ANNOSCOLASTICO,CODICESCUOLA,ORDINESCUOLA,ANNOCORSO,ALUNNI,ALUNNICITTADINANZAITALIANA,ALUNNICITTADINANZANONITALIANA,ALUNNICITTADINANZANONITALIANAPAESIUE,ALUNNICITTADINANZANONITALIANAPAESINONUE
202223,FI1E035004,SCUOLA PRIMARIA,3,34,30,4,0,4
202223,TO1E02900B,SCUOLA PRIMARIA,2,13,13,0,0,0
202223,NA1E198008,SCUOLA PRIMARIA,1,17,16,1,0,1
202223,CERHD15005,SCUOLA SECONDARIA II GRADO,4,9,9,0,0,0
202223,ISPL5F5001,SCUOLA SECONDARIA II GRADO,2,1,1,0,0,0
202223,BG1M002002,SCUOLA SECONDARIA I GRADO,1,37,37,0,0,0
202223,RM1E20900C,SCUOLA PRIMARIA,2,7,6,1,0,1
202223,CT1M02400B,SCUOLA SECONDARIA I GRADO,1,40,36,4,2,2
202223,PD1M001003,SCUOLA SECONDARIA I GRADO,1,37,36,1,0,1
202223,VARH025001,SCUOLA SECONDARIA II GRADO,1,19,19,0,0,0
202223,TOPC06500L,SCUOLA SECONDARIA II GRADO,1,15,15,0,0,0
202223,RMPSMF500G,SCUOLA SECONDARIA II GRADO,5,12,12,0,0,0
202223,RM1E10900G,SCUOLA PRIMARIA,3,22,21,1,1,0
202223,MBSL05500V,SCUOLA SECONDARIA II GRADO,4,78,77,1,0,1
202223,PD1E013004,SCUOLA PRIMARIA,1,26,26,0,0,0
202223,CE1E06800N,SCUOLA PRIMARIA,4,9,9,0,0,0
202223,RM1M108001,SCUOLA SECONDARIA I GRADO,1,43,40,3,0,3
202223,NO1E006007,SCUOLA PRIMARIA,2,51,49,2,0,2
202223,NARF0C5004,SCUOLA SECONDARIA II GRADO,3,8,7,1,0,1
202223,VR1E01300T,SCUOLA PRIMARIA,1,24,24,0,0,0
202223,NAPM455007,SCUOLA SECONDARIA II GRADO,4,5,5,0,0,0
202223,TS1E00300T,SCUOLA PRIMARIA,4,18,17,1,1,0
202223,VI1E01100T,SCUOLA PRIMARIA,1,19,16,3,1,2
202223,SATDVQ500D,SCUOLA SECONDARIA II GRADO,4,6,6,0,0,0
202223,CZ1EQB500O,SCUOLA PRIMARIA,2,20,20,0,0,0
202223,BNTL025006,SCUOLA SECONDARIA II GRADO,5,71,69,2,1,1
202223,PD1E00800L,SCUOLA PRIMARIA,2,19,18,1,1,0
202223,BG1E027005,SCUOLA PRIMARIA,5,15,14,1,0,1
202223,RMTAPV5005,SCUOLA SECONDARIA II GRADO,2,1,1,0,0,0
202223,NA1E23000V,SCUOLA PRIMARIA,3,22,22,0,0,0
202223,RM1E19000L,SCUOLA PRIMARIA,5,27,25,2,0,2
202223,VEPL04500N,SCUOLA SECONDARIA II GRADO,4,8,8,0,0,0
202223,LCTB00500V,SCUOLA SECONDARIA II GRADO,5,7,5,2,0,2
202223,NAPL7N500U,SCUOLA SECONDARIA II GRADO,5,57,49,8,2,6
202223,VR1E00800A,SCUOLA PRIMARIA,1,26,19,7,4,3
202223,GE1E02500A,SCUOLA PRIMARIA,2,18,18,0,0,0
202223,RM1E00300Q,SCUOLA PRIMARIA,3,54,54,0,0,0
202223,PR1E007003,SCUOLA PRIMARIA,1,20,20,0,0,0
202223,CTPS075008,SCUOLA SECONDARIA II GRADO,1,37,35,2,0,2
202223,BGPQ235008,SCUOLA SECONDARIA II GRADO,5,29,29,0,0,0
202223,RM1E12400N,SCUOLA PRIMARIA,2,16,15,1,0,1
202223,PATD34500B,SCUOLA SECONDARIA II GRADO,5,23,22,1,1,0
202223,VRTN025003,SCUOLA SECONDARIA II GRADO,3,28,27,1,0,1
202223,RM1E18300D,SCUOLA PRIMARIA,1,16,10,6,1,5
202223,MI1M05700R,SCUOLA SECONDARIA I GRADO,2,159,156,3,0,3
202223,NATD1E500I,SCUOLA SECONDARIA II GRADO,3,17,17,0,0,0
202223,MI1M063004,SCUOLA SECONDARIA I GRADO,1,120,118,2,0,2
202223,VEPMLV5000,SCUOLA SECONDARIA II GRADO,5,17,17,0,0,0
202223,AN1E001009,SCUOLA PRIMARIA,5,12,11,1,0,1
202223,GE1E019003,SCUOLA PRIMARIA,3,16,15,1,0,1
202223,SA1E012002,SCUOLA PRIMARIA,4,10,10,0,0,0
202223,NARH3Z5008,SCUOLA SECONDARIA II GRADO,2,3,3,0,0,0
202223,BG1M029002,SCUOLA SECONDARIA I GRADO,3,36,35,1,0,1
202223,NA1E051006,SCUOLA PRIMARIA,1,40,39,1,0,1
202223,BGPMS4500R,SCUOLA SECONDARIA II GRADO,3,6,5,1,0,1
202223,COPL025008,SCUOLA SECONDARIA II GRADO,5,9,9,0,0,0
202223,NA1E11800B,SCUOLA PRIMARIA,2,16,16,0,0,0
202223,UD1EM3500M,SCUOLA PRIMARIA,1,43,40,3,1,2
202223,FG1MS1500L,SCUOLA SECONDARIA I GRADO,3,12,11,1,1,0
202223,RM1MTI500F,SCUOLA SECONDARIA I GRADO,1,26,18,8,1,7
202223,LI1E00800R,SCUOLA PRIMARIA,2,16,16,0,0,0
202223,BSTN01500A,SCUOLA SECONDARIA II GRADO,4,12,12,0,0,0
202223,RM1E02400R,SCUOLA PRIMARIA,1,40,37,3,0,3
202223,VI1E00500E,SCUOLA PRIMARIA,5,26,26,0,0,0
202223,AGTD00500C,SCUOLA SECONDARIA II GRADO,1,3,3,0,0,0
202223,TO1E053008,SCUOLA PRIMARIA,5,30,29,1,1,0
202223,RMTDOO500A,SCUOLA SECONDARIA II GRADO,1,4,4,0,0,0
202223,SI1E003001,SCUOLA PRIMARIA,4,17,14,3,0,3
202223,PG1E00200V,SCUOLA PRIMARIA,4,13,13,0,0,0
202223,SA1E012002,SCUOLA PRIMARIA,1,12,12,0,0,0
202223,METD065008,SCUOLA SECONDARIA II GRADO,4,5,4,1,1,0
202223,SATD2H5007,SCUOLA SECONDARIA II GRADO,3,5,5,0,0,0
202223,TVPM4Q500B,SCUOLA SECONDARIA II GRADO,1,11,11,0,0,0
202223,VR1M021002,SCUOLA SECONDARIA I GRADO,1,15,14,1,0,1
202223,FIPL085005,SCUOLA SECONDARIA II GRADO,2,4,3,1,0,1
202223,NA1E11600Q,SCUOLA PRIMARIA,1,20,20,0,0,0
202223,NAPS92500P,SCUOLA SECONDARIA II GRADO,3,31,30,1,0,1
202223,CERH4F500L,SCUOLA SECONDARIA II GRADO,4,13,13,0,0,0
202223,NATL145007,SCUOLA SECONDARIA II GRADO,3,4,4,0,0,0
202223,BSTD355007,SCUOLA SECONDARIA II GRADO,1,4,4,0,0,0
202223,CAPS005009,SCUOLA SECONDARIA II GRADO,4,14,13,1,0,1
202223,NA1E19000N,SCUOLA PRIMARIA,4,10,10,0,0,0
202223,RN1E00200T,SCUOLA PRIMARIA,1,6,6,0,0,0
202223,PEPS005001,SCUOLA SECONDARIA II GRADO,4,35,35,0,0,0
202223,CTTD37500P,SCUOLA SECONDARIA II GRADO,1,3,3,0,0,0
202223,TA1E009007,SCUOLA PRIMARIA,2,11,11,0,0,0
202223,MIRF105007,SCUOLA SECONDARIA II GRADO,5,25,24,1,0,1
202223,MITD13500L,SCUOLA SECONDARIA II GRADO,4,17,16,1,0,1
202223,SSPM9L500Q,SCUOLA SECONDARIA II GRADO,1,3,3,0,0,0
202223,NA1E25100X,SCUOLA PRIMARIA,3,10,10,0,0,0
202223,RC1E00200R,SCUOLA PRIMARIA,2,21,20,1,0,1
202223,RM1E13300C,SCUOLA PRIMARIA,3,13,11,2,0,2
202223,BGTF015006,SCUOLA SECONDARIA II GRADO,3,13,13,0,0,0
202223,UD1E00500G,SCUOLA PRIMARIA,1,46,46,0,0,0
202223,CSTN015007,SCUOLA SECONDARIA II GRADO,2,4,4,0,0,0
202223,RMPC1A5001,SCUOLA SECONDARIA II GRADO,5,11,10,1,0,1
202223,MIPSRS500B,SCUOLA SECONDARIA II GRADO,1,17,16,1,1,0
202223,NAPC00500E,SCUOLA SECONDARIA II GRADO,2,8,6,2,0,2
202223,LE1E00200E,SCUOLA PRIMARIA,2,39,39,0,0,0
202223,PDTD01500R,SCUOLA SECONDARIA II GRADO,2,16,15,1,1,0
202223,RMPC525003,SCUOLA SECONDARIA II GRADO,3,19,19,0,0,0
202223,TARI00500A,SCUOLA SECONDARIA II GRADO,3,3,3,0,0,0
202223,RO1E00100P,SCUOLA PRIMARIA,1,25,24,1,0,1
202223,MISL04500B,SCUOLA SECONDARIA II GRADO,4,61,59,2,0,2
202223,BSPS88500T,SCUOLA SECONDARIA II GRADO,2,19,19,0,0,0
202223,GE1E039008,SCUOLA PRIMARIA,5,38,35,3,0,3
202223,MIPS735002,SCUOLA SECONDARIA II GRADO,1,10,9,1,0,1
202223,NA1E21700C,SCUOLA PRIMARIA,4,28,28,0,0,0
202223,BS1E00700C,SCUOLA PRIMARIA,1,26,26,0,0,0
202223,LO1M010007,SCUOLA SECONDARIA I GRADO,2,36,35,1,0,1
202223,RMPS44500E,SCUOLA SECONDARIA II GRADO,1,15,15,0,0,0
202223,LC1M08000Q,SCUOLA SECONDARIA I GRADO,1,40,39,1,0,1
202223,AL1E005002,SCUOLA PRIMARIA,1,49,47,2,1,1
202223,TO1E03500P,SCUOLA PRIMARIA,1,82,76,6,4,2
202223,RM1E08400C,SCUOLA PRIMARIA,2,40,38,2,1,1
202223,PV1E003001,SCUOLA PRIMARIA,5,45,45,0,0,0
202223,ANPS025003,SCUOLA SECONDARIA II GRADO,3,3,3,0,0,0
202223,VA1M8O500Z,SCUOLA SECONDARIA I GRADO,3,13,13,0,0,0
202223,RM1EM25008,SCUOLA PRIMARIA,2,25,16,9,0,9
202223,VE1E013006,SCUOLA PRIMARIA,3,23,22,1,0,1
202223,VE1E005007,SCUOLA PRIMARIA,4,23,19,4,1,3
202223,SATNV3500O,SCUOLA SECONDARIA II GRADO,3,5,5,0,0,0
202223,CO1E00900A,SCUOLA PRIMARIA,5,35,32,3,1,2
202223,GE1E03700L,SCUOLA PRIMARIA,4,21,20,1,0,1
202223,RMPM4G5004,SCUOLA SECONDARIA II GRADO,1,14,14,0,0,0
202223,FG1E02500R,SCUOLA PRIMARIA,2,23,23,0,0,0
202223,PA1E01700G,SCUOLA PRIMARIA,2,34,33,1,1,0
202223,MI1E039002,SCUOLA PRIMARIA,5,40,39,1,0,1
202223,RMTD00500C,SCUOLA SECONDARIA II GRADO,1,2,1,1,1,0
202223,LT1E00200R,SCUOLA PRIMARIA,5,26,22,4,1,3
202223,PGPC00500C,SCUOLA SECONDARIA II GRADO,5,5,5,0,0,0
202223,RM1E03400B,SCUOLA PRIMARIA,4,18,17,1,0,1
202223,FI1E03100R,SCUOLA PRIMARIA,1,18,18,0,0,0
202223,IM1E00600C,SCUOLA PRIMARIA,1,22,17,5,1,4
202223,BSPM6Z500C,SCUOLA SECONDARIA II GRADO,2,7,6,1,1,0
202223,PA1EDC5004,SCUOLA PRIMARIA,2,10,10,0,0,0
202223,TVPL005007,SCUOLA SECONDARIA II GRADO,1,10,9,1,0,1
202223,CORC43500S,SCUOLA SECONDARIA II GRADO,4,8,8,0,0,0
202223,CATF955004,SCUOLA SECONDARIA II GRADO,4,5,5,0,0,0
202223,FG1E01400A,SCUOLA PRIMARIA,5,17,17,0,0,0
202223,MI1E03100B,SCUOLA PRIMARIA,1,61,60,1,0,1
202223,MITL485005,SCUOLA SECONDARIA II GRADO,5,16,13,3,0,3
202223,MT1E00100E,SCUOLA PRIMARIA,3,24,23,1,1,0
202223,PZ1E002007,SCUOLA PRIMARIA,1,14,14,0,0,0
202223,VA1M01400R,SCUOLA SECONDARIA I GRADO,1,38,38,0,0,0
202223,NA1M05100B,SCUOLA SECONDARIA I GRADO,3,9,9,0,0,0
202223,TOPS125006,SCUOLA SECONDARIA II GRADO,1,1,1,0,0,0
202223,RM1E15900L,SCUOLA PRIMARIA,3,16,16,0,0,0
202223,COPSNU500Z,SCUOLA SECONDARIA II GRADO,4,9,7,2,1,1
202223,NA1E235002,SCUOLA PRIMARIA,3,20,20,0,0,0
202223,COTD105001,SCUOLA SECONDARIA II GRADO,4,13,13,0,0,0
202223,RM1E14500P,SCUOLA PRIMARIA,2,12,11,1,1,0
202223,GEPSC85001,SCUOLA SECONDARIA II GRADO,3,19,18,1,1,0
202223,RMPQ06500D,SCUOLA SECONDARIA II GRADO,4,8,8,0,0,0
202223,NATHES5002,SCUOLA SECONDARIA II GRADO,3,9,9,0,0,0
202223,PV1M00500T,SCUOLA SECONDARIA I GRADO,3,56,54,2,0,2
202223,APPC0Q500G,SCUOLA SECONDARIA II GRADO,1,2,2,0,0,0
202223,MI1E13000C,SCUOLA PRIMARIA,2,35,34,1,1,0
202223,NA1E073003,SCUOLA PRIMARIA,4,21,21,0,0,0
202223,MI1M05100T,SCUOLA SECONDARIA I GRADO,1,29,28,1,0,1
202223,SARF6Q5004,SCUOLA SECONDARIA II GRADO,3,3,2,1,0,1
202223,RM1E06300B,SCUOLA PRIMARIA,5,29,29,0,0,0
202223,FRPSD0500E,SCUOLA SECONDARIA II GRADO,4,3,3,0,0,0
202223,NA1M03300T,SCUOLA SECONDARIA I GRADO,3,27,22,5,0,5
202223,FI1E01000Q,SCUOLA PRIMARIA,5,33,32,1,1,0
202223,CO1M02500D,SCUOLA SECONDARIA I GRADO,1,27,27,0,0,0
202223,SATFH5500B,SCUOLA SECONDARIA II GRADO,4,2,2,0,0,0
202223,CN1E00300P,SCUOLA PRIMARIA,3,10,9,1,1,0
202223,BG1E013007,SCUOLA PRIMARIA,5,26,26,0,0,0
202223,AQ1E00700D,SCUOLA PRIMARIA,3,32,32,0,0,0
202223,BS1E002009,SCUOLA PRIMARIA,5,25,21,4,0,4
202223,MB1EVP500T,SCUOLA PRIMARIA,5,18,18,0,0,0
202223,PVPMF55003,SCUOLA SECONDARIA II GRADO,5,11,11,0,0,0
202223,RMPS575007,SCUOLA SECONDARIA II GRADO,5,22,22,0,0,0
202223,RM1E099006,SCUOLA PRIMARIA,3,24,23,1,0,1
202223,RE1E565000,SCUOLA PRIMARIA,1,13,10,3,1,2
202223,TV1M006008,SCUOLA SECONDARIA I GRADO,3,17,15,2,1,1
202223,RM1E07000E,SCUOLA PRIMARIA,4,36,36,0,0,0
202223,FRPM9G500T,SCUOLA SECONDARIA II GRADO,2,3,2,1,0,1
202223,LT1E006004,SCUOLA PRIMARIA,1,14,14,0,0,0
202223,LTTD01500X,SCUOLA SECONDARIA II GRADO,2,2,2,0,0,0
202223,CERVEN500Q,SCUOLA SECONDARIA II GRADO,2,9,9,0,0,0
202223,NA1E6E500B,SCUOLA PRIMARIA,3,14,14,0,0,0
202223,RM1E200002,SCUOLA PRIMARIA,4,13,13,0,0,0
202223,NATDU1500D,SCUOLA SECONDARIA II GRADO,5,64,64,0,0,0
202223,SATFIP5005,SCUOLA SECONDARIA II GRADO,5,5,4,1,0,1
202223,CE1E016001,SCUOLA PRIMARIA,2,10,8,2,1,1
202223,RMPSPL500P,SCUOLA SECONDARIA II GRADO,1,11,11,0,0,0
202223,NOSL015004,SCUOLA SECONDARIA II GRADO,3,2,2,0,0,0
202223,VAPSQ4500H,SCUOLA SECONDARIA II GRADO,3,26,26,0,0,0
202223,RMTD70500E,SCUOLA SECONDARIA II GRADO,4,21,20,1,1,0
202223,MI1E06300V,SCUOLA PRIMARIA,3,17,9,8,1,7
202223,SAPM3S500H,SCUOLA SECONDARIA II GRADO,3,5,5,0,0,0
202223,RM1E02000D,SCUOLA PRIMARIA,5,22,22,0,0,0
202223,BG1E01200B,SCUOLA PRIMARIA,3,39,38,1,0,1
202223,MI1E00800A,SCUOLA PRIMARIA,3,54,53,1,0,1
202223,BOPM8F500M,SCUOLA SECONDARIA II GRADO,1,16,15,1,0,1
202223,PTPS3N5004,SCUOLA SECONDARIA II GRADO,2,29,28,1,0,1
202223,RM1E065003,SCUOLA PRIMARIA,3,30,30,0,0,0
202223,BS1M00300A,SCUOLA SECONDARIA I GRADO,2,34,33,1,0,1
202223,PA1E02900T,SCUOLA PRIMARIA,4,22,20,2,0,2
202223,AVTDAS5006,SCUOLA SECONDARIA II GRADO,2,2,2,0,0,0
202223,PAPM4U500C,SCUOLA SECONDARIA II GRADO,4,3,3,0,0,0
202223,FIPLV0500F,SCUOLA SECONDARIA II GRADO,4,5,5,0,0,0
202223,MIPLVI500L,SCUOLA SECONDARIA II GRADO,3,19,19,0,0,0
202223,NA1E12000B,SCUOLA PRIMARIA,4,10,8,2,0,2
202223,TO1M05100T,SCUOLA SECONDARIA I GRADO,3,36,22,14,6,8
202223,MCPM00500L,SCUOLA SECONDARIA II GRADO,1,21,21,0,0,0
202223,RM1M02700D,SCUOLA SECONDARIA I GRADO,1,23,21,2,0,2
202223,MN1E00300Q,SCUOLA PRIMARIA,1,38,38,0,0,0
202223,MO1E00900B,SCUOLA PRIMARIA,4,24,22,2,0,2
202223,PVPS775003,SCUOLA SECONDARIA II GRADO,4,17,17,0,0,0
202223,MI1EBF500V,SCUOLA PRIMARIA,4,23,23,0,0,0
202223,NAPMS6500L,SCUOLA SECONDARIA II GRADO,4,11,11,0,0,0
202223,ME1M004001,SCUOLA SECONDARIA I GRADO,3,13,13,0,0,0
202223,IM1E00400R,SCUOLA PRIMARIA,3,22,21,1,0,1
202223,BS1EUE5000,SCUOLA PRIMARIA,2,8,8,0,0,0
202223,PR1E00300Q,SCUOLA PRIMARIA,5,14,13,1,0,1
202223,PAPC1H500H,SCUOLA SECONDARIA II GRADO,3,13,13,0,0,0
202223,MIPC075007,SCUOLA SECONDARIA II GRADO,3,36,36,0,0,0
202223,TOPL11500A,SCUOLA SECONDARIA II GRADO,4,11,11,0,0,0
202223,PATFCO500Z,SCUOLA SECONDARIA II GRADO,3,7,7,0,0,0
202223,VRPS3P500M,SCUOLA SECONDARIA II GRADO,1,24,24,0,0,0
202223,NAPSAV500Q,SCUOLA SECONDARIA II GRADO,4,4,4,0,0,0
202223,CA1E00200L,SCUOLA PRIMARIA,4,18,18,0,0,0
202223,NATD2T5008,SCUOLA SECONDARIA II GRADO,3,3,3,0,0,0
202223,PVSLMT5003,SCUOLA SECONDARIA II GRADO,1,11,10,1,0,1
202223,MI1M00100R,SCUOLA SECONDARIA I GRADO,1,100,100,0,0,0
202223,NA1E078006,SCUOLA PRIMARIA,4,21,19,2,0,2
202223,TV1E01100E,SCUOLA PRIMARIA,1,24,24,0,0,0
202223,CTTF01500P,SCUOLA SECONDARIA II GRADO,5,8,8,0,0,0
202223,MITD11500B,SCUOLA SECONDARIA II GRADO,2,2,1,1,0,1
202223,TO1M048002,SCUOLA SECONDARIA I GRADO,2,46,40,6,1,5
202223,NA1E13300D,SCUOLA PRIMARIA,2,20,20,0,0,0
202223,RMPLB3500E,SCUOLA SECONDARIA II GRADO,2,1,1,0,0,0
202223,APTD5L500H,SCUOLA SECONDARIA II GRADO,1,3,3,0,0,0
202223,BG1E030001,SCUOLA PRIMARIA,1,49,46,3,1,2
202223,MIPS535008,SCUOLA SECONDARIA II GRADO,1,13,11,2,0,2
202223,RM1M07200B,SCUOLA SECONDARIA I GRADO,2,4,3,1,0,1
202223,MBPL73500N,SCUOLA SECONDARIA II GRADO,2,8,8,0,0,0
202223,RM1E19700B,SCUOLA PRIMARIA,4,63,62,1,0,1
202223,RM1E03900E,SCUOLA PRIMARIA,4,18,18,0,0,0
202223,SRPS52500Q,SCUOLA SECONDARIA II GRADO,4,10,9,1,0,1
202223,NO1M00900X,SCUOLA SECONDARIA I GRADO,2,66,63,3,0,3
202223,SARFD1500N,SCUOLA SECONDARIA II GRADO,3,1,1,0,0,0
202223,FR1E001009,SCUOLA PRIMARIA,4,26,26,0,0,0
202223,SA1E020001,SCUOLA PRIMARIA,1,19,19,0,0,0
202223,CERHD15005,SCUOLA SECONDARIA II GRADO,5,186,180,6,4,2
202223,RNPC015002,SCUOLA SECONDARIA II GRADO,2,15,15,0,0,0
202223,PS1E00500V,SCUOLA PRIMARIA,4,27,27,0,0,0
202223,PO1E00300L,SCUOLA PRIMARIA,5,46,34,12,0,12
202223,NARHM0500C,SCUOLA SECONDARIA II GRADO,2,3,3,0,0,0
202223,RMPME45007,SCUOLA SECONDARIA II GRADO,3,8,8,0,0,0
202223,FIPS04500X,SCUOLA SECONDARIA II GRADO,5,30,30,0,0,0
202223,NA1E094004,SCUOLA PRIMARIA,3,11,11,0,0,0
202223,RCTDBT500S,SCUOLA SECONDARIA II GRADO,3,13,13,0,0,0
202223,CR1E00200P,SCUOLA PRIMARIA,3,16,15,1,0,1
202223,CR1M00200X,SCUOLA SECONDARIA I GRADO,3,42,40,2,0,2
202223,BATD105005,SCUOLA SECONDARIA II GRADO,1,6,6,0,0,0
202223,CA1E01000G,SCUOLA PRIMARIA,4,22,19,3,0,3
202223,CA1M013008,SCUOLA SECONDARIA I GRADO,1,20,20,0,0,0
202223,VETFO1500N,SCUOLA SECONDARIA II GRADO,5,9,9,0,0,0
202223,PERFNA5005,SCUOLA SECONDARIA II GRADO,2,1,1,0,0,0
202223,VA1E02200E,SCUOLA PRIMARIA,5,37,37,0,0,0
202223,BG1M002002,SCUOLA SECONDARIA I GRADO,2,23,23,0,0,0
202223,CT1ET9500Z,SCUOLA PRIMARIA,1,24,23,1,0,1
202223,BSPLPI500F,SCUOLA SECONDARIA II GRADO,3,15,15,0,0,0
202223,NA1E04600P,SCUOLA PRIMARIA,5,19,17,2,0,2
202223,COSL035001,SCUOLA SECONDARIA II GRADO,5,30,27,3,0,3
202223,VR1M00700Q,SCUOLA SECONDARIA I GRADO,1,64,61,3,0,3
202223,RM1E10700X,SCUOLA PRIMARIA,1,29,28,1,0,1
202223,FIPMRR500G,SCUOLA SECONDARIA II GRADO,5,14,13,1,0,1
202223,RM1M05000E,SCUOLA SECONDARIA I GRADO,1,27,27,0,0,0
202223,NA1E100006,SCUOLA PRIMARIA,2,28,26,2,0,2
202223,RM1M114008,SCUOLA SECONDARIA I GRADO,3,43,39,4,2,2
202223,CR1E006002,SCUOLA PRIMARIA,4,16,16,0,0,0
202223,NATL95500B,SCUOLA SECONDARIA II GRADO,5,55,52,3,1,2
202223,SA1MR95005,SCUOLA SECONDARIA I GRADO,1,5,5,0,0,0
202223,CA1E020006,SCUOLA PRIMARIA,2,26,24,2,1,1
202223,RMTFNG5000,SCUOLA SECONDARIA II GRADO,4,5,5,0,0,0
202223,MB1E05000N,SCUOLA PRIMARIA,1,71,70,1,0,1
202223,PEPMPL500U,SCUOLA SECONDARIA II GRADO,4,22,18,4,1,3
202223,VI1E00900T,SCUOLA PRIMARIA,3,25,25,0,0,0
202223,PG1E00400E,SCUOLA PRIMARIA,5,13,12,1,1,0
202223,CE1E02500Q,SCUOLA PRIMARIA,5,8,6,2,0,2
202223,SV1M00500B,SCUOLA SECONDARIA I GRADO,1,20,19,1,0,1
202223,NA1E23200E,SCUOLA PRIMARIA,1,10,10,0,0,0
202223,NATFFL500P,SCUOLA SECONDARIA II GRADO,3,8,8,0,0,0
202223,NATF15500N,SCUOLA SECONDARIA II GRADO,3,24,24,0,0,0
202223,BNTDHO5008,SCUOLA SECONDARIA II GRADO,4,4,4,0,0,0
202223,MIPLGB500O,SCUOLA SECONDARIA II GRADO,5,12,12,0,0,0
202223,NA1E15500A,SCUOLA PRIMARIA,1,15,15,0,0,0
202223,VRPM01500Q,SCUOLA SECONDARIA II GRADO,1,32,31,1,1,0
202223,VR1M02900L,SCUOLA SECONDARIA I GRADO,2,37,35,2,0,2
202223,SATF6H500T,SCUOLA SECONDARIA II GRADO,5,65,57,8,2,6
202223,MIPSN6500B,SCUOLA SECONDARIA II GRADO,3,11,11,0,0,0
202223,TVPSN55005,SCUOLA SECONDARIA II GRADO,1,21,21,0,0,0
202223,TATDI4500D,SCUOLA SECONDARIA II GRADO,5,20,20,0,0,0
202223,LI1E00200T,SCUOLA PRIMARIA,1,24,24,0,0,0
202223,CS1E008005,SCUOLA PRIMARIA,2,14,14,0,0,0
202223,RMPL085008,SCUOLA SECONDARIA II GRADO,3,20,19,1,0,1
202223,RGPS98500R,SCUOLA SECONDARIA II GRADO,3,2,2,0,0,0
202223,MB1E05500R,SCUOLA PRIMARIA,2,31,27,4,0,4
202223,RG1E00300C,SCUOLA PRIMARIA,3,20,20,0,0,0
202223,PEPS995008,SCUOLA SECONDARIA II GRADO,4,2,2,0,0,0
202223,CTTD145005,SCUOLA SECONDARIA II GRADO,5,21,21,0,0,0
202223,ME1EOF500O,SCUOLA PRIMARIA,3,33,33,0,0,0
202223,MIPSZS500P,SCUOLA SECONDARIA II GRADO,4,39,39,0,0,0
202223,VAPS06500N,SCUOLA SECONDARIA II GRADO,4,20,20,0,0,0
202223,BS1M00600T,SCUOLA SECONDARIA I GRADO,2,73,73,0,0,0
202223,TO1ED5500F,SCUOLA PRIMARIA,5,18,18,0,0,0
202223,PATD475004,SCUOLA SECONDARIA II GRADO,5,29,29,0,0,0
202223,MI1E08100C,SCUOLA PRIMARIA,5,14,10,4,0,4
202223,VRPSI5500C,SCUOLA SECONDARIA II GRADO,5,30,30,0,0,0
202223,CSTDIB500Z,SCUOLA SECONDARIA II GRADO,2,8,8,0,0,0
202223,PA1E007001,SCUOLA PRIMARIA,5,11,11,0,0,0
202223,MB1M017007,SCUOLA SECONDARIA I GRADO,2,69,69,0,0,0
202223,MIPSQ55000,SCUOLA SECONDARIA II GRADO,3,22,22,0,0,0
202223,NATFTA500I,SCUOLA SECONDARIA II GRADO,5,100,100,0,0,0
202223,TO1E00100G,SCUOLA PRIMARIA,5,65,64,1,0,1
202223,CS1E00400T,SCUOLA PRIMARIA,5,10,10,0,0,0
202223,SI1E003001,SCUOLA PRIMARIA,3,14,14,0,0,0
202223,VA1M012005,SCUOLA SECONDARIA I GRADO,2,91,90,1,0,1
202223,NARH4C5006,SCUOLA SECONDARIA II GRADO,5,67,67,0,0,0
202223,VC1E00100P,SCUOLA PRIMARIA,4,7,3,4,0,4
202223,BG1M01900B,SCUOLA SECONDARIA I GRADO,3,69,68,1,1,0
202223,CTPS10500V,SCUOLA SECONDARIA II GRADO,3,10,10,0,0,0
202223,NA1E04100G,SCUOLA PRIMARIA,3,64,63,1,0,1
202223,PDPS035006,SCUOLA SECONDARIA II GRADO,1,19,17,2,1,1
202223,CE1E00300V,SCUOLA PRIMARIA,2,19,19,0,0,0
202223,COPL08500X,SCUOLA SECONDARIA II GRADO,5,29,24,5,2,3
202223,UD1M00600L,SCUOLA SECONDARIA I GRADO,1,78,76,2,0,2
202223,APTFOR5004,SCUOLA SECONDARIA II GRADO,4,15,14,1,0,1
202223,MC1M8S500G,SCUOLA SECONDARIA I GRADO,1,18,17,1,1,0
202223,MN1E00300Q,SCUOLA PRIMARIA,2,32,30,2,2,0
202223,CAPS005009,SCUOLA SECONDARIA II GRADO,5,17,16,1,0,1
202223,AGTD2M5007,SCUOLA SECONDARIA II GRADO,3,7,7,0,0,0
202223,RM1E09600P,SCUOLA PRIMARIA,5,33,33,0,0,0
202223,TO1E02200L,SCUOLA PRIMARIA,3,18,17,1,0,1
202223,RM1M01200Q,SCUOLA SECONDARIA I GRADO,2,55,55,0,0,0
202223,MERHH5500F,SCUOLA SECONDARIA II GRADO,1,1,1,0,0,0
202223,VA1E003005,SCUOLA PRIMARIA,4,14,14,0,0,0
202223,SATD27500X,SCUOLA SECONDARIA II GRADO,3,3,3,0,0,0
202223,LC1E00100D,SCUOLA PRIMARIA,1,15,14,1,0,1
202223,BG1M01100R,SCUOLA SECONDARIA I GRADO,2,19,19,0,0,0
202223,CO1E00700P,SCUOLA PRIMARIA,3,25,23,2,0,2
202223,NA1E24900X,SCUOLA PRIMARIA,1,21,21,0,0,0
202223,RC1E00200R,SCUOLA PRIMARIA,3,20,20,0,0,0
202223,ENSD01500A,SCUOLA SECONDARIA II GRADO,3,23,23,0,0,0
202223,NA1E27900Q,SCUOLA PRIMARIA,4,10,10,0,0,0
202223,NATD9Z5006,SCUOLA SECONDARIA II GRADO,5,140,135,5,1,4
202223,FG1M002009,SCUOLA SECONDARIA I GRADO,3,24,24,0,0,0
202223,MIPSRS500B,SCUOLA SECONDARIA II GRADO,2,11,10,1,0,1
202223,BSTF01500P,SCUOLA SECONDARIA II GRADO,1,30,29,1,0,1
202223,NA1E185006,SCUOLA PRIMARIA,4,22,22,0,0,0
202223,VITD02500R,SCUOLA SECONDARIA II GRADO,5,15,14,1,1,0
202223,ME1E001008,SCUOLA PRIMARIA,4,40,40,0,0,0
202223,VA1EZH500L,SCUOLA PRIMARIA,3,17,16,1,0,1
202223,BSPS88500T,SCUOLA SECONDARIA II GRADO,3,15,15,0,0,0
202223,SS1E01100Q,SCUOLA PRIMARIA,4,13,11,2,0,2
202223,TVPS065004,SCUOLA SECONDARIA II GRADO,2,29,28,1,0,1
202223,RM1E16100L,SCUOLA PRIMARIA,2,5,4,1,0,1
202223,NA1E25300G,SCUOLA PRIMARIA,5,18,18,0,0,0
202223,BGTF9O500Q,SCUOLA SECONDARIA II GRADO,2,14,13,1,0,1
202223,RM1E128001,SCUOLA PRIMARIA,1,25,25,0,0,0
202223,FE1E004005,SCUOLA PRIMARIA,2,22,22,0,0,0
202223,GR1E00100D,SCUOLA PRIMARIA,5,46,46,0,0,0
202223,RMRHZT500U,SCUOLA SECONDARIA II GRADO,5,37,33,4,0,4
202223,CHRI00500N,SCUOLA SECONDARIA II GRADO,2,1,1,0,0,0
202223,NA1E164005,SCUOLA PRIMARIA,1,18,15,3,0,3
202223,PVTD05500P,SCUOLA SECONDARIA II GRADO,5,33,33,0,0,0
202223,PNTD7Z500U,SCUOLA SECONDARIA II GRADO,3,7,6,1,0,1
202223,MI1E01300T,SCUOLA PRIMARIA,3,22,22,0,0,0
202223,NAPC08500B,SCUOLA SECONDARIA II GRADO,5,10,10,0,0,0
202223,TV1E013006,SCUOLA PRIMARIA,3,21,21,0,0,0
202223,FR1EZQ500N,SCUOLA PRIMARIA,1,12,11,1,0,1
202223,MCPMOP500O,SCUOLA SECONDARIA II GRADO,4,7,5,2,0,2
202223,NAPMUF500A,SCUOLA SECONDARIA II GRADO,2,12,12,0,0,0
202223,BGPS0D500U,SCUOLA SECONDARIA II GRADO,2,21,20,1,0,1
202223,BSPMS9500M,SCUOLA SECONDARIA II GRADO,2,71,68,3,0,3
202223,VE1E014002,SCUOLA PRIMARIA,5,22,22,0,0,0
202223,VATD18500G,SCUOLA SECONDARIA II GRADO,4,10,8,2,0,2
202223,SATFTL5007,SCUOLA SECONDARIA II GRADO,4,8,8,0,0,0
202223,NATFPQ500Q,SCUOLA SECONDARIA II GRADO,4,6,6,0,0,0
202223,PCTD015006,SCUOLA SECONDARIA II GRADO,1,6,6,0,0,0
202223,BS1E008008,SCUOLA PRIMARIA,4,41,40,1,0,1
202223,NA1E22400G,SCUOLA PRIMARIA,2,56,55,1,0,1
202223,MI1E003007,SCUOLA PRIMARIA,3,56,56,0,0,0
202223,FR1E00400R,SCUOLA PRIMARIA,3,22,22,0,0,0
202223,RM1ERR500T,SCUOLA PRIMARIA,3,13,13,0,0,0
202223,LU1E003004,SCUOLA PRIMARIA,1,14,11,3,2,1
202223,VE1E01000P,SCUOLA PRIMARIA,5,25,25,0,0,0
202223,BSPS075008,SCUOLA SECONDARIA II GRADO,1,48,44,4,0,4
202223,LC1E009004,SCUOLA PRIMARIA,5,25,25,0,0,0
202223,BGPMC0500F,SCUOLA SECONDARIA II GRADO,2,11,11,0,0,0
202223,GE1E03000T,SCUOLA PRIMARIA,2,13,13,0,0,0
202223,UDTF00500V,SCUOLA SECONDARIA II GRADO,3,35,31,4,2,2
202223,TO1MB25008,SCUOLA SECONDARIA I GRADO,3,43,43,0,0,0
202223,FG1E015006,SCUOLA PRIMARIA,1,13,12,1,1,0
202223,AQ1E00500T,SCUOLA PRIMARIA,3,23,21,2,1,1
202223,RCTDPL500T,SCUOLA SECONDARIA II GRADO,5,26,26,0,0,0
202223,RMTD51500B,SCUOLA SECONDARIA II GRADO,4,8,8,0,0,0
202223,MI1E07300D,SCUOLA PRIMARIA,3,23,21,2,0,2
202223,TOTB025006,SCUOLA SECONDARIA II GRADO,5,13,11,2,1,1
202223,RM1E028004,SCUOLA PRIMARIA,4,24,24,0,0,0
202223,MI1M076006,SCUOLA SECONDARIA I GRADO,1,58,54,4,0,4
202223,VI1E002003,SCUOLA PRIMARIA,1,22,20,2,1,1
202223,CS1ENE5005,SCUOLA PRIMARIA,1,27,27,0,0,0
202223,GE1E013004,SCUOLA PRIMARIA,1,11,11,0,0,0
202223,BO1M00300Q,SCUOLA SECONDARIA I GRADO,2,25,23,2,0,2
202223,MIPM2A500Z,SCUOLA SECONDARIA II GRADO,1,30,28,2,0,2
202223,MIPMEO500H,SCUOLA SECONDARIA II GRADO,2,31,30,1,0,1
202223,RM1E7V500S,SCUOLA PRIMARIA,3,12,12,0,0,0
202223,NATDR0500L,SCUOLA SECONDARIA II GRADO,2,8,8,0,0,0
202223,VASLAA500P,SCUOLA SECONDARIA II GRADO,4,14,13,1,0,1
202223,RMPSQP500D,SCUOLA SECONDARIA II GRADO,2,20,19,1,1,0
202223,BLPMMN5000,SCUOLA SECONDARIA II GRADO,1,2,2,0,0,0
202223,NA1E127006,SCUOLA PRIMARIA,4,39,37,2,0,2
202223,FG1E015006,SCUOLA PRIMARIA,5,18,17,1,0,1
202223,BNTD02500Q,SCUOLA SECONDARIA II GRADO,4,8,8,0,0,0
202223,RM1M04200G,SCUOLA SECONDARIA I GRADO,2,70,65,5,1,4
202223,NA1E106005,SCUOLA PRIMARIA,1,21,19,2,0,2
202223,BA1M01200G,SCUOLA SECONDARIA I GRADO,3,31,30,1,0,1
202223,RMPSHR5005,SCUOLA SECONDARIA II GRADO,3,13,13,0,0,0
202223,TOPSA6500N,SCUOLA SECONDARIA II GRADO,1,18,17,1,0,1
202223,CE1E04000T,SCUOLA PRIMARIA,1,56,49,7,0,7
202223,MIPM0O500U,SCUOLA SECONDARIA II GRADO,5,29,27,2,0,2
202223,FI1ECP5008,SCUOLA PRIMARIA,2,19,7,12,4,8
202223,CTTN01500A,SCUOLA SECONDARIA II GRADO,2,3,3,0,0,0
202223,SVPS015002,SCUOLA SECONDARIA II GRADO,4,27,27,0,0,0
202223,FO1M00100B,SCUOLA SECONDARIA I GRADO,1,45,44,1,1,0
202223,AVTD045005,SCUOLA SECONDARIA II GRADO,3,8,8,0,0,0
202223,TOPS105001,SCUOLA SECONDARIA II GRADO,1,107,104,3,1,2
202223,CZPC00500G,SCUOLA SECONDARIA II GRADO,1,11,11,0,0,0
202223,RMPSVP500H,SCUOLA SECONDARIA II GRADO,1,8,5,3,2,1
202223,RM1E11100G,SCUOLA PRIMARIA,3,17,17,0,0,0
202223,RM1M031005,SCUOLA SECONDARIA I GRADO,3,23,21,2,0,2
202223,PVPS01500C,SCUOLA SECONDARIA II GRADO,1,17,17,0,0,0
202223,NATD46500L,SCUOLA SECONDARIA II GRADO,3,4,4,0,0,0
202223,SARH13500E,SCUOLA SECONDARIA II GRADO,4,4,4,0,0,0
202223,PAPS02500Q,SCUOLA SECONDARIA II GRADO,2,59,59,0,0,0
202223,TV1E005007,SCUOLA PRIMARIA,1,21,19,2,0,2
202223,PR1E00900P,SCUOLA PRIMARIA,4,23,22,1,0,1
202223,VBSLCH500S,SCUOLA SECONDARIA II GRADO,3,7,7,0,0,0
202223,FI1E00800Q,SCUOLA PRIMARIA,5,19,14,5,0,5
202223,AVPM03500Q,SCUOLA SECONDARIA II GRADO,1,6,5,1,0,1
202223,NA1E14000L,SCUOLA PRIMARIA,5,23,23,0,0,0
202223,UD1M00100D,SCUOLA SECONDARIA I GRADO,2,18,18,0,0,0
202223,NAPS265003,SCUOLA SECONDARIA II GRADO,3,15,15,0,0,0
202223,LC1M05000X,SCUOLA SECONDARIA I GRADO,3,62,60,2,1,1
202223,LCRFHO5008,SCUOLA SECONDARIA II GRADO,4,10,8,2,1,1
202223,RM1E065003,SCUOLA PRIMARIA,2,25,24,1,1,0
202223,FIPL005008,SCUOLA SECONDARIA II GRADO,2,8,6,2,0,2
202223,CETB015007,SCUOLA SECONDARIA II GRADO,1,27,27,0,0,0
202223,PO1E013007,SCUOLA PRIMARIA,4,23,17,6,0,6
202223,MI1E07700R,SCUOLA PRIMARIA,4,25,24,1,0,1
202223,CE1E01700R,SCUOLA PRIMARIA,5,19,19,0,0,0
202223,RMPLLD5008,SCUOLA SECONDARIA II GRADO,1,11,11,0,0,0
202223,SAPS005004,SCUOLA SECONDARIA II GRADO,1,2,1,1,0,1
202223,CRPSVN500C,SCUOLA SECONDARIA II GRADO,2,29,29,0,0,0
202223,SAPC005001,SCUOLA SECONDARIA II GRADO,4,4,4,0,0,0
202223,PN1E001008,SCUOLA PRIMARIA,5,41,39,2,0,2
202223,RM1E04700D,SCUOLA PRIMARIA,5,17,17,0,0,0
202223,FI1E022002,SCUOLA PRIMARIA,4,28,28,0,0,0
202223,MB1E09200Q,SCUOLA PRIMARIA,5,20,20,0,0,0
202223,BO1M01300A,SCUOLA SECONDARIA I GRADO,3,45,45,0,0,0
202223,FIPC05500B,SCUOLA SECONDARIA II GRADO,1,2,1,1,0,1
202223,LTPLCG500C,SCUOLA SECONDARIA II GRADO,3,13,13,0,0,0
202223,SSPS00500N,SCUOLA SECONDARIA II GRADO,5,3,3,0,0,0
202223,BG1M015004,SCUOLA SECONDARIA I GRADO,2,72,69,3,0,3
202223,NA1E03200R,SCUOLA PRIMARIA,2,11,11,0,0,0
202223,VR1M01000G,SCUOLA SECONDARIA I GRADO,1,30,30,0,0,0
202223,RM1E06100Q,SCUOLA PRIMARIA,4,25,24,1,1,0
202223,RM1E143003,SCUOLA PRIMARIA,2,24,22,2,1,1
202223,RM1M151007,SCUOLA SECONDARIA I GRADO,1,59,59,0,0,0
202223,TVTD6A500Z,SCUOLA SECONDARIA II GRADO,1,18,17,1,0,1
202223,LI1M00300V,SCUOLA SECONDARIA I GRADO,3,16,16,0,0,0
202223,TOTF055007,SCUOLA SECONDARIA II GRADO,4,7,7,0,0,0
202223,APPSNE500L,SCUOLA SECONDARIA II GRADO,2,20,18,2,2,0
202223,MI1E2B5001,SCUOLA PRIMARIA,4,15,12,3,0,3
202223,RMPS56500L,SCUOLA SECONDARIA II GRADO,3,9,9,0,0,0
202223,TO1E05000R,SCUOLA PRIMARIA,1,15,15,0,0,0
202223,LE1M00400B,SCUOLA SECONDARIA I GRADO,2,34,31,3,0,3
202223,PEPC8E500U,SCUOLA SECONDARIA II GRADO,5,21,21,0,0,0
202223,PSTF005006,SCUOLA SECONDARIA II GRADO,2,28,27,1,0,1
202223,ME1E00500G,SCUOLA PRIMARIA,3,10,10,0,0,0
202223,RMPC455002,SCUOLA SECONDARIA II GRADO,4,10,10,0,0,0
202223,MIPC10500T,SCUOLA SECONDARIA II GRADO,1,28,28,0,0,0
202223,VRSL01500G,SCUOLA SECONDARIA II GRADO,3,6,5,1,0,1
202223,PC1E00300V,SCUOLA PRIMARIA,2,19,18,1,0,1
202223,CT1E02100P,SCUOLA PRIMARIA,5,5,5,0,0,0
202223,NAPS68500Q,SCUOLA SECONDARIA II GRADO,1,29,27,2,0,2
202223,UD1E002004,SCUOLA PRIMARIA,1,12,10,2,1,1
202223,SASLFZ5001,SCUOLA SECONDARIA II GRADO,2,6,6,0,0,0
202223,NA1E08200T,SCUOLA PRIMARIA,2,17,16,1,0,1
202223,BGPS1G5008,SCUOLA SECONDARIA II GRADO,2,24,24,0,0,0
202223,VTPM7D500R,SCUOLA SECONDARIA II GRADO,1,11,11,0,0,0
202223,FO1E00500D,SCUOLA PRIMARIA,1,39,37,2,0,2
202223,CETF4P500Q,SCUOLA SECONDARIA II GRADO,3,11,11,0,0,0
202223,RMPC355005,SCUOLA SECONDARIA II GRADO,5,20,20,0,0,0
202223,VAPLL0500E,SCUOLA SECONDARIA II GRADO,2,14,13,1,0,1
202223,CSTD71500B,SCUOLA SECONDARIA II GRADO,2,8,8,0,0,0
202223,AV1ETA500G,SCUOLA PRIMARIA,2,1,1,0,0,0
202223,RMTD355004,SCUOLA SECONDARIA II GRADO,4,11,11,0,0,0
202223,MB1M02800N,SCUOLA SECONDARIA I GRADO,3,41,41,0,0,0
202223,MOTD01500Q,SCUOLA SECONDARIA II GRADO,3,17,16,1,0,1
202223,RMSLBH500V,SCUOLA SECONDARIA II GRADO,1,17,17,0,0,0
202223,TO1E009006,SCUOLA PRIMARIA,1,27,27,0,0,0
202223,PIPS02500D,SCUOLA SECONDARIA II GRADO,3,27,27,0,0,0
202223,LEPL01500L,SCUOLA SECONDARIA II GRADO,5,9,9,0,0,0
202223,MI1E00700E,SCUOLA PRIMARIA,2,50,50,0,0,0
202223,RMPL22500A,SCUOLA SECONDARIA II GRADO,4,19,19,0,0,0
202223,RNPS00500E,SCUOLA SECONDARIA II GRADO,1,23,18,5,1,4
202223,NARHP4500A,SCUOLA SECONDARIA II GRADO,5,140,138,2,0,2
202223,CETFOD5002,SCUOLA SECONDARIA II GRADO,3,8,1,7,0,7
202223,PD1M015007,SCUOLA SECONDARIA I GRADO,2,18,7,11,0,11
202223,CO1M001001,SCUOLA SECONDARIA I GRADO,3,27,26,1,0,1
202223,CR1E00400A,SCUOLA PRIMARIA,5,20,20,0,0,0
202223,MB1EQT500D,SCUOLA PRIMARIA,3,22,20,2,0,2
202223,MO1E01100B,SCUOLA PRIMARIA,4,47,45,2,0,2
202223,VI1E00900T,SCUOLA PRIMARIA,2,23,22,1,0,1
202223,TO1E04200T,SCUOLA PRIMARIA,4,41,39,2,0,2
202223,REPLP0500O,SCUOLA SECONDARIA II GRADO,4,11,11,0,0,0
202223,RM1E08800Q,SCUOLA PRIMARIA,3,20,19,1,0,1
202223,FI1M001006,SCUOLA SECONDARIA I GRADO,2,38,37,1,0,1
202223,RM1E078005,SCUOLA PRIMARIA,5,37,37,0,0,0
202223,VA1E01200X,SCUOLA PRIMARIA,2,32,32,0,0,0
202223,BORC10500R,SCUOLA SECONDARIA II GRADO,2,31,30,1,0,1
202223,RM1EGU500T,SCUOLA PRIMARIA,2,35,35,0,0,0
202223,CO1E013002,SCUOLA PRIMARIA,4,43,40,3,1,2
202223,MIPL335009,SCUOLA SECONDARIA II GRADO,5,13,13,0,0,0
202223,FIPMT8500I,SCUOLA SECONDARIA II GRADO,2,21,20,1,0,1
202223,MBRH02500X,SCUOLA SECONDARIA II GRADO,3,24,24,0,0,0
202223,APRF3R500G,SCUOLA SECONDARIA II GRADO,4,2,2,0,0,0
202223,MI1E045009,SCUOLA PRIMARIA,5,15,15,0,0,0
202223,RMPMR25005,SCUOLA SECONDARIA II GRADO,3,9,9,0,0,0
202223,SAPL3T500R,SCUOLA SECONDARIA II GRADO,4,3,2,1,0,1
202223,RMPSCF500T,SCUOLA SECONDARIA II GRADO,1,14,10,4,3,1
202223,MI1M03700G,SCUOLA SECONDARIA I GRADO,2,16,16,0,0,0
202223,NAPSP85001,SCUOLA SECONDARIA II GRADO,1,7,7,0,0,0
202223,RMTF285009,SCUOLA SECONDARIA II GRADO,4,15,15,0,0,0
202223,NAPLZL5002,SCUOLA SECONDARIA II GRADO,1,13,13,0,0,0
202223,VIPL02500Q,SCUOLA SECONDARIA II GRADO,4,5,5,0,0,0
202223,CE1E031003,SCUOLA PRIMARIA,2,14,14,0,0,0
202223,PG1EPF500P,SCUOLA PRIMARIA,3,18,18,0,0,0
202223,ME1EOF500O,SCUOLA PRIMARIA,4,50,50,0,0,0
202223,MERHH5500F,SCUOLA SECONDARIA II GRADO,5,35,34,1,0,1
202223,PA1E043004,SCUOLA PRIMARIA,4,21,16,5,0,5
202223,BS1M02100X,SCUOLA SECONDARIA I GRADO,3,34,34,0,0,0
202223,PATD7N500Z,SCUOLA SECONDARIA II GRADO,2,2,2,0,0,0
202223,VRPL06500E,SCUOLA SECONDARIA II GRADO,3,15,15,0,0,0
202223,BG1E02500D,SCUOLA PRIMARIA,3,49,49,0,0,0
202223,PD1E01400X,SCUOLA PRIMARIA,4,24,24,0,0,0
202223,BA1E00200Q,SCUOLA PRIMARIA,4,25,25,0,0,0
202223,TO1E004003,SCUOLA PRIMARIA,2,20,19,1,1,0
202223,REPS00500P,SCUOLA SECONDARIA II GRADO,4,4,4,0,0,0
202223,GE1E006001,SCUOLA PRIMARIA,1,81,69,12,1,11
202223,MIRF105007,SCUOLA SECONDARIA II GRADO,2,16,14,2,0,2
202223,CERIH2500T,SCUOLA SECONDARIA II GRADO,2,11,11,0,0,0
202223,BS1E02000V,SCUOLA PRIMARIA,3,46,45,1,0,1
202223,TO1M01000G,SCUOLA SECONDARIA I GRADO,3,19,19,0,0,0
202223,NATFD05003,SCUOLA SECONDARIA II GRADO,2,3,3,0,0,0
202223,NA1E13100T,SCUOLA PRIMARIA,3,19,19,0,0,0
202223,VRTF265002,SCUOLA SECONDARIA II GRADO,3,27,27,0,0,0
202223,BG1E01600P,SCUOLA PRIMARIA,3,57,53,4,0,4
202223,PD1E00800L,SCUOLA PRIMARIA,1,13,13,0,0,0
202223,MIPS79500P,SCUOLA SECONDARIA II GRADO,1,6,6,0,0,0
202223,RMTD325008,SCUOLA SECONDARIA II GRADO,4,2,2,0,0,0
202223,RMPS265002,SCUOLA SECONDARIA II GRADO,2,18,18,0,0,0
202223,RMSL3E5005,SCUOLA SECONDARIA II GRADO,1,5,5,0,0,0
202223,MBPS365007,SCUOLA SECONDARIA II GRADO,1,14,14,0,0,0
202223,VEPL4H500R,SCUOLA SECONDARIA II GRADO,1,2,2,0,0,0
202223,RG1E004008,SCUOLA PRIMARIA,3,20,19,1,0,1
202223,BOPSR2500M,SCUOLA SECONDARIA II GRADO,5,22,21,1,0,1
202223,SA1E00600P,SCUOLA PRIMARIA,4,21,20,1,0,1
202223,NARFA35009,SCUOLA SECONDARIA II GRADO,1,3,3,0,0,0
202223,PATD26500Q,SCUOLA SECONDARIA II GRADO,5,50,49,1,1,0
202223,NARH96500S,SCUOLA SECONDARIA II GRADO,2,28,28,0,0,0
202223,VE1M00500C,SCUOLA SECONDARIA I GRADO,2,26,23,3,0,3
202223,CTPC08500Q,SCUOLA SECONDARIA II GRADO,1,3,3,0,0,0
202223,CTPM415005,SCUOLA SECONDARIA II GRADO,5,13,12,1,1,0
202223,NA1E05400N,SCUOLA PRIMARIA,4,59,58,1,0,1
202223,FI1E014003,SCUOLA PRIMARIA,4,16,15,1,0,1
202223,BGPQ235008,SCUOLA SECONDARIA II GRADO,4,23,23,0,0,0
202223,COPL01500N,SCUOLA SECONDARIA II GRADO,1,18,18,0,0,0
202223,VRTN025003,SCUOLA SECONDARIA II GRADO,4,26,26,0,0,0
202223,AV1E007009,SCUOLA PRIMARIA,2,24,24,0,0,0
202223,NA1E21600L,SCUOLA PRIMARIA,3,16,16,0,0,0
202223,RM1M09800G,SCUOLA SECONDARIA I GRADO,3,14,12,2,0,2
202223,BA1E01000P,SCUOLA PRIMARIA,4,25,24,1,0,1
202223,CS1E00500N,SCUOLA PRIMARIA,4,10,9,1,1,0
202223,NARI01500D,SCUOLA SECONDARIA II GRADO,1,3,3,0,0,0
202223,RM1E18900C,SCUOLA PRIMARIA,5,20,20,0,0,0
202223,MI1E004003,SCUOLA PRIMARIA,4,52,52,0,0,0
202223,AGPSI1500H,SCUOLA SECONDARIA II GRADO,5,8,8,0,0,0
202223,GE1E019003,SCUOLA PRIMARIA,2,13,12,1,1,0
202223,LT1E00900G,SCUOLA PRIMARIA,2,38,35,3,0,3
202223,NARF5C500N,SCUOLA SECONDARIA II GRADO,4,8,8,0,0,0
202223,PAPC07500N,SCUOLA SECONDARIA II GRADO,5,31,31,0,0,0
202223,RC1E005008,SCUOLA PRIMARIA,1,18,18,0,0,0
202223,NATF25500E,SCUOLA SECONDARIA II GRADO,1,9,9,0,0,0
202223,RMPSLS5006,SCUOLA SECONDARIA II GRADO,1,19,19,0,0,0
202223,FG1MS1500L,SCUOLA SECONDARIA I GRADO,2,8,8,0,0,0
202223,CE1ERT500Q,SCUOLA PRIMARIA,3,13,13,0,0,0
202223,RMPC08500A,SCUOLA SECONDARIA II GRADO,2,78,77,1,0,1
202223,RM1M130006,SCUOLA SECONDARIA I GRADO,2,52,49,3,3,0
202223,BSTF4M5001,SCUOLA SECONDARIA II GRADO,4,7,6,1,0,1
202223,MI1E067006,SCUOLA PRIMARIA,2,15,15,0,0,0
202223,BSTN01500A,SCUOLA SECONDARIA II GRADO,3,13,11,2,0,2
202223,NA1E178003,SCUOLA PRIMARIA,3,21,18,3,1,2
202223,RM1E02500L,SCUOLA PRIMARIA,4,26,25,1,0,1
202223,TV1E00100X,SCUOLA PRIMARIA,2,23,18,5,3,2
202223,GE1E006001,SCUOLA PRIMARIA,5,106,97,9,0,9
202223,PE1M5C500R,SCUOLA SECONDARIA I GRADO,1,18,17,1,0,1
202223,CE1E065006,SCUOLA PRIMARIA,1,37,37,0,0,0
202223,CTTDG7500Z,SCUOLA SECONDARIA II GRADO,5,4,4,0,0,0
202223,PR1M00400R,SCUOLA SECONDARIA I GRADO,2,22,21,1,0,1
202223,TVPMVC5000,SCUOLA SECONDARIA II GRADO,5,21,21,0,0,0
202223,AVTF1Q5009,SCUOLA SECONDARIA II GRADO,1,7,7,0,0,0
202223,BGTF9O500Q,SCUOLA SECONDARIA II GRADO,3,12,12,0,0,0
202223,NA1E148007,SCUOLA PRIMARIA,5,10,10,0,0,0
202223,NA1E12500E,SCUOLA PRIMARIA,3,37,37,0,0,0
202223,CT1E03900X,SCUOLA PRIMARIA,2,16,15,1,1,0
202223,RMPC235003,SCUOLA SECONDARIA II GRADO,2,7,7,0,0,0
202223,CE1ELF5000,SCUOLA PRIMARIA,2,18,18,0,0,0
202223,NA1E09200C,SCUOLA PRIMARIA,1,22,22,0,0,0
202223,MSPC01500B,SCUOLA SECONDARIA II GRADO,4,11,11,0,0,0
202223,CL1E00500Q,SCUOLA PRIMARIA,2,16,16,0,0,0
202223,RM1E180002,SCUOLA PRIMARIA,5,30,25,5,2,3
202223,RN1E00200T,SCUOLA PRIMARIA,2,21,19,2,0,2
202223,SAPS11500B,SCUOLA SECONDARIA II GRADO,1,2,2,0,0,0
202223,CE1E05900V,SCUOLA PRIMARIA,1,20,20,0,0,0
202223,NAPMGU500T,SCUOLA SECONDARIA II GRADO,5,140,132,8,3,5
202223,RMPCAM500U,SCUOLA SECONDARIA II GRADO,5,4,4,0,0,0
202223,FO1E002002,SCUOLA PRIMARIA,2,17,13,4,1,3
202223,POPS9T5004,SCUOLA SECONDARIA II GRADO,1,21,9,12,0,12
202223,NATF30500A,SCUOLA SECONDARIA II GRADO,2,12,12,0,0,0
202223,PS1E00200B,SCUOLA PRIMARIA,3,16,15,1,0,1
202223,RM1E11700E,SCUOLA PRIMARIA,2,11,10,1,1,0
202223,UD1E00500G,SCUOLA PRIMARIA,2,41,40,1,0,1
202223,BS1E004001,SCUOLA PRIMARIA,3,51,45,6,2,4
202223,BS1E009004,SCUOLA PRIMARIA,4,27,26,1,0,1
202223,MIPSRF5008,SCUOLA SECONDARIA II GRADO,1,3,3,0,0,0
202223,MI1M076006,SCUOLA SECONDARIA I GRADO,2,46,44,2,0,2
202223,NA1E073003,SCUOLA PRIMARIA,1,25,24,1,0,1
202223,VE1M01000X,SCUOLA SECONDARIA I GRADO,2,23,23,0,0,0
202223,LE1E00200E,SCUOLA PRIMARIA,1,39,39,0,0,0
202223,TARI00500A,SCUOLA SECONDARIA II GRADO,5,5,5,0,0,0
202223,RM1E199003,SCUOLA PRIMARIA,4,16,15,1,0,1
202223,NA1E022006,SCUOLA PRIMARIA,2,51,51,0,0,0
202223,FI1E00300L,SCUOLA PRIMARIA,1,20,18,2,1,1
202223,BGPL01500V,SCUOLA SECONDARIA II GRADO,5,10,9,1,0,1
202223,VR1M01500P,SCUOLA SECONDARIA I GRADO,3,46,45,1,1,0
202223,SATL16500Q,SCUOLA SECONDARIA II GRADO,2,9,4,5,0,5
202223,RMPMPL5008,SCUOLA SECONDARIA II GRADO,4,9,9,0,0,0
202223,GE1E039008,SCUOLA PRIMARIA,4,28,22,6,0,6
202223,NA1E28100Q,SCUOLA PRIMARIA,1,29,29,0,0,0
202223,UDPC00500N,SCUOLA SECONDARIA II GRADO,4,17,17,0,0,0
202223,RMPL43500P,SCUOLA SECONDARIA II GRADO,5,16,16,0,0,0
202223,AR1E00400L,SCUOLA PRIMARIA,4,20,15,5,0,5
202223,RCRI015009,SCUOLA SECONDARIA II GRADO,2,4,4,0,0,0
202223,TPTD075004,SCUOLA SECONDARIA II GRADO,3,3,2,1,0,1
202223,SATD125002,SCUOLA SECONDARIA II GRADO,4,1,1,0,0,0
202223,RM1E03100X,SCUOLA PRIMARIA,1,9,9,0,0,0
202223,MI1M06600G,SCUOLA SECONDARIA I GRADO,3,51,48,3,0,3
202223,RMPS655007,SCUOLA SECONDARIA II GRADO,5,11,11,0,0,0
202223,PO1E001001,SCUOLA PRIMARIA,4,18,18,0,0,0
202223,AL1E00600T,SCUOLA PRIMARIA,2,37,34,3,1,2
202223,MIPMEO500H,SCUOLA SECONDARIA II GRADO,3,32,32,0,0,0
202223,TV1M01200G,SCUOLA SECONDARIA I GRADO,3,69,69,0,0,0
202223,NATDS2500B,SCUOLA SECONDARIA II GRADO,5,173,162,11,4,7
202223,NA1E272001,SCUOLA PRIMARIA,4,16,16,0,0,0
202223,BL1E818011,SCUOLA PRIMARIA,5,6,5,1,0,1
202223,FG1E022009,SCUOLA PRIMARIA,3,39,37,2,0,2
202223,BA1E01600N,SCUOLA PRIMARIA,1,8,8,0,0,0
202223,NO1E00300Q,SCUOLA PRIMARIA,3,43,41,2,1,1
202223,TO1E05100L,SCUOLA PRIMARIA,5,16,16,0,0,0
202223,MB1E07200E,SCUOLA PRIMARIA,4,16,15,1,0,1
202223,FI1M02000G,SCUOLA SECONDARIA I GRADO,1,14,11,3,0,3
202223,BGSLAE500Q,SCUOLA SECONDARIA II GRADO,5,12,12,0,0,0
202223,SV1E005006,SCUOLA PRIMARIA,2,34,32,2,1,1
202223,SRTHA6500C,SCUOLA SECONDARIA II GRADO,1,5,5,0,0,0
202223,RM1E157001,SCUOLA PRIMARIA,4,10,8,2,0,2
202223,AVPM03500Q,SCUOLA SECONDARIA II GRADO,2,11,11,0,0,0
202223,MI1MV25008,SCUOLA SECONDARIA I GRADO,1,50,49,1,0,1
202223,COTD105001,SCUOLA SECONDARIA II GRADO,3,24,24,0,0,0
202223,RM1M04000X,SCUOLA SECONDARIA I GRADO,2,87,84,3,1,2
202223,GO1E00100A,SCUOLA PRIMARIA,3,22,22,0,0,0
202223,MI1E03000G,SCUOLA PRIMARIA,4,27,27,0,0,0
202223,NAPSNL500R,SCUOLA SECONDARIA II GRADO,2,26,23,3,0,3
202223,NATL265009,SCUOLA SECONDARIA II GRADO,5,69,66,3,1,2
202223,APPS9N5001,SCUOLA SECONDARIA II GRADO,1,2,2,0,0,0
202223,BGPS065005,SCUOLA SECONDARIA II GRADO,5,12,12,0,0,0
202223,SARHGU5003,SCUOLA SECONDARIA II GRADO,5,30,30,0,0,0
202223,CE1E03300P,SCUOLA PRIMARIA,4,11,11,0,0,0
202223,RM1E007003,SCUOLA PRIMARIA,4,23,22,1,0,1
202223,NA1M011001,SCUOLA SECONDARIA I GRADO,3,10,9,1,0,1
202223,VE1E00300G,SCUOLA PRIMARIA,4,16,12,4,3,1
202223,CE1E01800L,SCUOLA PRIMARIA,1,9,9,0,0,0
202223,BNTL025006,SCUOLA SECONDARIA II GRADO,3,3,3,0,0,0
202223,TATD055002,SCUOLA SECONDARIA II GRADO,1,7,7,0,0,0
202223,LCPS025007,SCUOLA SECONDARIA II GRADO,3,6,6,0,0,0
202223,VR1E01000A,SCUOLA PRIMARIA,5,27,24,3,1,2
202223,RG1E0O5005,SCUOLA PRIMARIA,4,13,13,0,0,0
202223,CERIN35009,SCUOLA SECONDARIA II GRADO,4,8,8,0,0,0
202223,RM1E2U500H,SCUOLA PRIMARIA,5,48,46,2,0,2
202223,BSPS01500L,SCUOLA SECONDARIA II GRADO,2,9,9,0,0,0
202223,PO1E006004,SCUOLA PRIMARIA,3,25,19,6,0,6
202223,CE1E001007,SCUOLA PRIMARIA,1,10,10,0,0,0
202223,GE1M013009,SCUOLA SECONDARIA I GRADO,2,39,38,1,0,1
202223,RMPM045004,SCUOLA SECONDARIA II GRADO,1,10,9,1,1,0
202223,MI1E07900C,SCUOLA PRIMARIA,1,24,23,1,0,1
202223,RMSLZ35008,SCUOLA SECONDARIA II GRADO,5,25,22,3,2,1
202223,PI1E00100Q,SCUOLA PRIMARIA,2,29,28,1,0,1
202223,MI1E00200B,SCUOLA PRIMARIA,3,18,18,0,0,0
202223,RM1E099006,SCUOLA PRIMARIA,4,35,34,1,0,1
202223,BOPL02500B,SCUOLA SECONDARIA II GRADO,2,18,17,1,0,1
202223,TO1E03000G,SCUOLA PRIMARIA,2,13,12,1,0,1
202223,RM1E077009,SCUOLA PRIMARIA,3,14,0,14,1,13
202223,LT1E005008,SCUOLA PRIMARIA,4,36,36,0,0,0
202223,VA1E00600L,SCUOLA PRIMARIA,2,17,13,4,1,3
202223,TVPMRQ500V,SCUOLA SECONDARIA II GRADO,5,18,17,1,1,0
202223,PA1MQ8500S,SCUOLA SECONDARIA I GRADO,3,16,16,0,0,0
202223,CTRHMM500U,SCUOLA SECONDARIA II GRADO,1,14,11,3,0,3
202223,COTB01500Q,SCUOLA SECONDARIA II GRADO,2,15,11,4,1,3
202223,RM1E14700A,SCUOLA PRIMARIA,3,27,26,1,1,0
202223,TOPS005004,SCUOLA SECONDARIA II GRADO,4,34,31,3,2,1
202223,BNPS3O5006,SCUOLA SECONDARIA II GRADO,1,6,6,0,0,0
202223,CEPC015007,SCUOLA SECONDARIA II GRADO,4,17,16,1,0,1
202223,LIPL035005,SCUOLA SECONDARIA II GRADO,3,6,5,1,0,1
202223,MN1M002005,SCUOLA SECONDARIA I GRADO,2,25,25,0,0,0
202223,MNPL2H500Q,SCUOLA SECONDARIA II GRADO,3,8,8,0,0,0
202223,BA1M006008,SCUOLA SECONDARIA I GRADO,2,21,19,2,0,2
202223,BG1E006004,SCUOLA PRIMARIA,1,43,42,1,0,1
202223,PVSL015009,SCUOLA SECONDARIA II GRADO,2,1,1,0,0,0
202223,TR1E00100P,SCUOLA PRIMARIA,4,17,15,2,0,2
202223,NA1E19700C,SCUOLA PRIMARIA,5,13,13,0,0,0
202223,MIPQ01500X,SCUOLA SECONDARIA II GRADO,5,26,26,0,0,0
202223,FO1E00500D,SCUOLA PRIMARIA,2,44,41,3,1,2
202223,METDP0500I,SCUOLA SECONDARIA II GRADO,2,4,4,0,0,0
202223,BS1M00200E,SCUOLA SECONDARIA I GRADO,3,20,17,3,0,3
202223,ISTDGG500C,SCUOLA SECONDARIA II GRADO,3,1,1,0,0,0
202223,PA1M01900C,SCUOLA SECONDARIA I GRADO,1,89,86,3,0,3
202223,RM1E13800G,SCUOLA PRIMARIA,2,70,69,1,0,1
202223,TOPM09500L,SCUOLA SECONDARIA II GRADO,5,16,16,0,0,0
202223,BG1E019006,SCUOLA PRIMARIA,2,15,15,0,0,0
202223,NAPS39500Q,SCUOLA SECONDARIA II GRADO,1,11,11,0,0,0
202223,MI1E02200L,SCUOLA PRIMARIA,5,22,19,3,0,3
202223,MN1E00200X,SCUOLA PRIMARIA,4,32,32,0,0,0
202223,RMPMT1500R,SCUOLA SECONDARIA II GRADO,4,9,8,1,0,1
202223,RM1E17400P,SCUOLA PRIMARIA,2,14,14,0,0,0
202223,VIPMBL500I,SCUOLA SECONDARIA II GRADO,1,4,4,0,0,0
202223,PASD01500G,SCUOLA SECONDARIA II GRADO,1,28,28,0,0,0
202223,CETDHL500C,SCUOLA SECONDARIA II GRADO,2,9,9,0,0,0
202223,VAPS785001,SCUOLA SECONDARIA II GRADO,5,24,24,0,0,0
202223,NA1MR7500R,SCUOLA SECONDARIA I GRADO,3,13,11,2,2,0
202223,GE1M007002,SCUOLA SECONDARIA I GRADO,1,12,12,0,0,0
202223,MIPC075007,SCUOLA SECONDARIA II GRADO,1,24,24,0,0,0
202223,BNTL025006,SCUOLA SECONDARIA II GRADO,4,6,5,1,0,1
202223,BG1E01500V,SCUOLA PRIMARIA,3,38,37,1,0,1
202223,BG1E02300T,SCUOLA PRIMARIA,1,33,32,1,0,1
202223,MIPS43500B,SCUOLA SECONDARIA II GRADO,5,32,32,0,0,0
202223,RMTAPV5005,SCUOLA SECONDARIA II GRADO,3,1,1,0,0,0
202223,RMPS135009,SCUOLA SECONDARIA II GRADO,2,12,12,0,0,0
202223,TO1E016009,SCUOLA PRIMARIA,2,18,18,0,0,0
202223,RM1E16500X,SCUOLA PRIMARIA,2,20,19,1,0,1
202223,REPLP0500O,SCUOLA SECONDARIA II GRADO,5,8,7,1,1,0
202223,NAPL7N500U,SCUOLA SECONDARIA II GRADO,4,7,7,0,0,0
202223,GE1E01500Q,SCUOLA PRIMARIA,1,10,9,1,1,0
202223,RM1E00300Q,SCUOLA PRIMARIA,2,51,50,1,1,0
202223,PARI025001,SCUOLA SECONDARIA II GRADO,4,7,7,0,0,0
202223,RO1E00300A,SCUOLA PRIMARIA,2,22,22,0,0,0
202223,PD1EZU500F,SCUOLA PRIMARIA,1,17,15,2,2,0
202223,PAPM9C5005,SCUOLA SECONDARIA II GRADO,5,22,22,0,0,0
202223,BG1E01700E,SCUOLA PRIMARIA,4,3,2,1,0,1
202223,NA1E22500B,SCUOLA PRIMARIA,2,12,12,0,0,0
202223,NATD1E500I,SCUOLA SECONDARIA II GRADO,2,14,14,0,0,0
202223,VEPS00500C,SCUOLA SECONDARIA II GRADO,1,6,6,0,0,0
202223,AL1E00300A,SCUOLA PRIMARIA,5,12,10,2,0,2
202223,FI1E035004,SCUOLA PRIMARIA,2,32,26,6,0,6
202223,RM1E07500N,SCUOLA PRIMARIA,3,80,76,4,1,3
202223,CERHD15005,SCUOLA SECONDARIA II GRADO,3,62,61,1,0,1
202223,LTTFOH5004,SCUOLA SECONDARIA II GRADO,3,2,2,0,0,0
202223,BG1EUA5004,SCUOLA PRIMARIA,5,38,37,1,0,1
202223,CT1M02300G,SCUOLA SECONDARIA I GRADO,3,33,31,2,0,2
202223,VR1ESU500Z,SCUOLA PRIMARIA,3,17,14,3,1,2
202223,BGPMS4500R,SCUOLA SECONDARIA II GRADO,2,11,9,2,1,1
202223,RMPME45007,SCUOLA SECONDARIA II GRADO,5,48,44,4,0,4
202223,VARH025001,SCUOLA SECONDARIA II GRADO,2,17,16,1,0,1
202223,TOPC06500L,SCUOLA SECONDARIA II GRADO,2,22,22,0,0,0
202223,RMPSNS500T,SCUOLA SECONDARIA II GRADO,1,5,5,0,0,0
202223,NATDGE5008,SCUOLA SECONDARIA II GRADO,3,8,7,1,1,0
202223,CE1E06800N,SCUOLA PRIMARIA,3,8,8,0,0,0
202223,RCTDBT500S,SCUOLA SECONDARIA II GRADO,1,7,6,1,0,1
202223,RM1M108001,SCUOLA SECONDARIA I GRADO,2,34,28,6,0,6
202223,MI1M09400Q,SCUOLA SECONDARIA I GRADO,2,23,22,1,1,0
202223,RM1E023001,SCUOLA PRIMARIA,5,53,47,6,0,6
202223,NARF0C5004,SCUOLA SECONDARIA II GRADO,2,5,5,0,0,0
202223,RMTDOO500A,SCUOLA SECONDARIA II GRADO,2,4,4,0,0,0
202223,NAPM455007,SCUOLA SECONDARIA II GRADO,3,7,7,0,0,0
202223,TS1E00300T,SCUOLA PRIMARIA,5,20,18,2,1,1
202223,PV1E00500L,SCUOLA PRIMARIA,1,53,51,2,0,2
202223,METD065008,SCUOLA SECONDARIA II GRADO,3,8,8,0,0,0
202223,SV1E00200P,SCUOLA PRIMARIA,3,17,17,0,0,0
202223,BS1M01000D,SCUOLA SECONDARIA I GRADO,3,56,54,2,2,0
202223,CZ1EQB500O,SCUOLA PRIMARIA,1,12,12,0,0,0
202223,BL1E00200B,SCUOLA PRIMARIA,3,31,31,0,0,0
202223,NA1E114004,SCUOLA PRIMARIA,5,11,11,0,0,0
202223,VRPM27500E,SCUOLA SECONDARIA II GRADO,4,21,20,1,0,1
202223,VATB01500D,SCUOLA SECONDARIA II GRADO,5,18,16,2,0,2
202223,BSTD01500C,SCUOLA SECONDARIA II GRADO,5,19,19,0,0,0
202223,MB1E03600B,SCUOLA PRIMARIA,2,19,19,0,0,0
202223,MB1E04900D,SCUOLA PRIMARIA,5,69,65,4,1,3
202223,VR1E00800A,SCUOLA PRIMARIA,2,27,24,3,1,2
202223,SV1E006002,SCUOLA PRIMARIA,4,3,2,1,0,1
202223,MB1E02800C,SCUOLA PRIMARIA,1,51,49,2,0,2
202223,PR1E00500B,SCUOLA PRIMARIA,5,37,37,0,0,0
202223,BO1E00300E,SCUOLA PRIMARIA,5,24,24,0,0,0
202223,MBPS0G5007,SCUOLA SECONDARIA II GRADO,4,18,18,0,0,0
202223,MI1M05700R,SCUOLA SECONDARIA I GRADO,1,135,129,6,0,6
202223,MI1E125001,SCUOLA PRIMARIA,3,42,42,0,0,0
202223,NATD3V500N,SCUOLA SECONDARIA II GRADO,2,7,7,0,0,0
202223,PI1M001001,SCUOLA SECONDARIA I GRADO,2,16,15,1,0,1
202223,CS1E008005,SCUOLA PRIMARIA,1,22,21,1,0,1
202223,SARHDF500N,SCUOLA SECONDARIA II GRADO,5,208,201,7,2,5
202223,AN1E001009,SCUOLA PRIMARIA,4,13,12,1,0,1
202223,TV1E00900E,SCUOLA PRIMARIA,1,17,14,3,0,3
202223,SA1E012002,SCUOLA PRIMARIA,5,5,5,0,0,0
202223,NA1E05000A,SCUOLA PRIMARIA,5,5,5,0,0,0
202223,VR1E01300T,SCUOLA PRIMARIA,3,24,23,1,0,1
202223,COPL025008,SCUOLA SECONDARIA II GRADO,4,26,23,3,0,3
202223,NA1E13800L,SCUOLA PRIMARIA,1,13,13,0,0,0
202223,VT1E006009,SCUOLA PRIMARIA,5,23,23,0,0,0
202223,UD1EM3500M,SCUOLA PRIMARIA,2,47,43,4,1,3
202223,CSTDDC500C,SCUOLA SECONDARIA II GRADO,5,20,19,1,0,1
202223,BS1E00600L,SCUOLA PRIMARIA,5,45,42,3,1,2
202223,MI1E06500E,SCUOLA PRIMARIA,5,29,29,0,0,0
202223,LI1E006005,SCUOLA PRIMARIA,5,50,49,1,0,1
202223,MBPMZF5000,SCUOLA SECONDARIA II GRADO,2,15,14,1,0,1
202223,MO1EF4500G,SCUOLA PRIMARIA,2,16,13,3,2,1
202223,TO1E054004,SCUOLA PRIMARIA,1,12,12,0,0,0
202223,RMPS44500E,SCUOLA SECONDARIA II GRADO,2,17,14,3,1,2
202223,NA1E06600X,SCUOLA PRIMARIA,2,26,25,1,0,1
202223,AGTA6O500F,SCUOLA SECONDARIA II GRADO,5,22,21,1,1,0
202223,SI1E003001,SCUOLA PRIMARIA,5,15,14,1,0,1
202223,GE1E020007,SCUOLA PRIMARIA,5,29,28,1,0,1
202223,ALPM02500D,SCUOLA SECONDARIA II GRADO,5,10,10,0,0,0
202223,ANPS025003,SCUOLA SECONDARIA II GRADO,2,2,2,0,0,0
202223,PV1E003001,SCUOLA PRIMARIA,4,37,32,5,2,3
202223,PG1E00200V,SCUOLA PRIMARIA,3,11,10,1,0,1
202223,RM1EM25008,SCUOLA PRIMARIA,3,49,34,15,2,13
202223,NARH4C5006,SCUOLA SECONDARIA II GRADO,4,4,4,0,0,0
202223,VR1M021002,SCUOLA SECONDARIA I GRADO,2,12,9,3,2,1
202223,BGPC02500G,SCUOLA SECONDARIA II GRADO,2,5,5,0,0,0
202223,NA1E05500D,SCUOLA PRIMARIA,5,45,43,2,1,1
202223,NA1E239009,SCUOLA PRIMARIA,3,16,16,0,0,0
202223,FIPL085005,SCUOLA SECONDARIA II GRADO,1,3,3,0,0,0
202223,NA1E285003,SCUOLA PRIMARIA,1,11,11,0,0,0
202223,RMPLOA500A,SCUOLA SECONDARIA II GRADO,4,1,1,0,0,0
202223,NATD8F500U,SCUOLA SECONDARIA II GRADO,5,105,103,2,0,2
202223,CE1ELF5000,SCUOLA PRIMARIA,3,3,3,0,0,0
202223,MI1E062003,SCUOLA PRIMARIA,1,64,63,1,0,1
202223,SAPM53500M,SCUOLA SECONDARIA II GRADO,4,2,2,0,0,0
202223,APPM04500X,SCUOLA SECONDARIA II GRADO,2,7,7,0,0,0
202223,CA1M4N500E,SCUOLA SECONDARIA I GRADO,2,8,8,0,0,0
202223,CAPS005009,SCUOLA SECONDARIA II GRADO,2,12,12,0,0,0
202223,BO1M00200X,SCUOLA SECONDARIA I GRADO,3,65,64,1,0,1
202223,NA1E01000X,SCUOLA PRIMARIA,2,22,9,13,2,11
202223,NARH065003,SCUOLA SECONDARIA II GRADO,5,66,66,0,0,0
202223,SSPM9L500Q,SCUOLA SECONDARIA II GRADO,2,2,2,0,0,0
202223,NA1E015003,SCUOLA PRIMARIA,3,10,9,1,0,1
202223,BG1M010001,SCUOLA SECONDARIA I GRADO,3,152,151,1,0,1
202223,TVPL005007,SCUOLA SECONDARIA II GRADO,2,8,7,1,0,1
202223,BSPME1500B,SCUOLA SECONDARIA II GRADO,3,27,27,0,0,0
202223,NA1E25100X,SCUOLA PRIMARIA,2,10,10,0,0,0
202223,BGTF015006,SCUOLA SECONDARIA II GRADO,2,34,28,6,0,6
202223,RMPC235003,SCUOLA SECONDARIA II GRADO,1,2,2,0,0,0
202223,MIPSQV500F,SCUOLA SECONDARIA II GRADO,4,19,19,0,0,0
202223,MIPSRL500S,SCUOLA SECONDARIA II GRADO,2,27,23,4,0,4
202223,MT1E00100E,SCUOLA PRIMARIA,2,14,12,2,2,0
202223,NATN7V500I,SCUOLA SECONDARIA II GRADO,3,4,4,0,0,0
202223,MI1EBF500V,SCUOLA PRIMARIA,2,25,25,0,0,0
202223,RMPC525003,SCUOLA SECONDARIA II GRADO,4,12,12,0,0,0
202223,ME1E001008,SCUOLA PRIMARIA,2,22,21,1,1,0
202223,TARI00500A,SCUOLA SECONDARIA II GRADO,4,3,3,0,0,0
202223,BSPMNI500T,SCUOLA SECONDARIA II GRADO,5,36,36,0,0,0
202223,MISL04500B,SCUOLA SECONDARIA II GRADO,3,61,59,2,0,2
202223,TVPS065004,SCUOLA SECONDARIA II GRADO,3,23,23,0,0,0
202223,MI1MA05006,SCUOLA SECONDARIA I GRADO,3,17,14,3,0,3
202223,PATF02500T,SCUOLA SECONDARIA II GRADO,1,1,1,0,0,0
202223,AV1E010005,SCUOLA PRIMARIA,2,22,21,1,1,0
202223,SATF09500P,SCUOLA SECONDARIA II GRADO,5,70,66,4,0,4
202223,CS1MUP500H,SCUOLA SECONDARIA I GRADO,1,29,29,0,0,0
202223,AL1E004006,SCUOLA PRIMARIA,5,21,21,0,0,0
202223,CERHT0500Q,SCUOLA SECONDARIA II GRADO,2,13,2,11,0,11
202223,CETDHG500L,SCUOLA SECONDARIA II GRADO,1,5,0,5,1,4
202223,VE1E005007,SCUOLA PRIMARIA,5,21,21,0,0,0
202223,NA1M03300T,SCUOLA SECONDARIA I GRADO,2,26,24,2,0,2
202223,VAPMCL500Q,SCUOLA SECONDARIA II GRADO,2,18,18,0,0,0
202223,CTPM40500E,SCUOLA SECONDARIA II GRADO,5,19,18,1,0,1
202223,SATNV3500O,SCUOLA SECONDARIA II GRADO,4,4,4,0,0,0
202223,CO1E00900A,SCUOLA PRIMARIA,4,45,43,2,2,0
202223,CN1E00300P,SCUOLA PRIMARIA,2,14,14,0,0,0
202223,AQ1E00700D,SCUOLA PRIMARIA,2,28,28,0,0,0
202223,PA1E01700G,SCUOLA PRIMARIA,1,44,44,0,0,0
202223,RMTD00500C,SCUOLA SECONDARIA II GRADO,2,2,2,0,0,0
202223,LT1E00200R,SCUOLA PRIMARIA,4,28,25,3,1,2
202223,PGPC00500C,SCUOLA SECONDARIA II GRADO,4,4,4,0,0,0
202223,RMPS59500C,SCUOLA SECONDARIA II GRADO,1,9,8,1,0,1
202223,RMPS335003,SCUOLA SECONDARIA II GRADO,2,42,41,1,1,0
202223,SP1E002008,SCUOLA PRIMARIA,5,21,20,1,0,1
202223,REPM7R500G,SCUOLA SECONDARIA II GRADO,2,9,9,0,0,0
202223,BSPM6Z500C,SCUOLA SECONDARIA II GRADO,1,28,27,1,0,1
202223,PA1EDC5004,SCUOLA PRIMARIA,1,6,5,1,0,1
202223,NATDU1500D,SCUOLA SECONDARIA II GRADO,4,4,4,0,0,0
202223,CATF955004,SCUOLA SECONDARIA II GRADO,3,14,14,0,0,0
202223,RMRH00500A,SCUOLA SECONDARIA II GRADO,4,14,12,2,1,1
202223,FE1M00200P,SCUOLA SECONDARIA I GRADO,3,31,31,0,0,0
202223,FG1E01400A,SCUOLA PRIMARIA,4,21,20,1,0,1
202223,RMPSPL500P,SCUOLA SECONDARIA II GRADO,2,13,11,2,0,2
202223,AQ1E00500T,SCUOLA PRIMARIA,1,20,20,0,0,0
202223,MITL485005,SCUOLA SECONDARIA II GRADO,4,27,20,7,0,7
202223,BG1E01200B,SCUOLA PRIMARIA,2,47,46,1,1,0
202223,NA1E192009,SCUOLA PRIMARIA,4,10,10,0,0,0
202223,SR1E005001,SCUOLA PRIMARIA,1,14,10,4,0,4
202223,BOPLUH500M,SCUOLA SECONDARIA II GRADO,1,29,29,0,0,0
202223,VI1E01200N,SCUOLA PRIMARIA,1,27,22,5,1,4
202223,NA1E20300E,SCUOLA PRIMARIA,5,16,16,0,0,0
202223,RM1M002005,SCUOLA SECONDARIA I GRADO,1,11,11,0,0,0
202223,RM1E7V500S,SCUOLA PRIMARIA,4,10,10,0,0,0
202223,LC1E004001,SCUOLA PRIMARIA,5,24,24,0,0,0
202223,TOPS125006,SCUOLA SECONDARIA II GRADO,2,3,1,2,2,0
202223,NATDR0500L,SCUOLA SECONDARIA II GRADO,1,8,8,0,0,0
202223,RMRF9P500F,SCUOLA SECONDARIA II GRADO,3,6,5,1,1,0
202223,MIPLVI500L,SCUOLA SECONDARIA II GRADO,2,25,23,2,0,2
202223,RM1M036008,SCUOLA SECONDARIA I GRADO,3,33,33,0,0,0
202223,PVPS775003,SCUOLA SECONDARIA II GRADO,3,7,5,2,1,1
202223,MI1EBF500V,SCUOLA PRIMARIA,3,28,27,1,0,1
202223,MI1M050002,SCUOLA SECONDARIA I GRADO,3,21,20,1,0,1
202223,NAPL41500E,SCUOLA SECONDARIA II GRADO,5,32,31,1,1,0
202223,CE1E03900N,SCUOLA PRIMARIA,5,28,27,1,0,1
202223,ME1E01200P,SCUOLA PRIMARIA,2,15,15,0,0,0
202223,IM1E00400R,SCUOLA PRIMARIA,2,17,15,2,0,2
202223,BS1EUE5000,SCUOLA PRIMARIA,1,14,13,1,1,0
202223,PR1E00300Q,SCUOLA PRIMARIA,4,26,24,2,0,2
202223,PA1EAT500P,SCUOLA PRIMARIA,3,51,49,2,0,2
202223,FI1E01000Q,SCUOLA PRIMARIA,4,23,23,0,0,0
202223,VRPS3P500M,SCUOLA SECONDARIA II GRADO,2,25,25,0,0,0
202223,MB1EVP500T,SCUOLA PRIMARIA,4,16,16,0,0,0
202223,NA1E23000V,SCUOLA PRIMARIA,2,11,11,0,0,0
202223,TE1EDS5004,SCUOLA PRIMARIA,2,6,6,0,0,0
202223,PVPMF55003,SCUOLA SECONDARIA II GRADO,4,11,10,1,1,0
202223,CHTL31500X,SCUOLA SECONDARIA II GRADO,2,1,1,0,0,0
202223,NA1E17400Q,SCUOLA PRIMARIA,1,12,12,0,0,0
202223,LC1M10100G,SCUOLA SECONDARIA I GRADO,3,72,72,0,0,0
202223,NA1E078006,SCUOLA PRIMARIA,3,19,18,1,0,1
202223,TV1E01100E,SCUOLA PRIMARIA,2,15,13,2,0,2
202223,FRPM9G500T,SCUOLA SECONDARIA II GRADO,1,3,3,0,0,0
202223,LT1E005008,SCUOLA PRIMARIA,5,38,38,0,0,0
202223,CERVEN500Q,SCUOLA SECONDARIA II GRADO,1,8,8,0,0,0
202223,TO1M048002,SCUOLA SECONDARIA I GRADO,3,44,44,0,0,0
202223,TO1EPI500H,SCUOLA PRIMARIA,1,18,17,1,0,1
202223,SATFNZ5007,SCUOLA SECONDARIA II GRADO,3,2,2,0,0,0
202223,RMPM3Q500P,SCUOLA SECONDARIA II GRADO,1,4,4,0,0,0
202223,APRFSQ500B,SCUOLA SECONDARIA II GRADO,5,28,26,2,0,2
202223,NOSL015004,SCUOLA SECONDARIA II GRADO,2,2,2,0,0,0
202223,VAPSQ4500H,SCUOLA SECONDARIA II GRADO,4,33,32,1,0,1
202223,RMTD70500E,SCUOLA SECONDARIA II GRADO,5,45,41,4,2,2
202223,RM1E02000D,SCUOLA PRIMARIA,4,18,16,2,1,1
202223,TOPST1500C,SCUOLA SECONDARIA II GRADO,3,15,14,1,1,0
202223,MI1E00800A,SCUOLA PRIMARIA,2,67,66,1,0,1
202223,NO1M00900X,SCUOLA SECONDARIA I GRADO,1,65,63,2,1,1
202223,RM1E065003,SCUOLA PRIMARIA,4,25,23,2,2,0
202223,PTPS3N5004,SCUOLA SECONDARIA II GRADO,1,12,12,0,0,0
202223,MIPS01500P,SCUOLA SECONDARIA II GRADO,1,39,39,0,0,0
202223,LU1E00700B,SCUOLA PRIMARIA,5,24,24,0,0,0
202223,CTPL145004,SCUOLA SECONDARIA II GRADO,3,2,2,0,0,0
202223,AVTDAS5006,SCUOLA SECONDARIA II GRADO,1,5,5,0,0,0
202223,BN1E82500A,SCUOLA PRIMARIA,3,15,15,0,0,0
202223,NA1E12000B,SCUOLA PRIMARIA,3,10,9,1,0,1
202223,TO1M05200N,SCUOLA SECONDARIA I GRADO,1,120,115,5,1,4
202223,NA1E094004,SCUOLA PRIMARIA,2,14,13,1,0,1
202223,CERH015004,SCUOLA SECONDARIA II GRADO,1,22,22,0,0,0
202223,CR1E00200P,SCUOLA PRIMARIA,2,23,21,2,2,0
202223,RM1M08500D,SCUOLA SECONDARIA I GRADO,2,25,25,0,0,0
202223,MN1E00200X,SCUOLA PRIMARIA,5,42,38,4,2,2
202223,BATD07500E,SCUOLA SECONDARIA II GRADO,5,13,12,1,0,1
202223,TO1E05200C,SCUOLA PRIMARIA,4,19,19,0,0,0
202223,MIPMGC500D,SCUOLA SECONDARIA II GRADO,5,22,21,1,1,0
202223,SATDST500C,SCUOLA SECONDARIA II GRADO,2,5,5,0,0,0
202223,SATD2H5007,SCUOLA SECONDARIA II GRADO,4,2,2,0,0,0
202223,PAPC1H500H,SCUOLA SECONDARIA II GRADO,2,22,22,0,0,0
202223,MIPC075007,SCUOLA SECONDARIA II GRADO,2,37,37,0,0,0
202223,TOPL11500A,SCUOLA SECONDARIA II GRADO,5,15,15,0,0,0
202223,FIPMRR500G,SCUOLA SECONDARIA II GRADO,4,17,17,0,0,0
202223,NAPS045004,SCUOLA SECONDARIA II GRADO,5,18,18,0,0,0
202223,RM1M05000E,SCUOLA SECONDARIA I GRADO,2,34,32,2,0,2
202223,NAPS92500P,SCUOLA SECONDARIA II GRADO,2,27,25,2,0,2
202223,CA1E00200L,SCUOLA PRIMARIA,3,16,16,0,0,0
202223,RM1E01800D,SCUOLA PRIMARIA,1,9,7,2,0,2
202223,SARF195006,SCUOLA SECONDARIA II GRADO,2,3,3,0,0,0
202223,VR1E00200B,SCUOLA PRIMARIA,2,11,8,3,0,3
202223,CE1E06300E,SCUOLA PRIMARIA,1,15,8,7,4,3
202223,PAPSTT500B,SCUOLA SECONDARIA II GRADO,3,5,5,0,0,0
202223,CTTF01500P,SCUOLA SECONDARIA II GRADO,4,2,2,0,0,0
202223,SV1M00500B,SCUOLA SECONDARIA I GRADO,2,6,5,1,0,1
202223,MITD11500B,SCUOLA SECONDARIA II GRADO,1,5,2,3,0,3
202223,VAPS1O500A,SCUOLA SECONDARIA II GRADO,3,18,18,0,0,0
202223,VT1E002002,SCUOLA PRIMARIA,1,20,19,1,1,0
202223,BNTDHO5008,SCUOLA SECONDARIA II GRADO,3,4,4,0,0,0
202223,VRPM01500Q,SCUOLA SECONDARIA II GRADO,2,42,41,1,0,1
202223,NA1E149003,SCUOLA PRIMARIA,5,4,4,0,0,0
202223,NA1E15300P,SCUOLA PRIMARIA,5,10,10,0,0,0
202223,BG1E01700E,SCUOLA PRIMARIA,5,13,7,6,0,6
202223,BG1E02900R,SCUOLA PRIMARIA,5,106,102,4,1,3
202223,MIPS4M500V,SCUOLA SECONDARIA II GRADO,4,9,9,0,0,0
202223,RM1M07200B,SCUOLA SECONDARIA I GRADO,3,13,4,9,0,9
202223,NAPS5M500T,SCUOLA SECONDARIA II GRADO,2,14,7,7,3,4
202223,MBPL73500N,SCUOLA SECONDARIA II GRADO,1,12,12,0,0,0
202223,RM1E17300V,SCUOLA PRIMARIA,1,18,16,2,0,2
202223,LETD075009,SCUOLA SECONDARIA II GRADO,5,60,59,1,1,0
202223,MI1E140003,SCUOLA PRIMARIA,3,35,33,2,0,2
202223,SASLFZ5001,SCUOLA SECONDARIA II GRADO,3,3,3,0,0,0
202223,SARFD1500N,SCUOLA SECONDARIA II GRADO,4,2,2,0,0,0
202223,FR1E001009,SCUOLA PRIMARIA,3,22,22,0,0,0
202223,RM1E00400G,SCUOLA PRIMARIA,5,35,32,3,0,3
202223,PAPS8N500C,SCUOLA SECONDARIA II GRADO,1,9,9,0,0,0
202223,RNPC015002,SCUOLA SECONDARIA II GRADO,3,13,13,0,0,0
202223,PO1E00300L,SCUOLA PRIMARIA,4,44,32,12,0,12
202223,VAPLL0500E,SCUOLA SECONDARIA II GRADO,3,5,5,0,0,0
202223,TO1EDV500F,SCUOLA PRIMARIA,1,10,10,0,0,0
202223,RMPME45007,SCUOLA SECONDARIA II GRADO,4,5,5,0,0,0
202223,FIPS04500X,SCUOLA SECONDARIA II GRADO,4,32,31,1,0,1
202223,RCTDBT500S,SCUOLA SECONDARIA II GRADO,2,8,8,0,0,0
202223,BS1E008008,SCUOLA PRIMARIA,2,34,34,0,0,0
202223,MI1M09400Q,SCUOLA SECONDARIA I GRADO,3,24,23,1,1,0
202223,LEPL01500L,SCUOLA SECONDARIA II GRADO,4,10,10,0,0,0
202223,CS1E00400T,SCUOLA PRIMARIA,4,6,6,0,0,0
202223,FI1E030001,SCUOLA PRIMARIA,1,12,12,0,0,0
202223,TO1E03500P,SCUOLA PRIMARIA,2,84,82,2,1,1
202223,RM1E08400C,SCUOLA PRIMARIA,3,48,48,0,0,0
202223,VA1E9G500A,SCUOLA PRIMARIA,3,17,17,0,0,0
202223,VA1E41500F,SCUOLA PRIMARIA,1,17,15,2,1,1
202223,VTTD015005,SCUOLA SECONDARIA II GRADO,3,18,18,0,0,0
202223,LTRFGQ5000,SCUOLA SECONDARIA II GRADO,4,6,6,0,0,0
202223,CT1ELO5000,SCUOLA PRIMARIA,5,21,20,1,0,1
202223,VE1E013006,SCUOLA PRIMARIA,4,19,17,2,0,2
202223,BGPL16500Q,SCUOLA SECONDARIA II GRADO,4,21,20,1,0,1
202223,NA1E04100G,SCUOLA PRIMARIA,2,46,46,0,0,0
202223,NA1E04600P,SCUOLA PRIMARIA,4,20,19,1,0,1
202223,VR1M00700Q,SCUOLA SECONDARIA I GRADO,2,56,55,1,1,0
202223,COPCCE5008,SCUOLA SECONDARIA II GRADO,3,17,14,3,0,3
202223,CE1E00300V,SCUOLA PRIMARIA,1,10,10,0,0,0
202223,RM1M128006,SCUOLA SECONDARIA I GRADO,1,82,79,3,1,2
202223,MI1M08100N,SCUOLA SECONDARIA I GRADO,2,42,41,1,0,1
202223,SA1MR95005,SCUOLA SECONDARIA I GRADO,2,5,5,0,0,0
202223,SA1E02900B,SCUOLA PRIMARIA,2,42,41,1,0,1
202223,CA1E020006,SCUOLA PRIMARIA,1,22,20,2,0,2
202223,VI1E00900T,SCUOLA PRIMARIA,4,23,23,0,0,0
202223,MERHFN500I,SCUOLA SECONDARIA II GRADO,5,34,34,0,0,0
202223,BSPMN8500Q,SCUOLA SECONDARIA II GRADO,3,21,20,1,0,1
202223,NA1E23100P,SCUOLA PRIMARIA,5,22,22,0,0,0
202223,NATFFL500P,SCUOLA SECONDARIA II GRADO,2,20,20,0,0,0
202223,NA1E27900Q,SCUOLA PRIMARIA,3,11,11,0,0,0
202223,MIPLGB500O,SCUOLA SECONDARIA II GRADO,4,20,20,0,0,0
202223,FG1M002009,SCUOLA SECONDARIA I GRADO,2,27,26,1,0,1
202223,CT1E053006,SCUOLA PRIMARIA,5,21,21,0,0,0
202223,SATF6U5006,SCUOLA SECONDARIA II GRADO,1,5,5,0,0,0
202223,TVPSN55005,SCUOLA SECONDARIA II GRADO,2,15,15,0,0,0
202223,TO1E01300T,SCUOLA PRIMARIA,2,50,48,2,1,1
202223,SAPME1500D,SCUOLA SECONDARIA II GRADO,4,10,9,1,1,0
202223,AP1E006003,SCUOLA PRIMARIA,2,16,16,0,0,0
202223,NA1E16000T,SCUOLA PRIMARIA,1,20,20,0,0,0
202223,CLPC025003,SCUOLA SECONDARIA II GRADO,4,5,5,0,0,0
202223,NA1E185006,SCUOLA PRIMARIA,3,24,24,0,0,0
202223,RN1E00800R,SCUOLA PRIMARIA,3,87,82,5,1,4
202223,RG1E00300C,SCUOLA PRIMARIA,2,24,24,0,0,0
202223,MB1E05500R,SCUOLA PRIMARIA,1,60,58,2,1,1
202223,BO1E018008,SCUOLA PRIMARIA,2,17,15,2,1,1
202223,PEPS995008,SCUOLA SECONDARIA II GRADO,3,4,4,0,0,0
202223,BGPSQZ500T,SCUOLA SECONDARIA II GRADO,2,19,18,1,0,1
202223,ME1EOF500O,SCUOLA PRIMARIA,2,42,42,0,0,0
202223,SS1E01100Q,SCUOLA PRIMARIA,5,10,7,3,0,3
202223,RM1E15900L,SCUOLA PRIMARIA,4,22,22,0,0,0
202223,NATF32500G,SCUOLA SECONDARIA II GRADO,2,4,4,0,0,0
202223,COPSNU500Z,SCUOLA SECONDARIA II GRADO,3,6,6,0,0,0
202223,MI1MIN5009,SCUOLA SECONDARIA I GRADO,2,38,37,1,0,1
202223,SATFIF5007,SCUOLA SECONDARIA II GRADO,1,13,12,1,0,1
202223,PATD475004,SCUOLA SECONDARIA II GRADO,4,5,5,0,0,0
202223,NA1E13800L,SCUOLA PRIMARIA,2,13,13,0,0,0
202223,RM1M02100E,SCUOLA SECONDARIA I GRADO,1,74,73,1,1,0
202223,PCPSD7500T,SCUOLA SECONDARIA II GRADO,2,25,25,0,0,0
202223,CSTDIB500Z,SCUOLA SECONDARIA II GRADO,1,7,7,0,0,0
202223,MIPSQ55000,SCUOLA SECONDARIA II GRADO,2,19,19,0,0,0
202223,RMSL015004,SCUOLA SECONDARIA II GRADO,1,22,21,1,1,0
202223,PV1M00500T,SCUOLA SECONDARIA I GRADO,2,54,52,2,1,1
202223,MI1E13000C,SCUOLA PRIMARIA,1,32,32,0,0,0
202223,TO1E003007,SCUOLA PRIMARIA,1,39,39,0,0,0
202223,PNTD7Z500U,SCUOLA SECONDARIA II GRADO,2,11,9,2,2,0
202223,SARHV4500U,SCUOLA SECONDARIA II GRADO,1,8,8,0,0,0
202223,MI1E01300T,SCUOLA PRIMARIA,2,37,36,1,0,1
202223,NAPC08500B,SCUOLA SECONDARIA II GRADO,4,22,22,0,0,0
202223,RGTD04500G,SCUOLA SECONDARIA II GRADO,2,3,3,0,0,0
202223,MCPMOP500O,SCUOLA SECONDARIA II GRADO,1,3,3,0,0,0
202223,VA1M012005,SCUOLA SECONDARIA I GRADO,3,103,100,3,0,3
202223,VC1E00100P,SCUOLA PRIMARIA,5,19,18,1,0,1
202223,PDPS02500G,SCUOLA SECONDARIA II GRADO,5,44,44,0,0,0
202223,CO1M02400N,SCUOLA SECONDARIA I GRADO,3,35,35,0,0,0
202223,RMTD78500B,SCUOLA SECONDARIA II GRADO,2,3,3,0,0,0
202223,MIPS74500L,SCUOLA SECONDARIA II GRADO,4,15,15,0,0,0
202223,BS1E008008,SCUOLA PRIMARIA,3,38,36,2,2,0
202223,RMSL3E5005,SCUOLA SECONDARIA II GRADO,2,7,6,1,0,1
202223,MOPS01500X,SCUOLA SECONDARIA II GRADO,5,13,13,0,0,0
202223,RMPS4A500Z,SCUOLA SECONDARIA II GRADO,3,19,19,0,0,0
202223,MI1E011006,SCUOLA PRIMARIA,1,22,17,5,0,5
202223,VA1E003005,SCUOLA PRIMARIA,5,15,15,0,0,0
202223,NARF6T500Q,SCUOLA SECONDARIA II GRADO,5,33,30,3,1,2
202223,RM1ERR500T,SCUOLA PRIMARIA,4,7,6,1,0,1
202223,KR1M00100A,SCUOLA SECONDARIA I GRADO,3,17,17,0,0,0
202223,LC1E009004,SCUOLA PRIMARIA,4,25,25,0,0,0
202223,BG1M01100R,SCUOLA SECONDARIA I GRADO,1,32,31,1,0,1
202223,GE1E03000T,SCUOLA PRIMARIA,1,24,21,3,0,3
202223,PDPM00500B,SCUOLA SECONDARIA II GRADO,4,41,41,0,0,0
202223,NA1E247008,SCUOLA PRIMARIA,3,11,11,0,0,0
202223,ENSD01500A,SCUOLA SECONDARIA II GRADO,2,23,22,1,0,1
202223,MC1M8S500G,SCUOLA SECONDARIA I GRADO,3,17,17,0,0,0
202223,MI1E07300D,SCUOLA PRIMARIA,2,35,35,0,0,0
202223,TOTD08500R,SCUOLA SECONDARIA II GRADO,1,12,11,1,0,1
202223,RM1E028004,SCUOLA PRIMARIA,3,15,14,1,0,1
202223,ME1E001008,SCUOLA PRIMARIA,3,22,20,2,0,2
202223,TOPLM6500B,SCUOLA SECONDARIA II GRADO,2,5,5,0,0,0
202223,COTL045001,SCUOLA SECONDARIA II GRADO,3,3,2,1,1,0
202223,NA1E25300G,SCUOLA PRIMARIA,4,14,14,0,0,0
202223,BGTF9O500Q,SCUOLA SECONDARIA II GRADO,1,13,13,0,0,0
202223,RM1E128001,SCUOLA PRIMARIA,2,24,24,0,0,0
202223,FE1E004005,SCUOLA PRIMARIA,1,25,22,3,2,1
202223,MC1E001003,SCUOLA PRIMARIA,2,21,21,0,0,0
202223,BNTD02500Q,SCUOLA SECONDARIA II GRADO,1,11,10,1,0,1
202223,RMPC08500A,SCUOLA SECONDARIA II GRADO,4,79,78,1,0,1
202223,MOPS0N500H,SCUOLA SECONDARIA II GRADO,3,19,19,0,0,0
202223,MITF105003,SCUOLA SECONDARIA II GRADO,5,26,24,2,0,2
202223,CHRI00500N,SCUOLA SECONDARIA II GRADO,1,3,3,0,0,0
202223,PVTD05500P,SCUOLA SECONDARIA II GRADO,4,20,18,2,0,2
202223,RMPSHR5005,SCUOLA SECONDARIA II GRADO,4,6,6,0,0,0
202223,NA1E18900D,SCUOLA PRIMARIA,4,39,39,0,0,0
202223,TV1E013006,SCUOLA PRIMARIA,4,21,21,0,0,0
202223,LE1E009009,SCUOLA PRIMARIA,4,9,9,0,0,0
202223,NAPMS6500L,SCUOLA SECONDARIA II GRADO,3,6,6,0,0,0
202223,NAPMUF500A,SCUOLA SECONDARIA II GRADO,1,6,6,0,0,0
202223,CTTF005004,SCUOLA SECONDARIA II GRADO,5,12,12,0,0,0
202223,MCTD00500B,SCUOLA SECONDARIA II GRADO,3,2,1,1,0,1
202223,MITB025006,SCUOLA SECONDARIA II GRADO,1,43,32,11,1,10
202223,BSPMS9500M,SCUOLA SECONDARIA II GRADO,1,62,58,4,0,4
202223,VATD18500G,SCUOLA SECONDARIA II GRADO,5,18,17,1,0,1
202223,NATFPQ500Q,SCUOLA SECONDARIA II GRADO,3,5,5,0,0,0
202223,MI1E11800T,SCUOLA PRIMARIA,2,45,43,2,0,2
202223,MI1E03000G,SCUOLA PRIMARIA,2,24,23,1,0,1
202223,CETL04500C,SCUOLA SECONDARIA II GRADO,3,3,3,0,0,0
202223,TV1M00900Q,SCUOLA SECONDARIA I GRADO,2,24,24,0,0,0
202223,TV1E005007,SCUOLA PRIMARIA,2,22,22,0,0,0
202223,CETF4P500Q,SCUOLA SECONDARIA II GRADO,2,11,11,0,0,0
202223,BSPS06500N,SCUOLA SECONDARIA II GRADO,5,24,24,0,0,0
202223,VE1E01100E,SCUOLA PRIMARIA,1,25,25,0,0,0
202223,FI1E00800Q,SCUOLA PRIMARIA,4,13,10,3,0,3
202223,UDTF00500V,SCUOLA SECONDARIA II GRADO,4,43,40,3,1,2
202223,VRRI01500X,SCUOLA SECONDARIA II GRADO,1,7,3,4,1,3
202223,AQ1E00500T,SCUOLA PRIMARIA,2,16,15,1,1,0
202223,BS1E01300Q,SCUOLA PRIMARIA,4,18,18,0,0,0
202223,NA1E227003,SCUOLA PRIMARIA,5,7,7,0,0,0
202223,RM1E03900E,SCUOLA PRIMARIA,3,17,16,1,1,0
202223,MI1M07500A,SCUOLA SECONDARIA I GRADO,3,74,71,3,0,3
202223,VI1E002003,SCUOLA PRIMARIA,2,23,23,0,0,0
202223,SRRHFP500H,SCUOLA SECONDARIA II GRADO,1,3,3,0,0,0
202223,SP1E00500Q,SCUOLA PRIMARIA,4,27,27,0,0,0
202223,MIPM1R500Q,SCUOLA SECONDARIA II GRADO,5,11,11,0,0,0
202223,BOTB02500D,SCUOLA SECONDARIA II GRADO,4,8,8,0,0,0
202223,RO1M00300G,SCUOLA SECONDARIA I GRADO,3,16,15,1,1,0
202223,NARHM0500C,SCUOLA SECONDARIA II GRADO,1,3,3,0,0,0
202223,AVTF765001,SCUOLA SECONDARIA II GRADO,3,4,4,0,0,0
202223,VASLAA500P,SCUOLA SECONDARIA II GRADO,5,12,12,0,0,0
202223,BLPM01500Q,SCUOLA SECONDARIA II GRADO,5,31,30,1,0,1
202223,APTDCF500V,SCUOLA SECONDARIA II GRADO,5,52,45,7,1,6
202223,NA1E127006,SCUOLA PRIMARIA,3,49,49,0,0,0
202223,NA1E10400D,SCUOLA PRIMARIA,5,12,12,0,0,0
202223,NA1E221004,SCUOLA PRIMARIA,3,15,12,3,0,3
202223,VETN745000,SCUOLA SECONDARIA II GRADO,1,25,25,0,0,0
202223,CA1E01000G,SCUOLA PRIMARIA,3,19,19,0,0,0
202223,TOPSA6500N,SCUOLA SECONDARIA II GRADO,2,9,7,2,0,2
202223,RM1E04700D,SCUOLA PRIMARIA,4,17,17,0,0,0
202223,MB1E040003,SCUOLA PRIMARIA,3,18,18,0,0,0
202223,MB1E09200Q,SCUOLA PRIMARIA,4,17,16,1,1,0
202223,MI1M04600A,SCUOLA SECONDARIA I GRADO,2,48,48,0,0,0
202223,AGTD02500N,SCUOLA SECONDARIA II GRADO,2,4,4,0,0,0
202223,FI1E022002,SCUOLA PRIMARIA,3,24,23,1,0,1
202223,AL1E00600T,SCUOLA PRIMARIA,1,37,28,9,2,7
202223,BO1M01300A,SCUOLA SECONDARIA I GRADO,2,45,45,0,0,0
202223,MIPM0O500U,SCUOLA SECONDARIA II GRADO,4,39,39,0,0,0
202223,FI1ECP5008,SCUOLA PRIMARIA,1,13,7,6,1,5
202223,SVPS015002,SCUOLA SECONDARIA II GRADO,5,33,33,0,0,0
202223,PRPSNN500M,SCUOLA SECONDARIA II GRADO,2,6,6,0,0,0
202223,RM1E143003,SCUOLA PRIMARIA,3,25,25,0,0,0
202223,NATDS2500B,SCUOLA SECONDARIA II GRADO,4,9,8,1,0,1
202223,RC1E01000Q,SCUOLA PRIMARIA,5,18,18,0,0,0
202223,MIPL30500D,SCUOLA SECONDARIA II GRADO,4,8,7,1,0,1
202223,RM1E11100G,SCUOLA PRIMARIA,4,25,25,0,0,0
202223,FIPS065005,SCUOLA SECONDARIA II GRADO,4,9,9,0,0,0
202223,BN1E001006,SCUOLA PRIMARIA,1,38,37,1,0,1
202223,GO1E00100A,SCUOLA PRIMARIA,2,23,23,0,0,0
202223,RM1M11600X,SCUOLA SECONDARIA I GRADO,1,51,47,4,0,4
202223,RM1M03400L,SCUOLA SECONDARIA I GRADO,1,34,34,0,0,0
202223,MI1E053008,SCUOLA PRIMARIA,5,80,80,0,0,0
202223,NATL25500P,SCUOLA SECONDARIA II GRADO,4,12,12,0,0,0
202223,AP1E00400B,SCUOLA PRIMARIA,1,13,13,0,0,0
202223,CHTL31500X,SCUOLA SECONDARIA II GRADO,3,5,4,1,0,1
202223,MI1E2B5001,SCUOLA PRIMARIA,3,17,16,1,0,1
202223,RMTFNG5000,SCUOLA SECONDARIA II GRADO,5,21,19,2,1,1
202223,PEPMPL500U,SCUOLA SECONDARIA II GRADO,3,21,21,0,0,0
202223,TS1E006009,SCUOLA PRIMARIA,1,19,19,0,0,0
202223,BS1M00200E,SCUOLA SECONDARIA I GRADO,1,26,24,2,0,2
202223,PR1E00900P,SCUOLA PRIMARIA,3,27,27,0,0,0
202223,AV1ETA500G,SCUOLA PRIMARIA,5,3,3,0,0,0
202223,NATFI7500T,SCUOLA SECONDARIA II GRADO,5,123,121,2,0,2
202223,VRSL01500G,SCUOLA SECONDARIA II GRADO,4,2,2,0,0,0
202223,BNTDDC500S,SCUOLA SECONDARIA II GRADO,1,8,8,0,0,0
202223,BI1E00200D,SCUOLA PRIMARIA,2,19,18,1,0,1
202223,CT1E02100P,SCUOLA PRIMARIA,4,5,5,0,0,0
202223,NAPS265003,SCUOLA SECONDARIA II GRADO,2,10,10,0,0,0
202223,AP1E00100X,SCUOLA PRIMARIA,3,15,14,1,0,1
202223,NA1E08200T,SCUOLA PRIMARIA,1,16,16,0,0,0
202223,LC1M05000X,SCUOLA SECONDARIA I GRADO,2,56,54,2,0,2
202223,FIPL005008,SCUOLA SECONDARIA II GRADO,1,5,5,0,0,0
202223,CETAVH500S,SCUOLA SECONDARIA II GRADO,5,18,18,0,0,0
202223,MI1E07700R,SCUOLA PRIMARIA,3,20,20,0,0,0
202223,CB1E002007,SCUOLA PRIMARIA,4,22,21,1,1,0
202223,SATFH5500B,SCUOLA SECONDARIA II GRADO,5,22,22,0,0,0
202223,CE1E01700R,SCUOLA PRIMARIA,4,17,17,0,0,0
202223,MI1E08100C,SCUOLA PRIMARIA,4,18,16,2,0,2
202223,FIPSZD500T,SCUOLA SECONDARIA II GRADO,5,15,14,1,0,1
202223,CRPSVN500C,SCUOLA SECONDARIA II GRADO,1,29,27,2,2,0
202223,PN1E001008,SCUOLA PRIMARIA,4,36,36,0,0,0
202223,TO1E02700Q,SCUOLA PRIMARIA,1,47,43,4,1,3
202223,FIPC04500R,SCUOLA SECONDARIA II GRADO,5,4,4,0,0,0
202223,LTPLCG500C,SCUOLA SECONDARIA II GRADO,2,6,6,0,0,0
202223,VR1M01000G,SCUOLA SECONDARIA I GRADO,2,22,20,2,1,1
202223,RM1E06100Q,SCUOLA PRIMARIA,5,30,29,1,0,1
202223,RMPM045004,SCUOLA SECONDARIA II GRADO,2,6,6,0,0,0
202223,UD1M00600L,SCUOLA SECONDARIA I GRADO,2,93,85,8,3,5
202223,CN1EN55004,SCUOLA PRIMARIA,4,17,16,1,0,1
202223,CR1E00400A,SCUOLA PRIMARIA,4,16,15,1,0,1
202223,MB1EQT500D,SCUOLA PRIMARIA,2,17,17,0,0,0
202223,BA1MDT500L,SCUOLA SECONDARIA I GRADO,2,21,20,1,0,1
202223,TOTF055007,SCUOLA SECONDARIA II GRADO,5,35,33,2,0,2
202223,RMPS56500L,SCUOLA SECONDARIA II GRADO,4,6,6,0,0,0
202223,TO1E05600Q,SCUOLA PRIMARIA,3,19,18,1,1,0
202223,AGTD2M5007,SCUOLA SECONDARIA II GRADO,1,6,6,0,0,0
202223,TO1E05000R,SCUOLA PRIMARIA,2,21,21,0,0,0
202223,PSTF005006,SCUOLA SECONDARIA II GRADO,1,31,29,2,1,1
202223,BORC10500R,SCUOLA SECONDARIA II GRADO,1,29,28,1,0,1
202223,PG1E4Q500B,SCUOLA PRIMARIA,2,11,9,2,0,2
202223,RM1M01200Q,SCUOLA SECONDARIA I GRADO,3,48,44,4,2,2
202223,SATD27500X,SCUOLA SECONDARIA II GRADO,4,4,4,0,0,0
202223,MIPC09500C,SCUOLA SECONDARIA II GRADO,5,46,46,0,0,0
202223,MIPC15500V,SCUOLA SECONDARIA II GRADO,4,27,27,0,0,0
202223,FIPLZD500L,SCUOLA SECONDARIA II GRADO,5,12,11,1,1,0
202223,PC1E00300V,SCUOLA PRIMARIA,1,26,26,0,0,0
202223,RMPMR25005,SCUOLA SECONDARIA II GRADO,4,5,5,0,0,0
202223,BA1E026008,SCUOLA PRIMARIA,5,26,26,0,0,0
202223,SAPL3T500R,SCUOLA SECONDARIA II GRADO,5,70,65,5,2,3
202223,MI1M03700G,SCUOLA SECONDARIA I GRADO,1,20,20,0,0,0
202223,TO1E04800R,SCUOLA PRIMARIA,1,14,14,0,0,0
202223,BGPS1G5008,SCUOLA SECONDARIA II GRADO,1,23,23,0,0,0
202223,VTPM7D500R,SCUOLA SECONDARIA II GRADO,2,14,13,1,0,1
202223,VA1EZH500L,SCUOLA PRIMARIA,4,16,15,1,0,1
202223,FO1E00400N,SCUOLA PRIMARIA,5,65,65,0,0,0
202223,MITDGN5002,SCUOLA SECONDARIA II GRADO,1,18,11,7,1,6
202223,BS1M02100X,SCUOLA SECONDARIA I GRADO,2,41,40,1,0,1
202223,VATF295009,SCUOLA SECONDARIA II GRADO,4,21,21,0,0,0
202223,RM1E16100L,SCUOLA PRIMARIA,3,17,15,2,1,1
202223,RM1E13800G,SCUOLA PRIMARIA,3,67,66,1,0,1
202223,VRPL06500E,SCUOLA SECONDARIA II GRADO,4,15,13,2,1,1
202223,AV1ETA500G,SCUOLA PRIMARIA,1,6,6,0,0,0
202223,SATF5M500Z,SCUOLA SECONDARIA II GRADO,3,3,1,2,2,0
202223,MOTD01500Q,SCUOLA SECONDARIA II GRADO,2,15,14,1,0,1
202223,GR1E00100D,SCUOLA PRIMARIA,4,26,26,0,0,0
202223,MB1M02800N,SCUOLA SECONDARIA I GRADO,2,30,29,1,0,1
202223,RMPMT1500R,SCUOLA SECONDARIA II GRADO,5,10,8,2,0,2
202223,REPS00500P,SCUOLA SECONDARIA II GRADO,3,7,6,1,1,0
202223,PAPS00500E,SCUOLA SECONDARIA II GRADO,1,3,3,0,0,0
202223,PASD005001,SCUOLA SECONDARIA II GRADO,5,103,103,0,0,0
202223,VTTD015005,SCUOLA SECONDARIA II GRADO,2,6,5,1,0,1
202223,CETFOD5002,SCUOLA SECONDARIA II GRADO,2,8,6,2,0,2
202223,VAPS92500G,SCUOLA SECONDARIA II GRADO,1,21,20,1,1,0
202223,TO1M01100B,SCUOLA SECONDARIA I GRADO,1,31,31,0,0,0
202223,RMPL22500A,SCUOLA SECONDARIA II GRADO,5,47,41,6,1,5
202223,MO1E01100B,SCUOLA PRIMARIA,3,45,43,2,0,2
202223,VI1E00400P,SCUOLA PRIMARIA,4,37,35,2,1,1
202223,VEPL4H500R,SCUOLA SECONDARIA II GRADO,2,10,10,0,0,0
202223,RM1E09100G,SCUOLA PRIMARIA,3,12,11,1,0,1
202223,RM1E08800Q,SCUOLA PRIMARIA,4,17,17,0,0,0
202223,REPLP0500O,SCUOLA SECONDARIA II GRADO,3,8,8,0,0,0
202223,GE1E01000L,SCUOLA PRIMARIA,3,28,28,0,0,0
202223,AL1M006003,SCUOLA SECONDARIA I GRADO,1,35,33,2,1,1
202223,RM1EGU500T,SCUOLA PRIMARIA,3,24,24,0,0,0
202223,VE1E00800P,SCUOLA PRIMARIA,4,9,9,0,0,0
202223,TO1M01600E,SCUOLA SECONDARIA I GRADO,3,69,68,1,1,0
202223,BSPMN8500Q,SCUOLA SECONDARIA II GRADO,4,20,19,1,0,1
202223,CO1E013002,SCUOLA PRIMARIA,3,25,23,2,1,1
202223,TOPM035001,SCUOLA SECONDARIA II GRADO,4,28,27,1,0,1
202223,TO1MNU500Z,SCUOLA SECONDARIA I GRADO,1,14,14,0,0,0
202223,RMPSRQ500V,SCUOLA SECONDARIA II GRADO,5,25,24,1,0,1
202223,BA1E01000P,SCUOLA PRIMARIA,3,20,20,0,0,0
202223,RMPSCF500T,SCUOLA SECONDARIA II GRADO,2,10,9,1,1,0
202223,MI1E004003,SCUOLA PRIMARIA,3,52,48,4,0,4
202223,VIPL02500Q,SCUOLA SECONDARIA II GRADO,5,16,15,1,1,0
202223,MIPMEO500H,SCUOLA SECONDARIA II GRADO,1,32,32,0,0,0
202223,CTTFOR5002,SCUOLA SECONDARIA II GRADO,4,1,1,0,0,0
202223,CE1E031003,SCUOLA PRIMARIA,1,18,17,1,0,1
202223,NARF5C500N,SCUOLA SECONDARIA II GRADO,3,7,7,0,0,0
202223,RM1E114003,SCUOLA PRIMARIA,2,14,14,0,0,0
202223,VARH025001,SCUOLA SECONDARIA II GRADO,3,10,10,0,0,0
202223,BG1E02500D,SCUOLA PRIMARIA,2,51,50,1,1,0
202223,PD1E01400X,SCUOLA PRIMARIA,3,21,20,1,0,1
202223,CEPSSR500Q,SCUOLA SECONDARIA II GRADO,5,31,31,0,0,0
202223,RM1M108001,SCUOLA SECONDARIA I GRADO,3,23,18,5,0,5
202223,BA1E00200Q,SCUOLA PRIMARIA,3,24,24,0,0,0
202223,TO1E004003,SCUOLA PRIMARIA,3,11,9,2,1,1
202223,NA1E178003,SCUOLA PRIMARIA,2,28,27,1,1,0
202223,CN1E00200V,SCUOLA PRIMARIA,4,27,27,0,0,0
202223,TPSD015003,SCUOLA SECONDARIA II GRADO,1,57,56,1,0,1
202223,FRTFF6500V,SCUOLA SECONDARIA II GRADO,5,67,61,6,1,5
202223,VI1M01200V,SCUOLA SECONDARIA I GRADO,1,38,38,0,0,0
202223,BS1E02000V,SCUOLA PRIMARIA,2,46,44,2,0,2
202223,PR1M00400R,SCUOLA SECONDARIA I GRADO,1,25,22,3,0,3
202223,NA1E13100T,SCUOLA PRIMARIA,2,12,12,0,0,0
202223,VRTF265002,SCUOLA SECONDARIA II GRADO,4,22,22,0,0,0
202223,PD1E006001,SCUOLA PRIMARIA,5,26,25,1,0,1
202223,RMPC235003,SCUOLA SECONDARIA II GRADO,3,9,9,0,0,0
202223,MIPS74500L,SCUOLA SECONDARIA II GRADO,5,14,14,0,0,0
202223,MBPS345002,SCUOLA SECONDARIA II GRADO,5,29,29,0,0,0
202223,RM1E18100T,SCUOLA PRIMARIA,1,20,11,9,0,9
202223,NATD46500L,SCUOLA SECONDARIA II GRADO,2,7,7,0,0,0
202223,SATA2M500B,SCUOLA SECONDARIA II GRADO,5,66,66,0,0,0
202223,SARH13500E,SCUOLA SECONDARIA II GRADO,5,25,24,1,1,0
202223,TV1EAE500L,SCUOLA PRIMARIA,2,23,23,0,0,0
202223,CE1E04000T,SCUOLA PRIMARIA,5,29,26,3,0,3
202223,VR1E00800A,SCUOLA PRIMARIA,3,24,18,6,5,1
202223,PAPS02500Q,SCUOLA SECONDARIA II GRADO,1,65,64,1,0,1
202223,VAPLDB5003,SCUOLA SECONDARIA II GRADO,1,19,19,0,0,0
202223,PATD26500Q,SCUOLA SECONDARIA II GRADO,4,5,5,0,0,0
202223,NA1E05400N,SCUOLA PRIMARIA,3,46,45,1,0,1
202223,FI1E014003,SCUOLA PRIMARIA,3,37,36,1,1,0
202223,BGPQ235008,SCUOLA SECONDARIA II GRADO,3,12,11,1,0,1
202223,NA1E14000L,SCUOLA PRIMARIA,4,18,18,0,0,0
202223,BO1E00300E,SCUOLA PRIMARIA,3,18,18,0,0,0
202223,VRTN025003,SCUOLA SECONDARIA II GRADO,5,19,18,1,0,1
202223,AV1E007009,SCUOLA PRIMARIA,1,31,31,0,0,0
202223,NA1E21600L,SCUOLA PRIMARIA,2,17,17,0,0,0
202223,BS1E004001,SCUOLA PRIMARIA,2,41,38,3,0,3
202223,RMSLR1500M,SCUOLA SECONDARIA II GRADO,3,8,7,1,1,0
202223,RM1E19000L,SCUOLA PRIMARIA,1,21,21,0,0,0
202223,RM1E18300D,SCUOLA PRIMARIA,2,17,15,2,1,1
202223,PI1E00300B,SCUOLA PRIMARIA,5,24,24,0,0,0
202223,RM1E04500T,SCUOLA PRIMARIA,2,23,22,1,0,1
202223,VE1M01000X,SCUOLA SECONDARIA I GRADO,3,19,18,1,1,0
202223,AGTD685001,SCUOLA SECONDARIA II GRADO,2,3,3,0,0,0
202223,GE1E019003,SCUOLA PRIMARIA,1,9,8,1,1,0
202223,SA1E01300T,SCUOLA PRIMARIA,1,41,40,1,0,1
202223,RNRCCE500C,SCUOLA SECONDARIA II GRADO,2,22,13,9,1,8
202223,RM1E199003,SCUOLA PRIMARIA,5,13,13,0,0,0
202223,BG1M01300C,SCUOLA SECONDARIA I GRADO,3,137,135,2,1,1
202223,NA1E022006,SCUOLA PRIMARIA,1,50,50,0,0,0
202223,VR1M01600E,SCUOLA SECONDARIA I GRADO,1,17,10,7,1,6
202223,PD1M01000T,SCUOLA SECONDARIA I GRADO,1,70,68,2,0,2
202223,SATL16500Q,SCUOLA SECONDARIA II GRADO,5,63,60,3,0,3
202223,RMPM55500G,SCUOLA SECONDARIA II GRADO,5,18,18,0,0,0
202223,UD1EM3500M,SCUOLA PRIMARIA,3,23,23,0,0,0
202223,FG1MS1500L,SCUOLA SECONDARIA I GRADO,1,10,10,0,0,0
202223,CE1ERT500Q,SCUOLA PRIMARIA,2,19,17,2,1,1
202223,RMPC08500A,SCUOLA SECONDARIA II GRADO,3,88,87,1,0,1
202223,SAPS005004,SCUOLA SECONDARIA II GRADO,2,1,0,1,0,1
202223,NO1E00200X,SCUOLA PRIMARIA,4,41,40,1,1,0
202223,TPTD075004,SCUOLA SECONDARIA II GRADO,5,24,23,1,1,0
202223,RM1E030004,SCUOLA PRIMARIA,5,17,13,4,0,4
202223,RM1E02500L,SCUOLA PRIMARIA,3,26,25,1,0,1
202223,NO1E00500B,SCUOLA PRIMARIA,5,18,18,0,0,0
202223,BGSLAE500Q,SCUOLA SECONDARIA II GRADO,1,12,10,2,1,1
202223,SSPS02500V,SCUOLA SECONDARIA II GRADO,1,5,5,0,0,0
202223,TVPS015003,SCUOLA SECONDARIA II GRADO,1,34,34,0,0,0
202223,BG1M015004,SCUOLA SECONDARIA I GRADO,1,67,65,2,0,2
202223,AVTF125004,SCUOLA SECONDARIA II GRADO,5,70,67,3,2,1
202223,ENRH5C5006,SCUOLA SECONDARIA II GRADO,5,27,27,0,0,0
202223,NA1E148007,SCUOLA PRIMARIA,4,11,10,1,0,1
202223,NA1E121007,SCUOLA PRIMARIA,5,15,15,0,0,0
202223,NA1E12500E,SCUOLA PRIMARIA,2,29,29,0,0,0
202223,CT1E03900X,SCUOLA PRIMARIA,1,14,13,1,1,0
202223,CE1E07100D,SCUOLA PRIMARIA,5,16,16,0,0,0
202223,CE1ELF5000,SCUOLA PRIMARIA,1,11,11,0,0,0
202223,RM1M151007,SCUOLA SECONDARIA I GRADO,2,53,52,1,0,1
202223,SAPS11500B,SCUOLA SECONDARIA II GRADO,2,3,2,1,0,1
202223,PDPS065002,SCUOLA SECONDARIA II GRADO,5,51,50,1,0,1
202223,CE1E058003,SCUOLA PRIMARIA,5,11,9,2,0,2
202223,PEPC8E500U,SCUOLA SECONDARIA II GRADO,4,18,17,1,0,1
202223,NAPMGU500T,SCUOLA SECONDARIA II GRADO,4,5,3,2,0,2
202223,ME1E00500G,SCUOLA PRIMARIA,2,6,6,0,0,0
202223,PS1E00200B,SCUOLA PRIMARIA,2,21,20,1,0,1
202223,UD1E00500G,SCUOLA PRIMARIA,3,36,35,1,0,1
202223,PA1E02000B,SCUOLA PRIMARIA,1,12,8,4,1,3
202223,MOPS02500E,SCUOLA SECONDARIA II GRADO,5,21,20,1,0,1
202223,MI1E03000G,SCUOLA PRIMARIA,3,22,22,0,0,0
202223,NAPSNL500R,SCUOLA SECONDARIA II GRADO,1,25,25,0,0,0
202223,MIPSR85009,SCUOLA SECONDARIA II GRADO,5,13,13,0,0,0
202223,ANTD02500V,SCUOLA SECONDARIA II GRADO,1,5,5,0,0,0
202223,BSTF8F5009,SCUOLA SECONDARIA II GRADO,4,6,6,0,0,0
202223,BGPS065005,SCUOLA SECONDARIA II GRADO,4,7,7,0,0,0
202223,RMTN8V500Q,SCUOLA SECONDARIA II GRADO,2,1,1,0,0,0
202223,CE1E03300P,SCUOLA PRIMARIA,3,15,15,0,0,0
202223,LE1E00100P,SCUOLA PRIMARIA,5,42,40,2,1,1
202223,TV1E00300G,SCUOLA PRIMARIA,4,26,25,1,0,1
202223,RMPC525003,SCUOLA SECONDARIA II GRADO,5,9,9,0,0,0
202223,VE1M002001,SCUOLA SECONDARIA I GRADO,3,20,20,0,0,0
202223,RM1E007003,SCUOLA PRIMARIA,3,22,21,1,0,1
202223,MISL04500B,SCUOLA SECONDARIA II GRADO,2,64,61,3,1,2
202223,NA1EAN500C,SCUOLA PRIMARIA,1,24,24,0,0,0
202223,NA1M011001,SCUOLA SECONDARIA I GRADO,2,14,14,0,0,0
202223,BSPS13500P,SCUOLA SECONDARIA II GRADO,5,21,20,1,1,0
202223,VE1E00300G,SCUOLA PRIMARIA,5,16,16,0,0,0
202223,PR1E01000V,SCUOLA PRIMARIA,4,43,43,0,0,0
202223,BGPL01500V,SCUOLA SECONDARIA II GRADO,4,9,9,0,0,0
202223,UDPC00500N,SCUOLA SECONDARIA II GRADO,5,24,24,0,0,0
202223,CT1E00600L,SCUOLA PRIMARIA,5,18,16,2,1,1
202223,MIPS42500R,SCUOLA SECONDARIA II GRADO,4,51,50,1,0,1
202223,RMTD67500X,SCUOLA SECONDARIA II GRADO,5,177,164,13,3,10
202223,RMTD355004,SCUOLA SECONDARIA II GRADO,5,54,54,0,0,0
202223,NA1E221004,SCUOLA PRIMARIA,4,14,10,4,0,4
202223,MI1M06600G,SCUOLA SECONDARIA I GRADO,2,52,51,1,0,1
202223,PO1E001001,SCUOLA PRIMARIA,3,20,20,0,0,0
202223,RE1E007005,SCUOLA PRIMARIA,2,16,16,0,0,0
202223,BOPSPI500D,SCUOLA SECONDARIA II GRADO,4,38,37,1,0,1
202223,SA1E009006,SCUOLA PRIMARIA,1,7,7,0,0,0
202223,RNPS00500E,SCUOLA SECONDARIA II GRADO,2,14,14,0,0,0
202223,RM1E5A500D,SCUOLA PRIMARIA,1,17,15,2,0,2
202223,NARHP4500A,SCUOLA SECONDARIA II GRADO,4,4,4,0,0,0
202223,PO1E006004,SCUOLA PRIMARIA,2,41,33,8,0,8
202223,NA1E24500L,SCUOLA PRIMARIA,4,14,14,0,0,0
202223,NA1E272001,SCUOLA PRIMARIA,3,19,19,0,0,0
202223,GE1M013009,SCUOLA SECONDARIA I GRADO,1,47,44,3,0,3
202223,BL1E818011,SCUOLA PRIMARIA,4,11,11,0,0,0
202223,FG1E022009,SCUOLA PRIMARIA,2,35,35,0,0,0
202223,NATDE6500C,SCUOLA SECONDARIA II GRADO,4,3,3,0,0,0
202223,BA1E014002,SCUOLA PRIMARIA,5,16,16,0,0,0
202223,LIPL01500X,SCUOLA SECONDARIA II GRADO,4,2,2,0,0,0
202223,RMPSE55000,SCUOLA SECONDARIA II GRADO,4,29,29,0,0,0
202223,LT1E00200R,SCUOLA PRIMARIA,3,23,20,3,0,3
202223,RMPS335003,SCUOLA SECONDARIA II GRADO,3,26,25,1,0,1
202223,TO1E03000G,SCUOLA PRIMARIA,3,6,6,0,0,0
202223,BO1MZN5006,SCUOLA SECONDARIA I GRADO,3,33,32,1,1,0
202223,RM1E077009,SCUOLA PRIMARIA,4,14,3,11,2,9
202223,FI1M01800G,SCUOLA SECONDARIA I GRADO,3,14,14,0,0,0
202223,VR1M020006,SCUOLA SECONDARIA I GRADO,3,20,19,1,0,1
202223,RM1E14700A,SCUOLA PRIMARIA,4,25,21,4,1,3
202223,COTB01500Q,SCUOLA SECONDARIA II GRADO,1,16,15,1,0,1
202223,COTD105001,SCUOLA SECONDARIA II GRADO,2,8,7,1,0,1
202223,TOPS005004,SCUOLA SECONDARIA II GRADO,5,28,28,0,0,0
202223,NA1E25900E,SCUOLA PRIMARIA,2,10,10,0,0,0
202223,RMRH00500A,SCUOLA SECONDARIA II GRADO,5,79,71,8,2,6
202223,BI1E00200D,SCUOLA PRIMARIA,3,23,23,0,0,0
202223,MBRH02500X,SCUOLA SECONDARIA II GRADO,2,18,18,0,0,0
202223,MI1E045009,SCUOLA PRIMARIA,4,21,20,1,0,1
202223,NATL265009,SCUOLA SECONDARIA II GRADO,4,6,6,0,0,0
202223,NAPLVR500O,SCUOLA SECONDARIA II GRADO,5,18,18,0,0,0
202223,FRPS1T500V,SCUOLA SECONDARIA II GRADO,3,26,26,0,0,0
202223,BS1M00200E,SCUOLA SECONDARIA I GRADO,2,24,24,0,0,0
202223,NATFAA500F,SCUOLA SECONDARIA II GRADO,3,6,6,0,0,0
202223,COSL035001,SCUOLA SECONDARIA II GRADO,1,51,48,3,0,3
202223,NA1E00500C,SCUOLA PRIMARIA,1,10,10,0,0,0
202223,RM1E17400P,SCUOLA PRIMARIA,3,16,14,2,1,1
202223,TATD055002,SCUOLA SECONDARIA II GRADO,2,4,4,0,0,0
202223,LCPS025007,SCUOLA SECONDARIA II GRADO,2,17,17,0,0,0
202223,TV1M001005,SCUOLA SECONDARIA I GRADO,3,40,39,1,0,1
202223,RG1E0O5005,SCUOLA PRIMARIA,3,14,14,0,0,0
202223,FR1M00100E,SCUOLA SECONDARIA I GRADO,3,17,17,0,0,0
202223,MIRF105007,SCUOLA SECONDARIA II GRADO,1,19,18,1,0,1
202223,CERIN35009,SCUOLA SECONDARIA II GRADO,3,70,68,2,1,1
202223,LUPMRC5008,SCUOLA SECONDARIA II GRADO,1,3,3,0,0,0
202223,NA1MR7500R,SCUOLA SECONDARIA I GRADO,2,12,11,1,1,0
202223,TO1ED5500F,SCUOLA PRIMARIA,1,13,12,1,0,1
202223,SATFP3500G,SCUOLA SECONDARIA II GRADO,4,6,5,1,0,1
202223,CB1E002007,SCUOLA PRIMARIA,5,21,21,0,0,0
202223,MI1E07700R,SCUOLA PRIMARIA,5,25,24,1,0,1
202223,RMTA1T500M,SCUOLA SECONDARIA II GRADO,1,7,7,0,0,0
202223,MO1M0B500E,SCUOLA SECONDARIA I GRADO,3,17,16,1,0,1
202223,PVPL045003,SCUOLA SECONDARIA II GRADO,1,3,3,0,0,0
202223,MI1E140003,SCUOLA PRIMARIA,1,30,29,1,0,1
202223,NA1E06100R,SCUOLA PRIMARIA,1,18,18,0,0,0
202223,RM1E099006,SCUOLA PRIMARIA,5,25,24,1,0,1
202223,TV1M007004,SCUOLA SECONDARIA I GRADO,1,98,97,1,0,1
202223,BOPSR2500M,SCUOLA SECONDARIA II GRADO,4,35,32,3,0,3
202223,LT1E005008,SCUOLA PRIMARIA,3,44,42,2,1,1
202223,VA1E00600L,SCUOLA PRIMARIA,3,11,11,0,0,0
202223,NARH105008,SCUOLA SECONDARIA II GRADO,5,15,15,0,0,0
202223,PA1MQ8500S,SCUOLA SECONDARIA I GRADO,2,16,16,0,0,0
202223,CTRCQ5500S,SCUOLA SECONDARIA II GRADO,5,35,35,0,0,0
202223,RMPM3Q500P,SCUOLA SECONDARIA II GRADO,2,10,9,1,1,0
202223,COPL025008,SCUOLA SECONDARIA II GRADO,3,23,19,4,1,3
202223,CE1E00600A,SCUOLA PRIMARIA,4,21,20,1,0,1
202223,CN1MNS500A,SCUOLA SECONDARIA I GRADO,2,13,13,0,0,0
202223,BNPS12500Z,SCUOLA SECONDARIA II GRADO,3,10,10,0,0,0
202223,AR1E00300R,SCUOLA PRIMARIA,3,12,12,0,0,0
202223,MN1M002005,SCUOLA SECONDARIA I GRADO,1,25,24,1,0,1
202223,BA1M006008,SCUOLA SECONDARIA I GRADO,1,25,25,0,0,0
202223,TR1E00100P,SCUOLA PRIMARIA,5,9,5,4,0,4
202223,NAPSZI500L,SCUOLA SECONDARIA II GRADO,3,19,18,1,0,1
202223,AGPSFG5009,SCUOLA SECONDARIA II GRADO,5,17,17,0,0,0
202223,TO1E047001,SCUOLA PRIMARIA,5,38,24,14,3,11
202223,RM1E09500V,SCUOLA PRIMARIA,4,24,23,1,0,1
202223,FI1E035004,SCUOLA PRIMARIA,1,31,27,4,0,4
202223,NA1E19700C,SCUOLA PRIMARIA,4,20,20,0,0,0
202223,MIPQ01500X,SCUOLA SECONDARIA II GRADO,4,28,27,1,1,0
202223,SATDH85000,SCUOLA SECONDARIA II GRADO,5,70,64,6,3,3
202223,SATD30500E,SCUOLA SECONDARIA II GRADO,5,133,131,2,1,1
202223,ISTDGG500C,SCUOLA SECONDARIA II GRADO,2,1,1,0,0,0
202223,PAPC07500N,SCUOLA SECONDARIA II GRADO,4,22,22,0,0,0
202223,PA1M01800L,SCUOLA SECONDARIA I GRADO,3,13,10,3,0,3
202223,NATF215004,SCUOLA SECONDARIA II GRADO,5,86,85,1,0,1
202223,RMPSLS5006,SCUOLA SECONDARIA II GRADO,2,20,20,0,0,0
202223,NAPS37500E,SCUOLA SECONDARIA II GRADO,5,23,19,4,1,3
202223,MI1E02200L,SCUOLA PRIMARIA,4,17,12,5,0,5
202223,MN1E00200X,SCUOLA PRIMARIA,3,30,29,1,0,1
202223,MI1E067006,SCUOLA PRIMARIA,1,21,21,0,0,0
202223,NA1E186002,SCUOLA PRIMARIA,5,14,14,0,0,0
202223,CE1E04700L,SCUOLA PRIMARIA,3,10,10,0,0,0
202223,CE1E06400A,SCUOLA PRIMARIA,5,11,10,1,0,1
202223,CETDHL500C,SCUOLA SECONDARIA II GRADO,1,9,9,0,0,0
202223,BS1M01000D,SCUOLA SECONDARIA I GRADO,2,61,58,3,1,2
202223,PA1E03900C,SCUOLA PRIMARIA,3,25,25,0,0,0
202223,TOPS04500E,SCUOLA SECONDARIA II GRADO,3,51,51,0,0,0
202223,RM1E119006,SCUOLA PRIMARIA,5,22,22,0,0,0
202223,MIPC06500L,SCUOLA SECONDARIA II GRADO,5,29,29,0,0,0
202223,TOPL20500L,SCUOLA SECONDARIA II GRADO,1,24,24,0,0,0
202223,VRPM27500E,SCUOLA SECONDARIA II GRADO,5,24,24,0,0,0
202223,AV1E00500N,SCUOLA PRIMARIA,3,13,13,0,0,0
202223,RMTAPV5005,SCUOLA SECONDARIA II GRADO,4,3,2,1,0,1
202223,PVSL1E500O,SCUOLA SECONDARIA II GRADO,4,2,2,0,0,0
202223,RM1E16500X,SCUOLA PRIMARIA,3,20,20,0,0,0
202223,MI1EN0500I,SCUOLA PRIMARIA,3,9,9,0,0,0
202223,MB1E03600B,SCUOLA PRIMARIA,1,23,23,0,0,0
202223,NAPL7N500U,SCUOLA SECONDARIA II GRADO,3,5,5,0,0,0
202223,FRTD0N500M,SCUOLA SECONDARIA II GRADO,5,67,65,2,0,2
202223,RM1E00300Q,SCUOLA PRIMARIA,1,43,42,1,0,1
202223,CETD43500Q,SCUOLA SECONDARIA II GRADO,2,5,5,0,0,0
202223,LUPSGN5009,SCUOLA SECONDARIA II GRADO,1,6,5,1,0,1
202223,TO1M02400D,SCUOLA SECONDARIA I GRADO,3,22,22,0,0,0
202223,PR1E00800V,SCUOLA PRIMARIA,3,21,20,1,0,1
202223,BG1E01700E,SCUOLA PRIMARIA,3,3,2,1,0,1
202223,PA1E02600A,SCUOLA PRIMARIA,4,19,19,0,0,0
202223,NATD1E500I,SCUOLA SECONDARIA II GRADO,1,9,9,0,0,0
202223,NATD3V500N,SCUOLA SECONDARIA II GRADO,1,11,10,1,0,1
202223,AL1E00300A,SCUOLA PRIMARIA,4,15,13,2,0,2
202223,LT1M001006,SCUOLA SECONDARIA I GRADO,1,27,26,1,1,0
202223,LTTF9N5007,SCUOLA SECONDARIA II GRADO,5,24,23,1,0,1
202223,TO1M03500X,SCUOLA SECONDARIA I GRADO,2,14,14,0,0,0
202223,NA1E030005,SCUOLA PRIMARIA,3,10,10,0,0,0
202223,NA1E05000A,SCUOLA PRIMARIA,4,12,9,3,0,3
202223,CO1E01500N,SCUOLA PRIMARIA,1,11,11,0,0,0
202223,BGPMS4500R,SCUOLA SECONDARIA II GRADO,1,12,10,2,0,2
202223,RMPMFO500A,SCUOLA SECONDARIA II GRADO,2,16,15,1,0,1
202223,RC1M00300T,SCUOLA SECONDARIA I GRADO,3,11,10,1,1,0
202223,RMPL445009,SCUOLA SECONDARIA II GRADO,1,9,9,0,0,0
202223,FIPS04500X,SCUOLA SECONDARIA II GRADO,3,30,29,1,1,0
202223,NATDGE5008,SCUOLA SECONDARIA II GRADO,2,9,9,0,0,0
202223,APTFZ6500L,SCUOLA SECONDARIA II GRADO,5,20,18,2,1,1
202223,RCRI015009,SCUOLA SECONDARIA II GRADO,1,5,5,0,0,0
202223,LOPS01500A,SCUOLA SECONDARIA II GRADO,3,18,18,0,0,0
202223,SR1M00200P,SCUOLA SECONDARIA I GRADO,2,13,12,1,0,1
202223,RMTDOO500A,SCUOLA SECONDARIA II GRADO,3,5,4,1,0,1
202223,NOPL015002,SCUOLA SECONDARIA II GRADO,2,14,14,0,0,0
202223,SI1M00200A,SCUOLA SECONDARIA I GRADO,1,20,19,1,0,1
202223,PG1E00200V,SCUOLA PRIMARIA,2,13,13,0,0,0
202223,PV1E00400R,SCUOLA PRIMARIA,5,26,26,0,0,0
202223,NA1E239009,SCUOLA PRIMARIA,2,11,11,0,0,0
202223,RM1E10700X,SCUOLA PRIMARIA,2,23,20,3,1,2
202223,NA1E114004,SCUOLA PRIMARIA,4,9,9,0,0,0
202223,NATD8F500U,SCUOLA SECONDARIA II GRADO,4,2,2,0,0,0
202223,VATB215007,SCUOLA SECONDARIA II GRADO,1,16,14,2,0,2
202223,NA1E100006,SCUOLA PRIMARIA,1,28,26,2,0,2
202223,RM1M128006,SCUOLA SECONDARIA I GRADO,2,72,69,3,1,2
202223,BSTD01500C,SCUOLA SECONDARIA II GRADO,4,23,23,0,0,0
202223,CR1E006002,SCUOLA PRIMARIA,3,16,16,0,0,0
202223,CRPLAB5007,SCUOLA SECONDARIA II GRADO,3,15,15,0,0,0
202223,APPM04500X,SCUOLA SECONDARIA II GRADO,1,16,16,0,0,0
202223,CA1E01400V,SCUOLA PRIMARIA,2,19,19,0,0,0
202223,CAPS005009,SCUOLA SECONDARIA II GRADO,1,24,23,1,0,1
202223,PETF005003,SCUOLA SECONDARIA II GRADO,5,17,14,3,1,2
202223,VI1E01300D,SCUOLA PRIMARIA,2,21,20,1,1,0
202223,CZ1E002002,SCUOLA PRIMARIA,4,21,20,1,1,0
202223,SV1E006002,SCUOLA PRIMARIA,5,5,5,0,0,0
202223,SSTD00500D,SCUOLA SECONDARIA II GRADO,3,8,8,0,0,0
202223,RMPC44500B,SCUOLA SECONDARIA II GRADO,1,28,28,0,0,0
202223,RM1E157001,SCUOLA PRIMARIA,5,19,16,3,1,2
202223,BSPME1500B,SCUOLA SECONDARIA II GRADO,2,30,28,2,1,1
202223,NATFFL500P,SCUOLA SECONDARIA II GRADO,1,10,10,0,0,0
202223,BO1E00300E,SCUOLA PRIMARIA,4,15,15,0,0,0
202223,VRPC01500G,SCUOLA SECONDARIA II GRADO,2,30,30,0,0,0
202223,MIPS8E5005,SCUOLA SECONDARIA II GRADO,3,5,5,0,0,0
202223,MIPSE7500I,SCUOLA SECONDARIA II GRADO,4,35,35,0,0,0
202223,RM1M04000X,SCUOLA SECONDARIA I GRADO,3,61,59,2,0,2
202223,MBPS0G5007,SCUOLA SECONDARIA II GRADO,3,21,20,1,0,1
202223,MI1E125001,SCUOLA PRIMARIA,2,52,52,0,0,0
202223,PI1M001001,SCUOLA SECONDARIA I GRADO,1,16,13,3,0,3
202223,RMTF145002,SCUOLA SECONDARIA II GRADO,1,7,6,1,0,1
202223,CTTD145005,SCUOLA SECONDARIA II GRADO,4,3,3,0,0,0
202223,BSPMNI500T,SCUOLA SECONDARIA II GRADO,4,23,23,0,0,0
202223,SV1E00400A,SCUOLA PRIMARIA,2,18,17,1,1,0
202223,VR1E01300T,SCUOLA PRIMARIA,4,25,24,1,0,1
202223,GE1M00300P,SCUOLA SECONDARIA I GRADO,1,28,25,3,0,3
202223,VT1E008001,SCUOLA PRIMARIA,1,6,5,1,0,1
202223,NA1E13700R,SCUOLA PRIMARIA,5,14,13,1,0,1
202223,BNTL025006,SCUOLA SECONDARIA II GRADO,2,3,3,0,0,0
202223,UD1E008003,SCUOLA PRIMARIA,4,25,25,0,0,0
202223,CSTDDC500C,SCUOLA SECONDARIA II GRADO,4,3,3,0,0,0
202223,MBPMZF5000,SCUOLA SECONDARIA II GRADO,1,10,9,1,0,1
202223,TO1E003007,SCUOLA PRIMARIA,2,32,31,1,1,0
202223,NA1E06600X,SCUOLA PRIMARIA,1,29,28,1,0,1
202223,RMPS44500E,SCUOLA SECONDARIA II GRADO,3,18,17,1,0,1
202223,CS1MT95008,SCUOLA SECONDARIA I GRADO,3,3,3,0,0,0
202223,RMPCQ1500T,SCUOLA SECONDARIA II GRADO,1,5,5,0,0,0
202223,GE1E020007,SCUOLA PRIMARIA,4,26,26,0,0,0
202223,PV1E003001,SCUOLA PRIMARIA,3,49,47,2,0,2
202223,ANPS025003,SCUOLA SECONDARIA II GRADO,1,4,4,0,0,0
202223,VA1E01400G,SCUOLA PRIMARIA,1,8,5,3,0,3
202223,SATNV3500O,SCUOLA SECONDARIA II GRADO,5,36,33,3,0,3
202223,CTPM40500E,SCUOLA SECONDARIA II GRADO,3,2,2,0,0,0
202223,PDPS02500G,SCUOLA SECONDARIA II GRADO,4,49,48,1,0,1
202223,CO1E00900A,SCUOLA PRIMARIA,3,19,18,1,0,1
202223,NA1E05500D,SCUOLA PRIMARIA,4,49,48,1,1,0
202223,UDTBCH500I,SCUOLA SECONDARIA II GRADO,1,9,8,1,1,0
202223,NA1E28200G,SCUOLA PRIMARIA,5,6,5,1,1,0
202223,MI1E08000L,SCUOLA PRIMARIA,2,11,10,1,0,1
202223,FIPSCR500M,SCUOLA SECONDARIA II GRADO,3,9,8,1,0,1
202223,NOPSUI500C,SCUOLA SECONDARIA II GRADO,1,5,4,1,0,1
202223,PA1E01500X,SCUOLA PRIMARIA,5,13,13,0,0,0
202223,MB1M02300E,SCUOLA SECONDARIA I GRADO,2,19,19,0,0,0
202223,IM1M00500T,SCUOLA SECONDARIA I GRADO,2,18,15,3,0,3
202223,NA1E015003,SCUOLA PRIMARIA,2,8,5,3,0,3
202223,BG1M010001,SCUOLA SECONDARIA I GRADO,2,147,143,4,2,2
202223,TVPL005007,SCUOLA SECONDARIA II GRADO,3,10,10,0,0,0
202223,RM1E14100B,SCUOLA PRIMARIA,5,23,23,0,0,0
202223,FG1E01400A,SCUOLA PRIMARIA,3,17,15,2,1,1
202223,MOPS0N500H,SCUOLA SECONDARIA II GRADO,1,10,10,0,0,0
202223,RMPS00500L,SCUOLA SECONDARIA II GRADO,5,21,17,4,1,3
202223,MT1E00100E,SCUOLA PRIMARIA,1,18,18,0,0,0
202223,MNPL2H500Q,SCUOLA SECONDARIA II GRADO,2,9,9,0,0,0
202223,ANTD02500V,SCUOLA SECONDARIA II GRADO,2,6,6,0,0,0
202223,NATN7V500I,SCUOLA SECONDARIA II GRADO,2,19,19,0,0,0
202223,NA1E192009,SCUOLA PRIMARIA,3,10,10,0,0,0
202223,NAPM39500R,SCUOLA SECONDARIA II GRADO,2,11,11,0,0,0
202223,ME1E001008,SCUOLA PRIMARIA,1,23,20,3,1,2
202223,RM1M002005,SCUOLA SECONDARIA I GRADO,2,6,6,0,0,0
202223,VBRH155008,SCUOLA SECONDARIA II GRADO,3,13,13,0,0,0
202223,TVPS065004,SCUOLA SECONDARIA II GRADO,4,27,27,0,0,0
202223,AV1E010005,SCUOLA PRIMARIA,1,25,25,0,0,0
202223,SATF1D500C,SCUOLA SECONDARIA II GRADO,3,10,10,0,0,0
202223,NA1E18900D,SCUOLA PRIMARIA,2,32,32,0,0,0
202223,NAPL19500R,SCUOLA SECONDARIA II GRADO,5,9,9,0,0,0
202223,VR1E009006,SCUOLA PRIMARIA,3,25,24,1,1,0
202223,FR1E00400R,SCUOLA PRIMARIA,2,15,14,1,0,1
202223,VIPS00500Q,SCUOLA SECONDARIA II GRADO,5,9,9,0,0,0
202223,RM1E00200X,SCUOLA PRIMARIA,2,8,8,0,0,0
202223,BGPS0D500U,SCUOLA SECONDARIA II GRADO,1,17,13,4,1,3
202223,FRTF2T500E,SCUOLA SECONDARIA II GRADO,5,59,53,6,0,6
202223,MISL075007,SCUOLA SECONDARIA II GRADO,5,54,54,0,0,0
202223,NA1EM9500T,SCUOLA PRIMARIA,1,15,15,0,0,0
202223,NARHSC500S,SCUOLA SECONDARIA II GRADO,3,6,6,0,0,0
202223,BSPSS1500O,SCUOLA SECONDARIA II GRADO,2,45,45,0,0,0
202223,VAPMCL500Q,SCUOLA SECONDARIA II GRADO,3,21,21,0,0,0
202223,GE1M006006,SCUOLA SECONDARIA I GRADO,3,22,22,0,0,0
202223,AQ1E00700D,SCUOLA PRIMARIA,1,33,33,0,0,0
202223,AT1E00200G,SCUOLA PRIMARIA,5,27,26,1,1,0
202223,BG1E01500V,SCUOLA PRIMARIA,2,41,39,2,0,2
202223,NA1E21500R,SCUOLA PRIMARIA,3,15,14,1,0,1
202223,RMTD51500B,SCUOLA SECONDARIA II GRADO,5,35,35,0,0,0
202223,RMPS59500C,SCUOLA SECONDARIA II GRADO,2,12,10,2,0,2
202223,TV1M01000X,SCUOLA SECONDARIA I GRADO,1,23,23,0,0,0
202223,MI1E017005,SCUOLA PRIMARIA,1,69,68,1,0,1
202223,FOPS5G500N,SCUOLA SECONDARIA II GRADO,3,23,23,0,0,0
202223,FRPC02500X,SCUOLA SECONDARIA II GRADO,5,10,10,0,0,0
202223,RO1E00300A,SCUOLA PRIMARIA,3,16,16,0,0,0
202223,AG1E006007,SCUOLA PRIMARIA,1,25,24,1,0,1
202223,VE1E01100E,SCUOLA PRIMARIA,2,22,22,0,0,0
202223,PD1EOO500S,SCUOLA PRIMARIA,5,8,6,2,0,2
202223,PAPMO7500Q,SCUOLA SECONDARIA II GRADO,2,9,9,0,0,0
202223,SATLGF500Z,SCUOLA SECONDARIA II GRADO,2,10,10,0,0,0
202223,SATFNZ5007,SCUOLA SECONDARIA II GRADO,4,3,3,0,0,0
202223,NOSL015004,SCUOLA SECONDARIA II GRADO,1,5,5,0,0,0
202223,AQ1E004002,SCUOLA PRIMARIA,5,18,17,1,1,0
202223,VAPSQ4500H,SCUOLA SECONDARIA II GRADO,5,6,6,0,0,0
202223,NA1E22500B,SCUOLA PRIMARIA,1,16,16,0,0,0
202223,BS1E01300Q,SCUOLA PRIMARIA,2,16,16,0,0,0
202223,BG1E01200B,SCUOLA PRIMARIA,1,42,41,1,0,1
202223,TOPST1500C,SCUOLA SECONDARIA II GRADO,4,16,16,0,0,0
202223,MI1E00800A,SCUOLA PRIMARIA,1,60,59,1,0,1
202223,PV1E001009,SCUOLA PRIMARIA,3,38,37,1,0,1
202223,VI1E01200N,SCUOLA PRIMARIA,2,44,36,8,1,7
202223,NA1E20300E,SCUOLA PRIMARIA,4,26,26,0,0,0
202223,BG1EUA5004,SCUOLA PRIMARIA,4,40,39,1,0,1
202223,LC1E004001,SCUOLA PRIMARIA,4,27,27,0,0,0
202223,AVTD075001,SCUOLA SECONDARIA II GRADO,5,15,14,1,1,0
202223,COSL035001,SCUOLA SECONDARIA II GRADO,2,52,47,5,0,5
202223,RM1E12300T,SCUOLA PRIMARIA,1,43,40,3,1,2
202223,RMRF9P500F,SCUOLA SECONDARIA II GRADO,4,6,5,1,1,0
202223,MIPLVI500L,SCUOLA SECONDARIA II GRADO,1,37,32,5,1,4
202223,TO1M05200N,SCUOLA SECONDARIA I GRADO,2,120,113,7,6,1
202223,MI1E033003,SCUOLA PRIMARIA,3,23,23,0,0,0
202223,CL1E003004,SCUOLA PRIMARIA,3,11,11,0,0,0
202223,RA1E00300B,SCUOLA PRIMARIA,4,28,23,5,1,4
202223,RM1E03300G,SCUOLA PRIMARIA,2,38,36,2,0,2
202223,RN1E00400D,SCUOLA PRIMARIA,1,21,19,2,0,2
202223,CE1E03900N,SCUOLA PRIMARIA,4,12,12,0,0,0
202223,NAPM455007,SCUOLA SECONDARIA II GRADO,2,9,9,0,0,0
202223,BO1M01200E,SCUOLA SECONDARIA I GRADO,3,166,157,9,2,7
202223,TS1E00400N,SCUOLA PRIMARIA,1,17,17,0,0,0
202223,ME1E01200P,SCUOLA PRIMARIA,1,8,8,0,0,0
202223,SATDST500C,SCUOLA SECONDARIA II GRADO,3,5,5,0,0,0
202223,PA1EAT500P,SCUOLA PRIMARIA,2,48,48,0,0,0
202223,CZ1E45500Q,SCUOLA PRIMARIA,5,16,16,0,0,0
202223,BL1E00200B,SCUOLA PRIMARIA,2,46,45,1,0,1
202223,NAPS045004,SCUOLA SECONDARIA II GRADO,4,26,25,1,0,1
202223,BG1E02900R,SCUOLA PRIMARIA,1,98,93,5,1,4
202223,RM1M03400L,SCUOLA SECONDARIA I GRADO,2,37,37,0,0,0
202223,NA1E23000V,SCUOLA PRIMARIA,1,25,25,0,0,0
202223,TE1EDS5004,SCUOLA PRIMARIA,3,13,11,2,1,1
202223,CHTL31500X,SCUOLA SECONDARIA II GRADO,1,4,4,0,0,0
202223,NA1E17300X,SCUOLA PRIMARIA,5,11,11,0,0,0
202223,LC1M10100G,SCUOLA SECONDARIA I GRADO,2,64,62,2,0,2
202223,NA1E078006,SCUOLA PRIMARIA,2,16,15,1,0,1
202223,PATD12500C,SCUOLA SECONDARIA II GRADO,1,3,3,0,0,0
202223,TO1M050002,SCUOLA SECONDARIA I GRADO,1,50,40,10,4,6
202223,PR1E00500B,SCUOLA PRIMARIA,4,33,33,0,0,0
202223,PATD43500N,SCUOLA SECONDARIA II GRADO,5,94,91,3,0,3
202223,PGPM02500T,SCUOLA SECONDARIA II GRADO,4,6,6,0,0,0
202223,MI1E140003,SCUOLA PRIMARIA,2,28,25,3,0,3
202223,SARFD1500N,SCUOLA SECONDARIA II GRADO,5,51,47,4,2,2
202223,NO1M001009,SCUOLA SECONDARIA I GRADO,3,84,83,1,0,1
202223,CE1E03800T,SCUOLA PRIMARIA,1,26,26,0,0,0
202223,FI1M006009,SCUOLA SECONDARIA I GRADO,1,32,30,2,0,2
202223,FR1E001009,SCUOLA PRIMARIA,2,32,31,1,0,1
202223,FI1M029002,SCUOLA SECONDARIA I GRADO,3,52,44,8,0,8
202223,FIPCI25001,SCUOLA SECONDARIA II GRADO,5,24,24,0,0,0
202223,PAPS5E500M,SCUOLA SECONDARIA II GRADO,5,21,20,1,1,0
202223,LU1E00700B,SCUOLA PRIMARIA,4,25,25,0,0,0
202223,CTPL145004,SCUOLA SECONDARIA II GRADO,2,5,5,0,0,0
202223,CE1E01200N,SCUOLA PRIMARIA,1,16,10,6,0,6
202223,BN1E82500A,SCUOLA PRIMARIA,2,20,20,0,0,0
202223,CERH00500D,SCUOLA SECONDARIA II GRADO,5,116,115,1,1,0
202223,LI1E006005,SCUOLA PRIMARIA,4,52,52,0,0,0
202223,RMPS5G5003,SCUOLA SECONDARIA II GRADO,2,7,6,1,0,1
202223,TO1E05200C,SCUOLA PRIMARIA,5,11,11,0,0,0
202223,FI1E02900R,SCUOLA PRIMARIA,4,22,22,0,0,0
202223,ALPM02500D,SCUOLA SECONDARIA II GRADO,4,14,13,1,0,1
202223,MIPMGC500D,SCUOLA SECONDARIA II GRADO,4,22,21,1,0,1
202223,PG1M00500G,SCUOLA SECONDARIA I GRADO,1,10,8,2,0,2
202223,AG1EVA500E,SCUOLA PRIMARIA,4,8,8,0,0,0
202223,RM1E134008,SCUOLA PRIMARIA,3,22,19,3,1,2
202223,NATF28500A,SCUOLA SECONDARIA II GRADO,5,65,65,0,0,0
202223,FIPMRR500G,SCUOLA SECONDARIA II GRADO,3,19,16,3,0,3
202223,VARH00500Q,SCUOLA SECONDARIA II GRADO,5,20,19,1,0,1
202223,CR1E00400A,SCUOLA PRIMARIA,2,22,22,0,0,0
202223,MI1E061007,SCUOLA PRIMARIA,5,49,47,2,0,2
202223,SA1MR95005,SCUOLA SECONDARIA I GRADO,3,2,2,0,0,0
202223,RM1E01700N,SCUOLA PRIMARIA,5,9,6,3,0,3
202223,FI1E026009,SCUOLA PRIMARIA,2,22,20,2,0,2
202223,NA1E01000X,SCUOLA PRIMARIA,1,26,18,8,0,8
202223,MIRFHT500U,SCUOLA SECONDARIA II GRADO,1,25,22,3,0,3
202223,SV1M00500B,SCUOLA SECONDARIA I GRADO,3,25,25,0,0,0
202223,VAPS1O500A,SCUOLA SECONDARIA II GRADO,4,12,12,0,0,0
202223,BS1M01400R,SCUOLA SECONDARIA I GRADO,1,52,47,5,0,5
202223,SS1E01300B,SCUOLA PRIMARIA,4,14,14,0,0,0
202223,AVTD045005,SCUOLA SECONDARIA II GRADO,5,65,58,7,2,5
202223,NA1E234006,SCUOLA PRIMARIA,3,10,10,0,0,0
202223,NA1E25100X,SCUOLA PRIMARIA,1,10,10,0,0,0
202223,BGTF015006,SCUOLA SECONDARIA II GRADO,1,18,15,3,0,3
202223,NA1E15300P,SCUOLA PRIMARIA,4,6,6,0,0,0
202223,CT1E053006,SCUOLA PRIMARIA,4,13,13,0,0,0
202223,VRPM01500Q,SCUOLA SECONDARIA II GRADO,3,42,42,0,0,0
202223,GEPS4C5009,SCUOLA SECONDARIA II GRADO,4,9,9,0,0,0
202223,RMPS25500B,SCUOLA SECONDARIA II GRADO,1,11,11,0,0,0
202223,TVPSN55005,SCUOLA SECONDARIA II GRADO,3,20,20,0,0,0
202223,TO1E01300T,SCUOLA PRIMARIA,3,50,47,3,2,1
202223,PVTBDH500G,SCUOLA SECONDARIA II GRADO,3,5,4,1,0,1
202223,MI1EBF500V,SCUOLA PRIMARIA,1,27,27,0,0,0
202223,RN1E00800R,SCUOLA PRIMARIA,4,81,76,5,2,3
202223,SARFTV500I,SCUOLA SECONDARIA II GRADO,3,3,3,0,0,0
202223,MB1E052009,SCUOLA PRIMARIA,5,38,38,0,0,0
202223,RG1E00300C,SCUOLA PRIMARIA,1,24,24,0,0,0
202223,PEPS995008,SCUOLA SECONDARIA II GRADO,2,1,1,0,0,0
202223,ME1EOF500O,SCUOLA PRIMARIA,1,48,48,0,0,0
202223,MI1E08400X,SCUOLA PRIMARIA,4,15,13,2,0,2
202223,PA1E014004,SCUOLA PRIMARIA,5,60,58,2,0,2
202223,CT1E038004,SCUOLA PRIMARIA,3,25,24,1,0,1
202223,SARHV4500U,SCUOLA SECONDARIA II GRADO,2,6,6,0,0,0
202223,TO1E03500P,SCUOLA PRIMARIA,3,85,78,7,3,4
202223,RM1E08400C,SCUOLA PRIMARIA,4,51,51,0,0,0
202223,VA1E9G500A,SCUOLA PRIMARIA,4,13,11,2,2,0
202223,VTTD015005,SCUOLA SECONDARIA II GRADO,4,19,18,1,1,0
202223,CETD15500D,SCUOLA SECONDARIA II GRADO,4,5,5,0,0,0
202223,LTRFGQ5000,SCUOLA SECONDARIA II GRADO,3,4,4,0,0,0
202223,CETFOD5002,SCUOLA SECONDARIA II GRADO,1,8,0,8,0,8
202223,CO1E01000E,SCUOLA PRIMARIA,5,30,30,0,0,0
202223,NA1E04100G,SCUOLA PRIMARIA,1,46,46,0,0,0
202223,BGPL16500Q,SCUOLA SECONDARIA II GRADO,3,17,17,0,0,0
202223,CE1E002003,SCUOLA PRIMARIA,5,24,24,0,0,0
202223,MOPS01500X,SCUOLA SECONDARIA II GRADO,4,8,8,0,0,0
202223,SA1E02900B,SCUOLA PRIMARIA,3,22,22,0,0,0
202223,RMPS49500G,SCUOLA SECONDARIA II GRADO,2,25,25,0,0,0
202223,TO1E040006,SCUOLA PRIMARIA,2,36,35,1,1,0
202223,RM1E09000Q,SCUOLA PRIMARIA,1,29,28,1,0,1
202223,MERHFN500I,SCUOLA SECONDARIA II GRADO,4,1,1,0,0,0
202223,NARHTO500T,SCUOLA SECONDARIA II GRADO,3,4,4,0,0,0
202223,BSPM57500D,SCUOLA SECONDARIA II GRADO,5,25,25,0,0,0
202223,PDPM00500B,SCUOLA SECONDARIA II GRADO,3,49,47,2,1,1
202223,NATDPG500E,SCUOLA SECONDARIA II GRADO,2,1,1,0,0,0
202223,CATF955004,SCUOLA SECONDARIA II GRADO,2,8,8,0,0,0
202223,MIPL15500R,SCUOLA SECONDARIA II GRADO,2,25,23,2,0,2
202223,NA1E27900Q,SCUOLA PRIMARIA,2,10,10,0,0,0
202223,PD1E00100T,SCUOLA PRIMARIA,2,18,15,3,1,2
202223,FG1M002009,SCUOLA SECONDARIA I GRADO,1,30,29,1,0,1
202223,NA1E093008,SCUOLA PRIMARIA,1,15,14,1,1,0
202223,RM1M149007,SCUOLA SECONDARIA I GRADO,3,36,34,2,0,2
202223,CR1E00800N,SCUOLA PRIMARIA,5,21,19,2,1,1
202223,BA1E01000P,SCUOLA PRIMARIA,1,23,23,0,0,0
202223,MO1E00600X,SCUOLA PRIMARIA,3,19,18,1,0,1
202223,NA1E15900N,SCUOLA PRIMARIA,5,11,11,0,0,0
202223,TO1E03700A,SCUOLA PRIMARIA,1,39,38,1,0,1
202223,BO1E018008,SCUOLA PRIMARIA,1,22,15,7,1,6
202223,BGPSQZ500T,SCUOLA SECONDARIA II GRADO,1,13,12,1,0,1
202223,GRPC64500E,SCUOLA SECONDARIA II GRADO,4,8,8,0,0,0
202223,SV1E00400A,SCUOLA PRIMARIA,1,18,17,1,0,1
202223,RMPC545008,SCUOLA SECONDARIA II GRADO,1,6,6,0,0,0
202223,COPSNU500Z,SCUOLA SECONDARIA II GRADO,2,4,3,1,0,1
202223,RM1E15900L,SCUOLA PRIMARIA,5,25,25,0,0,0
202223,MIPC16500D,SCUOLA SECONDARIA II GRADO,5,21,21,0,0,0
202223,PD1E00300D,SCUOLA PRIMARIA,3,25,25,0,0,0
202223,PCPSD7500T,SCUOLA SECONDARIA II GRADO,1,27,25,2,0,2
202223,MC1E001003,SCUOLA PRIMARIA,1,23,23,0,0,0
202223,RM1M03800X,SCUOLA SECONDARIA I GRADO,1,15,15,0,0,0
202223,RMSL015004,SCUOLA SECONDARIA II GRADO,2,20,19,1,0,1
202223,PV1M00500T,SCUOLA SECONDARIA I GRADO,1,57,56,1,0,1
202223,NATD255008,SCUOLA SECONDARIA II GRADO,1,7,7,0,0,0
202223,MI1E12600R,SCUOLA PRIMARIA,5,76,69,7,2,5
202223,PNTD7Z500U,SCUOLA SECONDARIA II GRADO,1,7,7,0,0,0
202223,MI1E01300T,SCUOLA PRIMARIA,1,35,35,0,0,0
202223,MI1M050002,SCUOLA SECONDARIA I GRADO,2,19,19,0,0,0
202223,TV1E013006,SCUOLA PRIMARIA,5,22,21,1,0,1
202223,RGTD04500G,SCUOLA SECONDARIA II GRADO,1,3,3,0,0,0
202223,MCPM505001,SCUOLA SECONDARIA II GRADO,5,12,10,2,2,0
202223,CO1M02400N,SCUOLA SECONDARIA I GRADO,2,47,44,3,0,3
202223,NATFPQ500Q,SCUOLA SECONDARIA II GRADO,2,6,6,0,0,0
202223,VT1E00300T,SCUOLA PRIMARIA,2,22,21,1,1,0
202223,PATDAH500E,SCUOLA SECONDARIA II GRADO,5,26,25,1,0,1
202223,CSTN015007,SCUOLA SECONDARIA II GRADO,1,4,4,0,0,0
202223,VRPC01500G,SCUOLA SECONDARIA II GRADO,5,32,32,0,0,0
202223,RMTD78500B,SCUOLA SECONDARIA II GRADO,3,2,2,0,0,0
202223,MIPS74500L,SCUOLA SECONDARIA II GRADO,3,17,15,2,0,2
202223,MBPL20500D,SCUOLA SECONDARIA II GRADO,4,36,35,1,1,0
202223,RMSL3E5005,SCUOLA SECONDARIA II GRADO,3,8,6,2,0,2
202223,MBPS345002,SCUOLA SECONDARIA II GRADO,4,27,27,0,0,0
202223,VE1M6Q5004,SCUOLA SECONDARIA I GRADO,3,37,34,3,0,3
202223,PN1M002009,SCUOLA SECONDARIA I GRADO,3,116,116,0,0,0
202223,RMPS4A500Z,SCUOLA SECONDARIA II GRADO,4,17,17,0,0,0
202223,CSPM025005,SCUOLA SECONDARIA II GRADO,5,5,5,0,0,0
202223,MI1E01000A,SCUOLA PRIMARIA,5,36,35,1,1,0
202223,GE1E01600G,SCUOLA PRIMARIA,3,23,22,1,0,1
202223,RG1E004008,SCUOLA PRIMARIA,2,13,13,0,0,0
202223,NARF6T500Q,SCUOLA SECONDARIA II GRADO,4,10,10,0,0,0
202223,CERIPM5008,SCUOLA SECONDARIA II GRADO,5,63,62,1,0,1
202223,MISL025006,SCUOLA SECONDARIA II GRADO,4,53,52,1,0,1
202223,TO1EPI500H,SCUOLA PRIMARIA,2,23,23,0,0,0
202223,PAPL6T500Q,SCUOLA SECONDARIA II GRADO,3,19,18,1,0,1
202223,GE1E02900N,SCUOLA PRIMARIA,5,25,25,0,0,0
202223,RMPSNS500T,SCUOLA SECONDARIA II GRADO,5,22,22,0,0,0
202223,CA1EN7500O,SCUOLA PRIMARIA,1,26,25,1,0,1
202223,MI1M07500A,SCUOLA SECONDARIA I GRADO,2,94,93,1,0,1
202223,VE1M01200G,SCUOLA SECONDARIA I GRADO,2,24,24,0,0,0
202223,BOTB02500D,SCUOLA SECONDARIA II GRADO,3,11,11,0,0,0
202223,SA1E00100G,SCUOLA PRIMARIA,1,13,12,1,0,1
202223,NARFV15001,SCUOLA SECONDARIA II GRADO,4,5,5,0,0,0
202223,RM1E5U5009,SCUOLA PRIMARIA,2,10,10,0,0,0
202223,NA1E02100A,SCUOLA PRIMARIA,4,12,12,0,0,0
202223,CTPSNQ5002,SCUOLA SECONDARIA II GRADO,3,8,7,1,0,1
202223,AVTF765001,SCUOLA SECONDARIA II GRADO,2,4,4,0,0,0
202223,RC1E00300L,SCUOLA PRIMARIA,5,14,12,2,0,2
202223,TOPLM6500B,SCUOLA SECONDARIA II GRADO,3,6,6,0,0,0
202223,VARCD7500V,SCUOLA SECONDARIA II GRADO,5,11,11,0,0,0
202223,MBPSUD500O,SCUOLA SECONDARIA II GRADO,1,21,21,0,0,0
202223,NA1E127006,SCUOLA PRIMARIA,2,65,62,3,0,3
202223,CE1ERT500Q,SCUOLA PRIMARIA,1,20,19,1,1,0
202223,BNRHZS500C,SCUOLA SECONDARIA II GRADO,5,66,65,1,0,1
202223,RMPC08500A,SCUOLA SECONDARIA II GRADO,5,89,89,0,0,0
202223,MOPS0N500H,SCUOLA SECONDARIA II GRADO,2,20,18,2,0,2
202223,RM1M08500D,SCUOLA SECONDARIA I GRADO,3,26,26,0,0,0
202223,NATNCE5004,SCUOLA SECONDARIA II GRADO,5,45,42,3,0,3
202223,BA1E018009,SCUOLA PRIMARIA,2,53,52,1,0,1
202223,RMPSHR5005,SCUOLA SECONDARIA II GRADO,5,44,40,4,2,2
202223,NA1E18900D,SCUOLA PRIMARIA,3,30,30,0,0,0
202223,MI1M04600A,SCUOLA SECONDARIA I GRADO,1,46,42,4,0,4
202223,LE1E005002,SCUOLA PRIMARIA,5,15,14,1,0,1
202223,AGTD02500N,SCUOLA SECONDARIA II GRADO,1,2,1,1,1,0
202223,NAPMS6500L,SCUOLA SECONDARIA II GRADO,2,16,16,0,0,0
202223,CTTF005004,SCUOLA SECONDARIA II GRADO,4,6,6,0,0,0
202223,PRPSAV500N,SCUOLA SECONDARIA II GRADO,4,26,25,1,1,0
202223,RC1E01000Q,SCUOLA PRIMARIA,4,22,22,0,0,0
202223,MI1E11800T,SCUOLA PRIMARIA,1,34,33,1,0,1
202223,MI1E03000G,SCUOLA PRIMARIA,1,24,24,0,0,0
202223,NATL25500P,SCUOLA SECONDARIA II GRADO,3,17,17,0,0,0
202223,CETL04500C,SCUOLA SECONDARIA II GRADO,2,4,4,0,0,0
202223,CA1E00200L,SCUOLA PRIMARIA,2,22,22,0,0,0
202223,NA1E18300E,SCUOLA PRIMARIA,1,47,47,0,0,0
202223,CSPQ025009,SCUOLA SECONDARIA II GRADO,5,11,11,0,0,0
202223,TV1M00900Q,SCUOLA SECONDARIA I GRADO,3,34,34,0,0,0
202223,VR1E00200B,SCUOLA PRIMARIA,3,12,10,2,0,2
202223,TV1E005007,SCUOLA PRIMARIA,3,23,22,1,0,1
202223,TS1E006009,SCUOLA PRIMARIA,2,24,24,0,0,0
202223,CTTF01500P,SCUOLA SECONDARIA II GRADO,3,5,5,0,0,0
202223,CETF4P500Q,SCUOLA SECONDARIA II GRADO,1,16,16,0,0,0
202223,PRPMF95000,SCUOLA SECONDARIA II GRADO,2,8,8,0,0,0
202223,AV1ETA500G,SCUOLA PRIMARIA,4,4,4,0,0,0
202223,NA1E13700R,SCUOLA PRIMARIA,1,17,17,0,0,0
202223,MI1E12000T,SCUOLA PRIMARIA,2,18,18,0,0,0
202223,VRRI01500X,SCUOLA SECONDARIA II GRADO,2,4,4,0,0,0
202223,PA1E01800B,SCUOLA PRIMARIA,5,16,15,1,0,1
202223,BG1E02000A,SCUOLA PRIMARIA,1,22,21,1,0,1
202223,MIPS4M500V,SCUOLA SECONDARIA II GRADO,3,12,12,0,0,0
202223,RMTB00500D,SCUOLA SECONDARIA II GRADO,5,15,12,3,1,2
202223,BS1E01300Q,SCUOLA PRIMARIA,3,12,12,0,0,0
202223,RM1E17300V,SCUOLA PRIMARIA,2,9,9,0,0,0
202223,RM1E03900E,SCUOLA PRIMARIA,2,20,17,3,0,3
202223,LC1M05000X,SCUOLA SECONDARIA I GRADO,1,65,65,0,0,0
202223,SRRHFP500H,SCUOLA SECONDARIA II GRADO,2,6,6,0,0,0
202223,PV1E001009,SCUOLA PRIMARIA,4,34,34,0,0,0
202223,GE1E027002,SCUOLA PRIMARIA,1,16,15,1,0,1
202223,VE1M00400L,SCUOLA SECONDARIA I GRADO,1,30,30,0,0,0
202223,NARHHE500A,SCUOLA SECONDARIA II GRADO,5,42,42,0,0,0
202223,FI1E00200R,SCUOLA PRIMARIA,5,28,27,1,0,1
202223,CB1E002007,SCUOLA PRIMARIA,3,15,11,4,1,3
202223,APTDCF500V,SCUOLA SECONDARIA II GRADO,4,2,2,0,0,0
202223,NA1E20800N,SCUOLA PRIMARIA,5,20,20,0,0,0
202223,NA1E221004,SCUOLA PRIMARIA,2,15,10,5,0,5
202223,BS1E008008,SCUOLA PRIMARIA,1,29,27,2,1,1
202223,CRPS02500L,SCUOLA SECONDARIA II GRADO,5,13,13,0,0,0
202223,LISL00500B,SCUOLA SECONDARIA II GRADO,4,9,9,0,0,0
202223,CA1E01000G,SCUOLA PRIMARIA,2,13,13,0,0,0
202223,VETN745000,SCUOLA SECONDARIA II GRADO,2,20,20,0,0,0
202223,RM1E03300G,SCUOLA PRIMARIA,3,43,36,7,3,4
202223,RM1E04700D,SCUOLA PRIMARIA,3,19,19,0,0,0
202223,BO1M01300A,SCUOLA SECONDARIA I GRADO,1,39,37,2,0,2
202223,VA1E41500F,SCUOLA PRIMARIA,2,14,14,0,0,0
202223,CTSD015003,SCUOLA SECONDARIA II GRADO,1,55,37,18,1,17
202223,LC1E00700C,SCUOLA PRIMARIA,2,20,19,1,0,1
202223,RMPC33500X,SCUOLA SECONDARIA II GRADO,4,9,8,1,1,0
202223,VR1M00700Q,SCUOLA SECONDARIA I GRADO,3,46,45,1,1,0
202223,COPSUC5004,SCUOLA SECONDARIA II GRADO,5,25,25,0,0,0
202223,RM1E06200G,SCUOLA PRIMARIA,1,31,30,1,0,1
202223,RM1E143003,SCUOLA PRIMARIA,4,40,39,1,0,1
202223,NATDS2500B,SCUOLA SECONDARIA II GRADO,3,9,9,0,0,0
202223,RMPMDD500Q,SCUOLA SECONDARIA II GRADO,2,8,8,0,0,0
202223,MIPL30500D,SCUOLA SECONDARIA II GRADO,3,11,9,2,0,2
202223,FG1E01300E,SCUOLA PRIMARIA,4,17,17,0,0,0
202223,FIPS065005,SCUOLA SECONDARIA II GRADO,3,3,3,0,0,0
202223,MI1E025004,SCUOLA PRIMARIA,4,42,38,4,0,4
202223,CEPL00500E,SCUOLA SECONDARIA II GRADO,4,20,20,0,0,0
202223,GO1E00100A,SCUOLA PRIMARIA,1,27,26,1,1,0
202223,RM1M11600X,SCUOLA SECONDARIA I GRADO,2,46,43,3,0,3
202223,NATFUA500M,SCUOLA SECONDARIA II GRADO,3,3,3,0,0,0
202223,TVTB205003,SCUOLA SECONDARIA II GRADO,5,26,24,2,1,1
202223,AP1E00300G,SCUOLA PRIMARIA,4,9,9,0,0,0
202223,RA1M00400C,SCUOLA SECONDARIA I GRADO,2,33,31,2,1,1
202223,RM1E036003,SCUOLA PRIMARIA,4,36,35,1,0,1
202223,RMPS56500L,SCUOLA SECONDARIA II GRADO,5,20,20,0,0,0
202223,PE1E009003,SCUOLA PRIMARIA,1,37,36,1,0,1
202223,PSPS005004,SCUOLA SECONDARIA II GRADO,5,15,15,0,0,0
202223,PEPMPL500U,SCUOLA SECONDARIA II GRADO,2,37,35,2,0,2
202223,ME1E01300E,SCUOLA PRIMARIA,5,27,26,1,0,1
202223,BS1M00100P,SCUOLA SECONDARIA I GRADO,3,23,22,1,1,0
202223,COPSCP5007,SCUOLA SECONDARIA II GRADO,4,17,17,0,0,0
202223,NA1E23100P,SCUOLA PRIMARIA,4,10,10,0,0,0
202223,RM1E148006,SCUOLA PRIMARIA,1,22,21,1,0,1
202223,VRTD04500A,SCUOLA SECONDARIA II GRADO,1,15,14,1,0,1
202223,BI1E00200D,SCUOLA PRIMARIA,1,24,23,1,1,0
202223,NA1E11000R,SCUOLA PRIMARIA,5,16,15,1,0,1
202223,TO1E00500V,SCUOLA PRIMARIA,4,21,15,6,0,6
202223,MBPS67500C,SCUOLA SECONDARIA II GRADO,4,25,24,1,0,1
202223,AP1E006003,SCUOLA PRIMARIA,1,23,23,0,0,0
202223,AP1E00100X,SCUOLA PRIMARIA,2,13,13,0,0,0
202223,SARFRL5003,SCUOLA SECONDARIA II GRADO,3,10,8,2,0,2
202223,NA1E081002,SCUOLA PRIMARIA,5,10,6,4,1,3
202223,NA1E085009,SCUOLA PRIMARIA,4,14,14,0,0,0
202223,FRPS1T500V,SCUOLA SECONDARIA II GRADO,2,10,10,0,0,0
202223,VA1MIT5001,SCUOLA SECONDARIA I GRADO,2,30,30,0,0,0
202223,FO1E00400N,SCUOLA PRIMARIA,4,43,42,1,0,1
202223,SATFIF5007,SCUOLA SECONDARIA II GRADO,2,7,6,1,0,1
202223,SATFH8500N,SCUOLA SECONDARIA II GRADO,3,7,6,1,1,0
202223,RM1E15300N,SCUOLA PRIMARIA,5,28,28,0,0,0
202223,MIPC06500L,SCUOLA SECONDARIA II GRADO,3,28,28,0,0,0
202223,AV1EE5500E,SCUOLA PRIMARIA,4,10,9,1,1,0
202223,GEPMAH500O,SCUOLA SECONDARIA II GRADO,1,46,41,5,0,5
202223,SARHDF500N,SCUOLA SECONDARIA II GRADO,2,2,2,0,0,0
202223,TO1E02700Q,SCUOLA PRIMARIA,2,49,40,9,2,7
202223,FI1M01200L,SCUOLA SECONDARIA I GRADO,1,19,16,3,1,2
202223,RM1E07400T,SCUOLA PRIMARIA,3,17,15,2,0,2
202223,PAPMUP500I,SCUOLA SECONDARIA II GRADO,5,26,26,0,0,0
202223,VA1M013001,SCUOLA SECONDARIA I GRADO,1,70,68,2,1,1
202223,BG1M00500D,SCUOLA SECONDARIA I GRADO,3,23,23,0,0,0
202223,CTPM075009,SCUOLA SECONDARIA II GRADO,4,4,4,0,0,0
202223,VC1E00200E,SCUOLA PRIMARIA,1,19,18,1,0,1
202223,NATF2S500C,SCUOLA SECONDARIA II GRADO,5,57,54,3,0,3
202223,UD1M00600L,SCUOLA SECONDARIA I GRADO,3,68,65,3,0,3
202223,CN1EN55004,SCUOLA PRIMARIA,3,13,13,0,0,0
202223,CR1E00400A,SCUOLA PRIMARIA,3,24,24,0,0,0
202223,MB1EQT500D,SCUOLA PRIMARIA,1,21,19,2,2,0
202223,BA1MDT500L,SCUOLA SECONDARIA I GRADO,1,11,11,0,0,0
202223,MO1E01100B,SCUOLA PRIMARIA,2,32,29,3,0,3
202223,BG1E005008,SCUOLA PRIMARIA,1,45,45,0,0,0
202223,RMPS72500B,SCUOLA SECONDARIA II GRADO,2,9,7,2,2,0
202223,RE1E002002,SCUOLA PRIMARIA,3,56,54,2,0,2
202223,RM1E08800Q,SCUOLA PRIMARIA,5,19,17,2,0,2
202223,BOPSVN5005,SCUOLA SECONDARIA II GRADO,5,14,14,0,0,0
202223,SATD27500X,SCUOLA SECONDARIA II GRADO,5,28,28,0,0,0
202223,RM1E212008,SCUOLA PRIMARIA,1,96,84,12,5,7
202223,PA1MQ8500S,SCUOLA SECONDARIA I GRADO,1,8,8,0,0,0
202223,MIPC15500V,SCUOLA SECONDARIA II GRADO,3,28,28,0,0,0
202223,TOPM035001,SCUOLA SECONDARIA II GRADO,5,27,26,1,1,0
202223,NATD51500C,SCUOLA SECONDARIA II GRADO,3,13,13,0,0,0
202223,MI1E054004,SCUOLA PRIMARIA,5,18,17,1,1,0
202223,MN1M001009,SCUOLA SECONDARIA I GRADO,3,35,30,5,2,3
202223,BA1E026008,SCUOLA PRIMARIA,4,25,24,1,0,1
202223,SAPL65500L,SCUOLA SECONDARIA II GRADO,1,9,9,0,0,0
202223,PVTBDH500G,SCUOLA SECONDARIA II GRADO,4,4,3,1,1,0
202223,TR1M00100X,SCUOLA SECONDARIA I GRADO,1,10,10,0,0,0
202223,RMPSCF500T,SCUOLA SECONDARIA II GRADO,3,8,8,0,0,0
202223,TO1E04800R,SCUOLA PRIMARIA,2,8,7,1,1,0
202223,CTTFOR5002,SCUOLA SECONDARIA II GRADO,3,2,2,0,0,0
202223,CE1E030007,SCUOLA PRIMARIA,5,12,11,1,0,1
202223,VA1EZH500L,SCUOLA PRIMARIA,5,14,14,0,0,0
202223,VATF295009,SCUOLA SECONDARIA II GRADO,5,19,19,0,0,0
202223,TVPL75500A,SCUOLA SECONDARIA II GRADO,2,20,18,2,0,2
202223,COTL045001,SCUOLA SECONDARIA II GRADO,2,8,7,1,0,1
202223,RM1E13800G,SCUOLA PRIMARIA,4,65,63,2,1,1
202223,BGTF1A500N,SCUOLA SECONDARIA II GRADO,4,3,3,0,0,0
202223,TOPMP2500E,SCUOLA SECONDARIA II GRADO,1,3,3,0,0,0
202223,PC1MIV500Z,SCUOLA SECONDARIA I GRADO,2,10,10,0,0,0
202223,BG1E02500D,SCUOLA PRIMARIA,1,38,38,0,0,0
202223,CT1E038004,SCUOLA PRIMARIA,4,17,17,0,0,0
202223,RMPS18500A,SCUOLA SECONDARIA II GRADO,5,34,28,6,1,5
202223,GR1E00100D,SCUOLA PRIMARIA,3,33,33,0,0,0
202223,BA1E00200Q,SCUOLA PRIMARIA,2,23,23,0,0,0
202223,TO1E004003,SCUOLA PRIMARIA,4,16,15,1,1,0
202223,CHRFQQ5004,SCUOLA SECONDARIA II GRADO,5,42,40,2,1,1
202223,PVPSTA500Q,SCUOLA SECONDARIA II GRADO,4,27,25,2,1,1
202223,PVTD05500P,SCUOLA SECONDARIA II GRADO,3,10,9,1,1,0
202223,REPS00500P,SCUOLA SECONDARIA II GRADO,2,12,12,0,0,0
202223,LE1E009009,SCUOLA PRIMARIA,2,13,13,0,0,0
202223,TO1M01100B,SCUOLA SECONDARIA I GRADO,2,20,19,1,0,1
202223,BS1M00800D,SCUOLA SECONDARIA I GRADO,3,51,50,1,1,0
202223,RMPL26500R,SCUOLA SECONDARIA II GRADO,1,20,19,1,0,1
202223,PC1E001007,SCUOLA PRIMARIA,2,21,19,2,1,1
202223,BG1E022002,SCUOLA PRIMARIA,5,24,24,0,0,0
202223,TVRA3C5009,SCUOLA SECONDARIA II GRADO,1,27,26,1,0,1
202223,NATABS5008,SCUOLA SECONDARIA II GRADO,5,69,69,0,0,0
202223,VI1E00400P,SCUOLA PRIMARIA,5,32,32,0,0,0
202223,RM1E16500X,SCUOLA PRIMARIA,4,9,9,0,0,0
202223,SATABS5008,SCUOLA SECONDARIA II GRADO,1,1,1,0,0,0
202223,GE1E01000L,SCUOLA PRIMARIA,2,27,27,0,0,0
202223,BOPSHR500B,SCUOLA SECONDARIA II GRADO,1,16,14,2,1,1
202223,LTPM02500Q,SCUOLA SECONDARIA II GRADO,2,27,26,1,0,1
202223,PATD26500Q,SCUOLA SECONDARIA II GRADO,3,14,14,0,0,0
202223,CETD43500Q,SCUOLA SECONDARIA II GRADO,1,11,11,0,0,0
202223,CT1M020004,SCUOLA SECONDARIA I GRADO,1,26,26,0,0,0
202223,BGPC05500B,SCUOLA SECONDARIA II GRADO,2,16,16,0,0,0
202223,BGPQ235008,SCUOLA SECONDARIA II GRADO,2,14,14,0,0,0
202223,GE1M02300X,SCUOLA SECONDARIA I GRADO,1,25,21,4,0,4
202223,NA1E093008,SCUOLA PRIMARIA,2,17,17,0,0,0
202223,BA1E01000P,SCUOLA PRIMARIA,2,27,26,1,0,1
202223,RM1E04500T,SCUOLA PRIMARIA,1,23,23,0,0,0
202223,SI1M00200A,SCUOLA SECONDARIA I GRADO,3,21,20,1,0,1
202223,RM1E08300L,SCUOLA PRIMARIA,3,37,37,0,0,0
202223,GE1E018007,SCUOLA PRIMARIA,5,12,12,0,0,0
202223,NARF5C500N,SCUOLA SECONDARIA II GRADO,2,6,5,1,0,1
202223,RNRCCE500C,SCUOLA SECONDARIA II GRADO,3,24,16,8,0,8
202223,PD1M00800T,SCUOLA SECONDARIA I GRADO,3,49,45,4,0,4
202223,PAPC14500P,SCUOLA SECONDARIA II GRADO,3,5,3,2,2,0
202223,RM1E114003,SCUOLA PRIMARIA,3,23,22,1,0,1
202223,FG1E00500G,SCUOLA PRIMARIA,2,21,21,0,0,0
202223,VASLQ8500T,SCUOLA SECONDARIA II GRADO,1,28,27,1,0,1
202223,VARH025001,SCUOLA SECONDARIA II GRADO,4,11,10,1,0,1
202223,CEPSSR500Q,SCUOLA SECONDARIA II GRADO,4,5,5,0,0,0
202223,NA1E10400D,SCUOLA PRIMARIA,4,11,11,0,0,0
202223,CR1E00300E,SCUOLA PRIMARIA,3,45,45,0,0,0
202223,MO1E00200L,SCUOLA PRIMARIA,1,31,27,4,1,3
202223,CN1E00200V,SCUOLA PRIMARIA,3,18,18,0,0,0
202223,CA1E01700A,SCUOLA PRIMARIA,1,18,18,0,0,0
202223,TPSD015003,SCUOLA SECONDARIA II GRADO,2,54,52,2,1,1
202223,MB1E040003,SCUOLA PRIMARIA,2,15,14,1,0,1
202223,PEPC025003,SCUOLA SECONDARIA II GRADO,5,4,4,0,0,0
202223,FI1E063008,SCUOLA PRIMARIA,5,11,9,2,0,2
202223,BGSD01500E,SCUOLA SECONDARIA II GRADO,5,41,41,0,0,0
202223,SVPM02500N,SCUOLA SECONDARIA II GRADO,4,14,14,0,0,0
202223,TOPS20500T,SCUOLA SECONDARIA II GRADO,4,30,30,0,0,0
202223,VRPC01500G,SCUOLA SECONDARIA II GRADO,4,29,29,0,0,0
202223,RMPC235003,SCUOLA SECONDARIA II GRADO,4,8,8,0,0,0
202223,CE1ELC500C,SCUOLA PRIMARIA,5,15,15,0,0,0
202223,RM1E18100T,SCUOLA PRIMARIA,2,17,13,4,0,4
202223,NATD46500L,SCUOLA SECONDARIA II GRADO,1,6,6,0,0,0
202223,MI1M03100L,SCUOLA SECONDARIA I GRADO,3,65,65,0,0,0
202223,PDTD01500R,SCUOLA SECONDARIA II GRADO,1,15,15,0,0,0
202223,NAPMGU500T,SCUOLA SECONDARIA II GRADO,3,7,7,0,0,0
202223,CE1E058003,SCUOLA PRIMARIA,4,11,10,1,0,1
202223,CZ1E002002,SCUOLA PRIMARIA,3,15,14,1,0,1
202223,UDPLO3500Z,SCUOLA SECONDARIA II GRADO,4,15,15,0,0,0
202223,BO1E00300E,SCUOLA PRIMARIA,2,8,7,1,0,1
202223,UD1E00500G,SCUOLA PRIMARIA,4,40,39,1,0,1
202223,VRPLHM500A,SCUOLA SECONDARIA II GRADO,1,21,19,2,1,1
202223,BS1E004001,SCUOLA PRIMARIA,1,45,43,2,1,1
202223,RMSLR1500M,SCUOLA SECONDARIA II GRADO,4,6,6,0,0,0
202223,MBPS0G5007,SCUOLA SECONDARIA II GRADO,2,17,17,0,0,0
202223,PI1E00300B,SCUOLA PRIMARIA,4,27,27,0,0,0
202223,VE1M01200G,SCUOLA SECONDARIA I GRADO,1,25,25,0,0,0
202223,LCPS01500L,SCUOLA SECONDARIA II GRADO,1,12,12,0,0,0
202223,RG1E00700Q,SCUOLA PRIMARIA,2,16,16,0,0,0
202223,LE1E00100P,SCUOLA PRIMARIA,4,44,44,0,0,0
202223,SA1E01300T,SCUOLA PRIMARIA,2,34,33,1,1,0
202223,CETAVH500S,SCUOLA SECONDARIA II GRADO,4,8,8,0,0,0
202223,RM1E200002,SCUOLA PRIMARIA,1,8,8,0,0,0
202223,NA1E02100A,SCUOLA PRIMARIA,5,15,14,1,1,0
202223,PR1E01000V,SCUOLA PRIMARIA,3,50,49,1,0,1
202223,RMPM5R5008,SCUOLA SECONDARIA II GRADO,1,8,7,1,0,1
202223,UD1EM3500M,SCUOLA PRIMARIA,4,22,22,0,0,0
202223,FIPSZD500T,SCUOLA SECONDARIA II GRADO,4,8,8,0,0,0
202223,MB1EP85003,SCUOLA PRIMARIA,2,23,23,0,0,0
202223,SAPS005004,SCUOLA SECONDARIA II GRADO,3,5,3,2,0,2
202223,TPTD80500R,SCUOLA SECONDARIA II GRADO,1,4,4,0,0,0
202223,RM1E030004,SCUOLA PRIMARIA,4,26,25,1,0,1
202223,MI1M06600G,SCUOLA SECONDARIA I GRADO,1,51,48,3,0,3
202223,PO1E001001,SCUOLA PRIMARIA,2,19,19,0,0,0
202223,AGTA6O500F,SCUOLA SECONDARIA II GRADO,4,4,4,0,0,0
202223,NO1E00500B,SCUOLA PRIMARIA,4,17,16,1,1,0
202223,AL1E6U500H,SCUOLA PRIMARIA,3,12,11,1,1,0
202223,ANPS00500T,SCUOLA SECONDARIA II GRADO,5,12,10,2,1,1
202223,BOPSPI500D,SCUOLA SECONDARIA II GRADO,3,47,47,0,0,0
202223,VA1E01400G,SCUOLA PRIMARIA,2,11,11,0,0,0
202223,SA1E009006,SCUOLA PRIMARIA,2,15,15,0,0,0
202223,SSPS02500V,SCUOLA SECONDARIA II GRADO,2,4,4,0,0,0
202223,TVPS035008,SCUOLA SECONDARIA II GRADO,4,26,26,0,0,0
202223,VR1E018001,SCUOLA PRIMARIA,5,29,23,6,1,5
202223,NA1E05500D,SCUOLA PRIMARIA,3,44,44,0,0,0
202223,NA1E24500L,SCUOLA PRIMARIA,3,12,12,0,0,0
202223,NATDE6500C,SCUOLA SECONDARIA II GRADO,3,3,3,0,0,0
202223,CN1M00400Q,SCUOLA SECONDARIA I GRADO,2,27,24,3,0,3
202223,FEPLDM500L,SCUOLA SECONDARIA II GRADO,4,9,5,4,1,3
202223,MBRH00500P,SCUOLA SECONDARIA II GRADO,3,45,42,3,0,3
202223,NA1E121007,SCUOLA PRIMARIA,4,14,14,0,0,0
202223,BNPC02500R,SCUOLA SECONDARIA II GRADO,1,17,17,0,0,0
202223,CE1E07100D,SCUOLA PRIMARIA,4,19,19,0,0,0
202223,LIPL01500X,SCUOLA SECONDARIA II GRADO,3,6,6,0,0,0
202223,MOPC005006,SCUOLA SECONDARIA II GRADO,3,8,7,1,0,1
202223,APPSR5500N,SCUOLA SECONDARIA II GRADO,4,2,2,0,0,0
202223,TO1E05600Q,SCUOLA PRIMARIA,4,16,15,1,1,0
202223,PDPS065002,SCUOLA SECONDARIA II GRADO,4,49,45,4,0,4
202223,TO1E05000R,SCUOLA PRIMARIA,3,22,22,0,0,0
202223,PETD06500C,SCUOLA SECONDARIA II GRADO,1,3,3,0,0,0
202223,PG1E4Q500B,SCUOLA PRIMARIA,1,16,15,1,1,0
202223,NA1E02000E,SCUOLA PRIMARIA,2,23,23,0,0,0
202223,FIPLZD500L,SCUOLA SECONDARIA II GRADO,3,2,2,0,0,0
202223,PC1E002003,SCUOLA PRIMARIA,5,17,17,0,0,0
202223,NAPSF2500E,SCUOLA SECONDARIA II GRADO,5,27,27,0,0,0
202223,MOPS02500E,SCUOLA SECONDARIA II GRADO,4,29,27,2,0,2
202223,BSTF8F5009,SCUOLA SECONDARIA II GRADO,3,6,6,0,0,0
202223,BGPS065005,SCUOLA SECONDARIA II GRADO,3,15,13,2,2,0
202223,RMTN8V500Q,SCUOLA SECONDARIA II GRADO,3,2,2,0,0,0
202223,VR1E00700E,SCUOLA PRIMARIA,3,40,39,1,1,0
202223,VAPSDE500S,SCUOLA SECONDARIA II GRADO,2,21,21,0,0,0
202223,RM1E007003,SCUOLA PRIMARIA,2,19,19,0,0,0
202223,BSPS08500V,SCUOLA SECONDARIA II GRADO,4,21,20,1,0,1
202223,BSPS13500P,SCUOLA SECONDARIA II GRADO,4,15,15,0,0,0
202223,MISL04500B,SCUOLA SECONDARIA II GRADO,1,72,67,5,3,2
202223,NA1E8R5008,SCUOLA PRIMARIA,2,10,10,0,0,0
202223,NA1M011001,SCUOLA SECONDARIA I GRADO,1,14,14,0,0,0
202223,BS1E0E500A,SCUOLA PRIMARIA,5,13,13,0,0,0
202223,BO1E00900D,SCUOLA PRIMARIA,3,58,57,1,1,0
202223,GE1E033009,SCUOLA PRIMARIA,5,44,43,1,0,1
202223,CT1E00600L,SCUOLA PRIMARIA,4,17,14,3,0,3
202223,MIPS42500R,SCUOLA SECONDARIA II GRADO,3,59,59,0,0,0
202223,RMTD43500Q,SCUOLA SECONDARIA II GRADO,1,1,1,0,0,0
202223,MB1M02800N,SCUOLA SECONDARIA I GRADO,1,32,31,1,0,1
202223,MBPS28500G,SCUOLA SECONDARIA II GRADO,4,8,8,0,0,0
202223,RM1E16700G,SCUOLA PRIMARIA,4,26,26,0,0,0
202223,RE1E007005,SCUOLA PRIMARIA,1,24,23,1,0,1
202223,FR1E002005,SCUOLA PRIMARIA,2,12,10,2,1,1
202223,RM1E001004,SCUOLA PRIMARIA,5,27,25,2,0,2
202223,RM1E5A500D,SCUOLA PRIMARIA,2,16,16,0,0,0
202223,NARHP4500A,SCUOLA SECONDARIA II GRADO,3,4,4,0,0,0
202223,NA1EIE500T,SCUOLA PRIMARIA,1,18,18,0,0,0
202223,NARHSC500S,SCUOLA SECONDARIA II GRADO,2,4,4,0,0,0
202223,PO1E006004,SCUOLA PRIMARIA,1,24,19,5,0,5
202223,GE1M00800T,SCUOLA SECONDARIA I GRADO,3,21,21,0,0,0
202223,RMTA1T500M,SCUOLA SECONDARIA II GRADO,2,7,6,1,0,1
202223,MO1M0B500E,SCUOLA SECONDARIA I GRADO,2,11,11,0,0,0
202223,RMPSE55000,SCUOLA SECONDARIA II GRADO,5,30,30,0,0,0
202223,TO1E03000G,SCUOLA PRIMARIA,4,19,18,1,0,1
202223,RMPS335003,SCUOLA SECONDARIA II GRADO,4,23,23,0,0,0
202223,AL1M00400B,SCUOLA SECONDARIA I GRADO,3,16,16,0,0,0
202223,BO1MZN5006,SCUOLA SECONDARIA I GRADO,2,43,41,2,0,2
202223,RM1E077009,SCUOLA PRIMARIA,5,14,1,13,0,13
202223,PV1E007008,SCUOLA PRIMARIA,2,15,10,5,1,4
202223,NA1E20300E,SCUOLA PRIMARIA,3,23,23,0,0,0
202223,LT1E005008,SCUOLA PRIMARIA,2,31,31,0,0,0
202223,RM1EGU500T,SCUOLA PRIMARIA,4,27,27,0,0,0
202223,RM1EBP500D,SCUOLA PRIMARIA,1,7,6,1,0,1
202223,SATLGF500Z,SCUOLA SECONDARIA II GRADO,3,7,7,0,0,0
202223,COPSI65000,SCUOLA SECONDARIA II GRADO,1,19,18,1,1,0
202223,RM1E14700A,SCUOLA PRIMARIA,5,18,15,3,2,1
202223,COTAV75005,SCUOLA SECONDARIA II GRADO,5,25,25,0,0,0
202223,CO1E013002,SCUOLA PRIMARIA,2,32,31,1,0,1
202223,RMRH12500C,SCUOLA SECONDARIA II GRADO,1,14,7,7,3,4
202223,RMPST6500P,SCUOLA SECONDARIA II GRADO,1,8,8,0,0,0
202223,PD1E01000L,SCUOLA PRIMARIA,5,46,45,1,0,1
202223,RCPC02500G,SCUOLA SECONDARIA II GRADO,4,7,7,0,0,0
202223,NAPSZI500L,SCUOLA SECONDARIA II GRADO,2,17,17,0,0,0
202223,NAPLVR500O,SCUOLA SECONDARIA II GRADO,4,20,19,1,0,1
202223,BO1E01500R,SCUOLA PRIMARIA,5,40,40,0,0,0
202223,MIPQ01500X,SCUOLA SECONDARIA II GRADO,3,25,25,0,0,0
202223,NA1E199004,SCUOLA PRIMARIA,1,8,8,0,0,0
202223,SATD4D500E,SCUOLA SECONDARIA II GRADO,1,8,8,0,0,0
202223,AG1EVA500E,SCUOLA PRIMARIA,1,13,13,0,0,0
202223,PA1M01800L,SCUOLA SECONDARIA I GRADO,2,16,13,3,0,3
202223,NATF9E5003,SCUOLA SECONDARIA II GRADO,5,70,67,3,1,2
202223,RMRF00500V,SCUOLA SECONDARIA II GRADO,1,3,3,0,0,0
202223,FG1E023005,SCUOLA PRIMARIA,2,18,17,1,0,1
202223,NAPS37500E,SCUOLA SECONDARIA II GRADO,3,10,10,0,0,0
202223,BG1E03200L,SCUOLA PRIMARIA,1,36,36,0,0,0
202223,RM1M06900G,SCUOLA SECONDARIA I GRADO,3,34,33,1,1,0
202223,MBPS245005,SCUOLA SECONDARIA II GRADO,2,4,4,0,0,0
202223,MN1E00200X,SCUOLA PRIMARIA,2,35,34,1,0,1
202223,NA1E00400L,SCUOLA PRIMARIA,5,6,3,3,0,3
202223,CL1E003004,SCUOLA PRIMARIA,2,20,20,0,0,0
202223,RA1E00300B,SCUOLA PRIMARIA,3,25,22,3,2,1
202223,NA1E064008,SCUOLA PRIMARIA,1,17,5,12,0,12
202223,TV1M002001,SCUOLA SECONDARIA I GRADO,1,56,52,4,2,2
202223,FR1M00100E,SCUOLA SECONDARIA I GRADO,2,15,15,0,0,0
202223,FITD01500X,SCUOLA SECONDARIA II GRADO,3,9,9,0,0,0
202223,TO1ED5500F,SCUOLA PRIMARIA,2,10,10,0,0,0
202223,NA1MR7500R,SCUOLA SECONDARIA I GRADO,1,33,24,9,7,2
202223,FI1E013007,SCUOLA PRIMARIA,3,21,16,5,0,5
202223,SATFP3500G,SCUOLA SECONDARIA II GRADO,5,69,65,4,0,4
202223,TOPS04500E,SCUOLA SECONDARIA II GRADO,4,51,51,0,0,0
202223,AV1E00500N,SCUOLA PRIMARIA,2,11,11,0,0,0
202223,MI1M097007,SCUOLA SECONDARIA I GRADO,2,21,21,0,0,0
202223,PVPL02500T,SCUOLA SECONDARIA II GRADO,5,12,11,1,1,0
202223,MI1E137007,SCUOLA PRIMARIA,4,10,9,1,1,0
202223,NA1E05900R,SCUOLA PRIMARIA,5,11,11,0,0,0
202223,TV1EAE500L,SCUOLA PRIMARIA,3,25,25,0,0,0
202223,NAPLQ2500N,SCUOLA SECONDARIA II GRADO,1,15,15,0,0,0
202223,CE1E04000T,SCUOLA PRIMARIA,4,39,36,3,0,3
202223,TV1M007004,SCUOLA SECONDARIA I GRADO,2,69,68,1,0,1
202223,FRTD0N500M,SCUOLA SECONDARIA II GRADO,3,2,2,0,0,0
202223,VAPLDB5003,SCUOLA SECONDARIA II GRADO,2,6,6,0,0,0
202223,CTTD145005,SCUOLA SECONDARIA II GRADO,3,3,3,0,0,0
202223,VE1E005007,SCUOLA PRIMARIA,2,13,12,1,0,1
202223,TO1M00900B,SCUOLA SECONDARIA I GRADO,1,78,77,1,1,0
202223,FI1E014003,SCUOLA PRIMARIA,2,13,11,2,1,1
202223,RMPM3Q500P,SCUOLA SECONDARIA II GRADO,3,12,12,0,0,0
202223,COPL025008,SCUOLA SECONDARIA II GRADO,2,24,23,1,0,1
202223,TO1M05700R,SCUOLA SECONDARIA I GRADO,2,27,26,1,1,0
202223,CN1MNS500A,SCUOLA SECONDARIA I GRADO,1,10,7,3,0,3
202223,BG1E01700E,SCUOLA PRIMARIA,2,2,1,1,0,1
202223,AR1E00300R,SCUOLA PRIMARIA,2,11,11,0,0,0
202223,RMPS54500B,SCUOLA SECONDARIA II GRADO,2,2,1,1,0,1
202223,AGPSFG5009,SCUOLA SECONDARIA II GRADO,4,5,5,0,0,0
202223,RM1E09500V,SCUOLA PRIMARIA,5,24,22,2,1,1
202223,LT1E01000Q,SCUOLA PRIMARIA,5,12,11,1,0,1
202223,SATDP9500M,SCUOLA SECONDARIA II GRADO,1,4,4,0,0,0
202223,PAPC07500N,SCUOLA SECONDARIA II GRADO,3,19,19,0,0,0
202223,NATF215004,SCUOLA SECONDARIA II GRADO,4,12,12,0,0,0
202223,RMPM08500E,SCUOLA SECONDARIA II GRADO,3,20,17,3,1,2
202223,RMPSLS5006,SCUOLA SECONDARIA II GRADO,3,13,13,0,0,0
202223,BA1E01100E,SCUOLA PRIMARIA,3,11,9,2,0,2
202223,NO1E00200X,SCUOLA PRIMARIA,3,40,36,4,2,2
202223,RM1E02500L,SCUOLA PRIMARIA,2,19,17,2,0,2
202223,TOPS76500T,SCUOLA SECONDARIA II GRADO,5,48,48,0,0,0
202223,CE1E04700L,SCUOLA PRIMARIA,2,11,11,0,0,0
202223,PV1E00400R,SCUOLA PRIMARIA,4,22,21,1,1,0
202223,CE1E03300P,SCUOLA PRIMARIA,1,22,22,0,0,0
202223,BS1M01000D,SCUOLA SECONDARIA I GRADO,1,54,50,4,0,4
202223,TVPS015003,SCUOLA SECONDARIA II GRADO,2,35,32,3,0,3
202223,AVTF125004,SCUOLA SECONDARIA II GRADO,4,9,9,0,0,0
202223,RM1E121006,SCUOLA PRIMARIA,1,51,50,1,1,0
202223,VRPMPR500A,SCUOLA SECONDARIA II GRADO,1,14,12,2,1,1
202223,VATB215007,SCUOLA SECONDARIA II GRADO,2,14,13,1,0,1
202223,NA1E12500E,SCUOLA PRIMARIA,1,22,20,2,0,2
202223,NAPS555009,SCUOLA SECONDARIA II GRADO,5,4,4,0,0,0
202223,MIPSQB5007,SCUOLA SECONDARIA II GRADO,2,30,30,0,0,0
202223,PVSL1E500O,SCUOLA SECONDARIA II GRADO,3,3,3,0,0,0
202223,MI1EN0500I,SCUOLA PRIMARIA,2,10,9,1,0,1
202223,SARF195006,SCUOLA SECONDARIA II GRADO,3,8,6,2,0,2
202223,LE1E00100P,SCUOLA PRIMARIA,1,34,32,2,0,2
202223,MB1E03500G,SCUOLA PRIMARIA,5,37,37,0,0,0
202223,SAPS11500B,SCUOLA SECONDARIA II GRADO,3,1,1,0,0,0
202223,PATD205004,SCUOLA SECONDARIA II GRADO,1,4,4,0,0,0
202223,PR1E00800V,SCUOLA PRIMARIA,2,23,23,0,0,0
202223,RMPL445009,SCUOLA SECONDARIA II GRADO,5,15,15,0,0,0
202223,VRPS01500P,SCUOLA SECONDARIA II GRADO,4,19,16,3,1,2
202223,PA1E02600A,SCUOLA PRIMARIA,3,13,12,1,0,1
202223,NAPS355009,SCUOLA SECONDARIA II GRADO,4,22,22,0,0,0
202223,TVPSN55005,SCUOLA SECONDARIA II GRADO,5,23,23,0,0,0
202223,TO1E01300T,SCUOLA PRIMARIA,5,54,53,1,1,0
202223,SAPSL4500R,SCUOLA SECONDARIA II GRADO,2,12,12,0,0,0
202223,RM1E051005,SCUOLA PRIMARIA,4,24,22,2,2,0
202223,PARI045006,SCUOLA SECONDARIA II GRADO,3,2,2,0,0,0
202223,RNTL025002,SCUOLA SECONDARIA II GRADO,1,5,3,2,0,2
202223,TO1M03500X,SCUOLA SECONDARIA I GRADO,3,16,15,1,0,1
202223,VR1M01100B,SCUOLA SECONDARIA I GRADO,3,11,11,0,0,0
202223,VR1E01300T,SCUOLA PRIMARIA,5,23,23,0,0,0
202223,GE1ELE500C,SCUOLA PRIMARIA,5,18,17,1,0,1
202223,VT1E008001,SCUOLA PRIMARIA,2,5,5,0,0,0
202223,RMPL445009,SCUOLA SECONDARIA II GRADO,2,7,7,0,0,0
202223,APTFZ6500L,SCUOLA SECONDARIA II GRADO,4,2,2,0,0,0
202223,MIPS74500L,SCUOLA SECONDARIA II GRADO,1,24,23,1,0,1
202223,SAPMBS5006,SCUOLA SECONDARIA II GRADO,4,7,7,0,0,0
202223,MBPMM55007,SCUOLA SECONDARIA II GRADO,5,30,30,0,0,0
202223,LOPS01500A,SCUOLA SECONDARIA II GRADO,2,15,13,2,0,2
202223,SR1M00200P,SCUOLA SECONDARIA I GRADO,3,27,26,1,0,1
202223,NOPL015002,SCUOLA SECONDARIA II GRADO,1,13,13,0,0,0
202223,GE1E020007,SCUOLA PRIMARIA,3,19,19,0,0,0
202223,PG1E00200V,SCUOLA PRIMARIA,1,10,8,2,0,2
202223,SS1E01000X,SCUOLA PRIMARIA,4,11,10,1,0,1
202223,NA1E023002,SCUOLA PRIMARIA,1,9,8,1,0,1
202223,PD1E076018,SCUOLA PRIMARIA,4,19,18,1,1,0
202223,NA1E04000Q,SCUOLA PRIMARIA,5,18,18,0,0,0
202223,RMPM9A500G,SCUOLA SECONDARIA II GRADO,1,22,21,1,0,1
202223,NA1E28200G,SCUOLA PRIMARIA,3,14,13,1,0,1
202223,RM1E10700X,SCUOLA PRIMARIA,3,23,20,3,0,3
202223,FIPSCR500M,SCUOLA SECONDARIA II GRADO,2,2,1,1,0,1
202223,NA1E099007,SCUOLA PRIMARIA,5,3,3,0,0,0
202223,CR1E006002,SCUOLA PRIMARIA,1,14,14,0,0,0
202223,APPCV8500G,SCUOLA SECONDARIA II GRADO,5,13,13,0,0,0
202223,CA1E01400V,SCUOLA PRIMARIA,1,12,12,0,0,0
202223,TO1E04900L,SCUOLA PRIMARIA,1,47,47,0,0,0
202223,TO1E040006,SCUOLA PRIMARIA,3,46,44,2,1,1
202223,FI1E03300C,SCUOLA PRIMARIA,4,23,23,0,0,0
202223,VI1E01300D,SCUOLA PRIMARIA,3,22,21,1,1,0
202223,VA1E01800V,SCUOLA PRIMARIA,3,12,12,0,0,0
202223,RMPC44500B,SCUOLA SECONDARIA II GRADO,2,10,10,0,0,0
202223,BG1M010001,SCUOLA SECONDARIA I GRADO,1,126,125,1,0,1
202223,BSPME1500B,SCUOLA SECONDARIA II GRADO,1,15,12,3,1,2
202223,NATFED500D,SCUOLA SECONDARIA II GRADO,5,53,52,1,0,1
202223,MIPL125001,SCUOLA SECONDARIA II GRADO,5,198,193,5,0,5
202223,PD1E00100T,SCUOLA PRIMARIA,1,13,11,2,0,2
202223,MIPSE7500I,SCUOLA SECONDARIA II GRADO,3,37,36,1,0,1
202223,RM1M04100Q,SCUOLA SECONDARIA I GRADO,1,19,18,1,0,1
202223,NATN7V500I,SCUOLA SECONDARIA II GRADO,1,7,7,0,0,0
202223,RMTF145002,SCUOLA SECONDARIA II GRADO,2,9,8,1,0,1
202223,RG1E00700Q,SCUOLA PRIMARIA,3,16,16,0,0,0
202223,NAPM39500R,SCUOLA SECONDARIA II GRADO,1,8,8,0,0,0
202223,PETN015009,SCUOLA SECONDARIA II GRADO,3,6,4,2,1,1
202223,RM1E01300A,SCUOLA PRIMARIA,3,24,23,1,1,0
202223,MEPMEB500L,SCUOLA SECONDARIA II GRADO,3,6,5,1,0,1
202223,BSPMNI500T,SCUOLA SECONDARIA II GRADO,3,23,22,1,0,1
202223,SV1E00400A,SCUOLA PRIMARIA,3,10,10,0,0,0
202223,NA1M060006,SCUOLA SECONDARIA I GRADO,2,10,10,0,0,0
202223,VAPMSE500O,SCUOLA SECONDARIA II GRADO,5,15,15,0,0,0
202223,FI1E01800A,SCUOLA PRIMARIA,2,10,7,3,1,2
202223,NA1E23600T,SCUOLA PRIMARIA,3,15,15,0,0,0
202223,NATFPQ500Q,SCUOLA SECONDARIA II GRADO,1,3,3,0,0,0
202223,BNTL025006,SCUOLA SECONDARIA II GRADO,1,1,1,0,0,0
202223,AV1E008005,SCUOLA PRIMARIA,5,20,20,0,0,0
202223,SATF1D500C,SCUOLA SECONDARIA II GRADO,4,13,13,0,0,0
202223,RMTAZI500E,SCUOLA SECONDARIA II GRADO,5,18,16,2,2,0
202223,RM1E18100T,SCUOLA PRIMARIA,5,23,12,11,0,11
202223,PGPSVU500T,SCUOLA SECONDARIA II GRADO,1,1,1,0,0,0
202223,APPCU15007,SCUOLA SECONDARIA II GRADO,2,11,11,0,0,0
202223,TO1E003007,SCUOLA PRIMARIA,3,32,32,0,0,0
202223,CS1MT95008,SCUOLA SECONDARIA I GRADO,2,2,1,1,0,1
202223,REPSQE5008,SCUOLA SECONDARIA II GRADO,4,16,14,2,0,2
202223,VR1E009006,SCUOLA PRIMARIA,4,18,18,0,0,0
202223,RG1E0O5005,SCUOLA PRIMARIA,2,18,18,0,0,0
202223,CERHFI5007,SCUOLA SECONDARIA II GRADO,4,31,30,1,0,1
202223,RM1E00800V,SCUOLA PRIMARIA,3,12,12,0,0,0
202223,LUPL01500A,SCUOLA SECONDARIA II GRADO,5,17,14,3,1,2
202223,CTPM345004,SCUOLA SECONDARIA II GRADO,5,11,11,0,0,0
202223,SI1E001009,SCUOLA PRIMARIA,1,20,20,0,0,0
202223,PDPS02500G,SCUOLA SECONDARIA II GRADO,3,49,49,0,0,0
202223,NATF41500Q,SCUOLA SECONDARIA II GRADO,2,9,9,0,0,0
202223,SATFET500V,SCUOLA SECONDARIA II GRADO,4,7,7,0,0,0
202223,MI1E08000L,SCUOLA PRIMARIA,1,10,6,4,1,3
202223,PATDAH500E,SCUOLA SECONDARIA II GRADO,3,4,4,0,0,0
202223,RMTD545007,SCUOLA SECONDARIA II GRADO,1,13,11,2,0,2
202223,RE1E00400N,SCUOLA PRIMARIA,5,27,27,0,0,0
202223,GE1E026006,SCUOLA PRIMARIA,3,20,19,1,0,1
202223,VA1E02100P,SCUOLA PRIMARIA,5,67,66,1,0,1
202223,SA1E01400N,SCUOLA PRIMARIA,2,15,15,0,0,0
202223,VA1E00600L,SCUOLA PRIMARIA,4,17,14,3,3,0
202223,METD08500D,SCUOLA SECONDARIA II GRADO,1,2,2,0,0,0
202223,NARHHE500A,SCUOLA SECONDARIA II GRADO,1,3,3,0,0,0
202223,IM1M00500T,SCUOLA SECONDARIA I GRADO,1,15,10,5,0,5
202223,CTPL00500R,SCUOLA SECONDARIA II GRADO,4,4,4,0,0,0
202223,CO1M013007,SCUOLA SECONDARIA I GRADO,3,47,47,0,0,0
202223,FE1E00200D,SCUOLA PRIMARIA,1,18,18,0,0,0
202223,TOPC11500C,SCUOLA SECONDARIA II GRADO,1,1,1,0,0,0
202223,RMPSPG500N,SCUOLA SECONDARIA II GRADO,1,12,11,1,0,1
202223,MI1E06400P,SCUOLA PRIMARIA,3,19,18,1,0,1
202223,MNPL02500L,SCUOLA SECONDARIA II GRADO,5,5,5,0,0,0
202223,NA1E192009,SCUOLA PRIMARIA,2,10,10,0,0,0
202223,CTTN01500A,SCUOLA SECONDARIA II GRADO,1,8,7,1,0,1
202223,RM1M002005,SCUOLA SECONDARIA I GRADO,3,4,4,0,0,0
202223,LC1E004001,SCUOLA PRIMARIA,3,28,27,1,0,1
202223,NA1E25300G,SCUOLA PRIMARIA,3,21,21,0,0,0
202223,RM1E12300T,SCUOLA PRIMARIA,2,46,46,0,0,0
202223,RMRF9P500F,SCUOLA SECONDARIA II GRADO,5,42,35,7,4,3
202223,FE1E00200D,SCUOLA PRIMARIA,5,24,24,0,0,0
202223,CN1E001003,SCUOLA PRIMARIA,2,16,15,1,0,1
202223,NA1E186002,SCUOLA PRIMARIA,4,12,12,0,0,0
202223,NA1E18900D,SCUOLA PRIMARIA,1,35,35,0,0,0
202223,NAPL19500R,SCUOLA SECONDARIA II GRADO,4,12,12,0,0,0
202223,LE1E005002,SCUOLA PRIMARIA,4,15,11,4,1,3
202223,TV1E00700V,SCUOLA PRIMARIA,5,18,17,1,0,1
202223,RM1E00200X,SCUOLA PRIMARIA,1,22,21,1,0,1
202223,ME1E00900V,SCUOLA PRIMARIA,5,11,6,5,0,5
202223,CE1E028007,SCUOLA PRIMARIA,4,16,16,0,0,0
202223,NA1EIE500T,SCUOLA PRIMARIA,2,18,18,0,0,0
202223,BO1E013005,SCUOLA PRIMARIA,5,20,20,0,0,0
202223,TVTF015005,SCUOLA SECONDARIA II GRADO,1,28,28,0,0,0
202223,BG1E01500V,SCUOLA PRIMARIA,1,27,25,2,1,1
202223,RMTD58500N,SCUOLA SECONDARIA II GRADO,3,40,36,4,1,3
202223,NA1E22900P,SCUOLA PRIMARIA,5,17,16,1,0,1
202223,CHTF00500E,SCUOLA SECONDARIA II GRADO,5,9,7,2,1,1
202223,MI1M070007,SCUOLA SECONDARIA I GRADO,2,41,40,1,0,1
202223,LC1M10100G,SCUOLA SECONDARIA I GRADO,1,55,55,0,0,0
202223,MI1E016009,SCUOLA PRIMARIA,5,40,38,2,0,2
202223,RM1E00200X,SCUOLA PRIMARIA,5,14,12,2,1,1
202223,RO1E00300A,SCUOLA PRIMARIA,4,13,13,0,0,0
202223,MITD25500P,SCUOLA SECONDARIA II GRADO,5,10,10,0,0,0
202223,PO1E013007,SCUOLA PRIMARIA,3,20,15,5,0,5
202223,BSPS06500N,SCUOLA SECONDARIA II GRADO,4,23,23,0,0,0
202223,VE1E01100E,SCUOLA PRIMARIA,3,17,17,0,0,0
202223,PD1EOO500S,SCUOLA PRIMARIA,4,4,2,2,0,2
202223,PAPMO7500Q,SCUOLA SECONDARIA II GRADO,1,9,9,0,0,0
202223,UDTF00500V,SCUOLA SECONDARIA II GRADO,5,32,31,1,0,1
202223,NA1E22400G,SCUOLA PRIMARIA,5,57,56,1,0,1
202223,BS1E01300Q,SCUOLA PRIMARIA,1,14,13,1,0,1
202223,NATD0C5008,SCUOLA SECONDARIA II GRADO,5,103,101,2,0,2
202223,TOPST1500C,SCUOLA SECONDARIA II GRADO,5,18,17,1,1,0
202223,RMPS455005,SCUOLA SECONDARIA II GRADO,5,41,40,1,0,1
202223,RM1E08700X,SCUOLA PRIMARIA,2,7,7,0,0,0
202223,MIPM1R500Q,SCUOLA SECONDARIA II GRADO,4,22,22,0,0,0
202223,LC1M040009,SCUOLA SECONDARIA I GRADO,2,61,60,1,1,0
202223,AL1E00300A,SCUOLA PRIMARIA,3,17,17,0,0,0
202223,BO1E01600L,SCUOLA PRIMARIA,1,40,37,3,2,1
202223,PV1E001009,SCUOLA PRIMARIA,2,44,44,0,0,0
202223,FI1M00500D,SCUOLA SECONDARIA I GRADO,3,21,19,2,1,1
202223,FI1M029002,SCUOLA SECONDARIA I GRADO,2,30,25,5,0,5
202223,LU1E00700B,SCUOLA PRIMARIA,3,21,20,1,0,1
202223,NA1E030005,SCUOLA PRIMARIA,2,10,10,0,0,0
202223,CO1E01400T,SCUOLA PRIMARIA,5,48,48,0,0,0
202223,TO1M05200N,SCUOLA SECONDARIA I GRADO,3,121,116,5,2,3
202223,RM1MHD500Z,SCUOLA SECONDARIA I GRADO,2,15,14,1,0,1
202223,MI1E047001,SCUOLA PRIMARIA,1,57,55,2,0,2
202223,RM1E03300G,SCUOLA PRIMARIA,1,31,26,5,1,4
202223,RN1E00400D,SCUOLA PRIMARIA,2,19,19,0,0,0
202223,MIPMGC500D,SCUOLA SECONDARIA II GRADO,3,23,23,0,0,0
202223,TS1E00400N,SCUOLA PRIMARIA,2,16,16,0,0,0
202223,SATDST500C,SCUOLA SECONDARIA II GRADO,4,5,5,0,0,0
202223,BSPM4P500U,SCUOLA SECONDARIA II GRADO,4,22,20,2,1,1
202223,TVPL08500G,SCUOLA SECONDARIA II GRADO,2,27,27,0,0,0
202223,AVTFVM500N,SCUOLA SECONDARIA II GRADO,5,70,67,3,1,2
202223,BLPSMD500A,SCUOLA SECONDARIA II GRADO,5,5,5,0,0,0
202223,VARH01500A,SCUOLA SECONDARIA II GRADO,1,35,33,2,0,2
202223,NAPS045004,SCUOLA SECONDARIA II GRADO,3,31,30,1,0,1
202223,RM1M04700P,SCUOLA SECONDARIA I GRADO,2,15,15,0,0,0
202223,MI1E04300N,SCUOLA PRIMARIA,1,42,41,1,0,1
202223,MOTD04500G,SCUOLA SECONDARIA II GRADO,1,16,14,2,1,1
202223,NATLT3500M,SCUOLA SECONDARIA II GRADO,2,9,9,0,0,0
202223,CHTD035004,SCUOLA SECONDARIA II GRADO,3,5,5,0,0,0
202223,AP1E00300G,SCUOLA PRIMARIA,3,14,13,1,1,0
202223,LCRF085005,SCUOLA SECONDARIA II GRADO,3,16,14,2,0,2
202223,MB1E052009,SCUOLA PRIMARIA,1,44,42,2,1,1
202223,BGPSH85002,SCUOLA SECONDARIA II GRADO,2,28,27,1,0,1
202223,TA1E00500X,SCUOLA PRIMARIA,3,19,18,1,1,0
202223,PO1E00900G,SCUOLA PRIMARIA,1,26,18,8,0,8
202223,SV1M00200X,SCUOLA SECONDARIA I GRADO,1,21,20,1,1,0
202223,PS1E003007,SCUOLA PRIMARIA,4,20,20,0,0,0
202223,MI1M10100N,SCUOLA SECONDARIA I GRADO,1,66,64,2,0,2
202223,MI1E12100N,SCUOLA PRIMARIA,5,46,46,0,0,0
202223,GEPS07500L,SCUOLA SECONDARIA II GRADO,5,12,12,0,0,0
202223,NA1E06200L,SCUOLA PRIMARIA,3,64,64,0,0,0
202223,NA1E081002,SCUOLA PRIMARIA,4,10,4,6,0,6
202223,SARFMI5004,SCUOLA SECONDARIA II GRADO,2,3,3,0,0,0
202223,CE1E036006,SCUOLA PRIMARIA,5,13,10,3,1,2
202223,PAPS5E500M,SCUOLA SECONDARIA II GRADO,4,6,6,0,0,0
202223,NA1E052002,SCUOLA PRIMARIA,1,21,21,0,0,0
202223,RMPM045004,SCUOLA SECONDARIA II GRADO,3,23,22,1,0,1
202223,CE1E01100T,SCUOLA PRIMARIA,5,30,30,0,0,0
202223,MI1E08400X,SCUOLA PRIMARIA,3,22,22,0,0,0
202223,ARPM015009,SCUOLA SECONDARIA II GRADO,4,34,34,0,0,0
202223,LI1E006005,SCUOLA PRIMARIA,3,36,34,2,0,2
202223,RMPS5G5003,SCUOLA SECONDARIA II GRADO,3,14,14,0,0,0
202223,PG1M001008,SCUOLA SECONDARIA I GRADO,3,21,18,3,0,3
202223,VTTD015005,SCUOLA SECONDARIA II GRADO,5,92,88,4,3,1
202223,LT1E006004,SCUOLA PRIMARIA,5,14,14,0,0,0
202223,CETD15500D,SCUOLA SECONDARIA II GRADO,3,17,17,0,0,0
202223,AG1EVA500E,SCUOLA PRIMARIA,3,15,15,0,0,0
202223,RM1E134008,SCUOLA PRIMARIA,4,21,20,1,1,0
202223,NATF28500A,SCUOLA SECONDARIA II GRADO,4,3,3,0,0,0
202223,NATF2S500C,SCUOLA SECONDARIA II GRADO,4,3,3,0,0,0
202223,RMPM3G5002,SCUOLA SECONDARIA II GRADO,2,7,5,2,1,1
202223,NOPS03500C,SCUOLA SECONDARIA II GRADO,5,45,44,1,1,0
202223,MN1M001009,SCUOLA SECONDARIA I GRADO,2,35,30,5,1,4
202223,MI1E061007,SCUOLA PRIMARIA,4,48,47,1,0,1
202223,TO1E6M500I,SCUOLA PRIMARIA,3,24,24,0,0,0
202223,RMPS49500G,SCUOLA SECONDARIA II GRADO,3,29,28,1,0,1
202223,FI1E026009,SCUOLA PRIMARIA,1,24,22,2,0,2
202223,TVPS57500F,SCUOLA SECONDARIA II GRADO,3,24,24,0,0,0
202223,BS1M013001,SCUOLA SECONDARIA I GRADO,3,62,60,2,2,0
202223,SS1E01300B,SCUOLA PRIMARIA,5,17,17,0,0,0
202223,VR1ESU500Z,SCUOLA PRIMARIA,4,19,19,0,0,0
202223,RM1E142007,SCUOLA PRIMARIA,1,44,43,1,1,0
202223,NATDPG500E,SCUOLA SECONDARIA II GRADO,1,4,4,0,0,0
202223,NA1E234006,SCUOLA PRIMARIA,2,20,20,0,0,0
202223,MIPC09500C,SCUOLA SECONDARIA II GRADO,4,46,46,0,0,0
202223,RM1E13800G,SCUOLA PRIMARIA,5,53,52,1,0,1
202223,MIPLMC5009,SCUOLA SECONDARIA II GRADO,5,4,3,1,1,0
202223,CT1E053006,SCUOLA PRIMARIA,3,13,13,0,0,0
202223,TVPSN55005,SCUOLA SECONDARIA II GRADO,4,17,17,0,0,0
202223,RMPS25500B,SCUOLA SECONDARIA II GRADO,2,17,17,0,0,0
202223,RMPS03500C,SCUOLA SECONDARIA II GRADO,1,33,31,2,0,2
202223,TO1E01300T,SCUOLA PRIMARIA,4,54,50,4,2,2
202223,LI1E00400D,SCUOLA PRIMARIA,5,25,23,2,0,2
202223,PVPS01500C,SCUOLA SECONDARIA II GRADO,5,21,21,0,0,0
202223,PVTBDH500G,SCUOLA SECONDARIA II GRADO,2,3,2,1,0,1
202223,AP1MUM500N,SCUOLA SECONDARIA I GRADO,1,23,19,4,0,4
202223,MI1EAE500E,SCUOLA PRIMARIA,5,15,15,0,0,0
202223,RN1E00800R,SCUOLA PRIMARIA,5,88,85,3,2,1
202223,BO1E01700C,SCUOLA PRIMARIA,5,38,37,1,0,1
202223,PEPS995008,SCUOLA SECONDARIA II GRADO,1,1,1,0,0,0
202223,ME1E01700T,SCUOLA PRIMARIA,4,22,22,0,0,0
202223,RMPC545008,SCUOLA SECONDARIA II GRADO,2,4,4,0,0,0
202223,COPSNU500Z,SCUOLA SECONDARIA II GRADO,1,4,3,1,0,1
202223,RM1E16000R,SCUOLA PRIMARIA,1,12,12,0,0,0
202223,MIPC16500D,SCUOLA SECONDARIA II GRADO,4,16,16,0,0,0
202223,VRPSEM5005,SCUOLA SECONDARIA II GRADO,5,4,4,0,0,0
202223,PCPS01500A,SCUOLA SECONDARIA II GRADO,5,12,12,0,0,0
202223,PA1E014004,SCUOLA PRIMARIA,4,65,65,0,0,0
202223,CT1E038004,SCUOLA PRIMARIA,2,13,11,2,0,2
202223,PV1M004002,SCUOLA SECONDARIA I GRADO,3,23,20,3,3,0
202223,NATD21500T,SCUOLA SECONDARIA II GRADO,5,65,61,4,1,3
202223,MI1E12600R,SCUOLA PRIMARIA,4,67,64,3,1,2
202223,SARHV4500U,SCUOLA SECONDARIA II GRADO,3,99,98,1,1,0
202223,RGPS98500R,SCUOLA SECONDARIA II GRADO,5,7,7,0,0,0
202223,VT1EM9500Q,SCUOLA PRIMARIA,1,12,12,0,0,0
202223,FI1E00700X,SCUOLA PRIMARIA,2,16,15,1,0,1
202223,CO1M02400N,SCUOLA SECONDARIA I GRADO,1,54,53,1,0,1
202223,RMPL26500R,SCUOLA SECONDARIA II GRADO,2,21,21,0,0,0
202223,RMTD78500B,SCUOLA SECONDARIA II GRADO,4,4,4,0,0,0
202223,MIPS175007,SCUOLA SECONDARIA II GRADO,5,34,34,0,0,0
202223,RCTDO0500U,SCUOLA SECONDARIA II GRADO,4,3,3,0,0,0
202223,MIPS74500L,SCUOLA SECONDARIA II GRADO,2,14,13,1,0,1
202223,TO1E01500D,SCUOLA PRIMARIA,2,18,16,2,2,0
202223,RMTB04500X,SCUOLA SECONDARIA II GRADO,1,16,14,2,1,1
202223,MBPL20500D,SCUOLA SECONDARIA II GRADO,3,38,35,3,0,3
202223,BG1E01100G,SCUOLA PRIMARIA,2,15,14,1,0,1
202223,MOPS01500X,SCUOLA SECONDARIA II GRADO,3,9,9,0,0,0
202223,SR1E009008,SCUOLA PRIMARIA,5,12,12,0,0,0
202223,RE1M00100B,SCUOLA SECONDARIA I GRADO,2,22,22,0,0,0
202223,FOPS5G500N,SCUOLA SECONDARIA II GRADO,2,31,30,1,1,0
202223,PAPS3Q5009,SCUOLA SECONDARIA II GRADO,2,35,35,0,0,0
202223,NARF6T500Q,SCUOLA SECONDARIA II GRADO,3,9,9,0,0,0
202223,NARHTO500T,SCUOLA SECONDARIA II GRADO,2,2,2,0,0,0
202223,BSPM57500D,SCUOLA SECONDARIA II GRADO,4,44,44,0,0,0
202223,RM1E056008,SCUOLA PRIMARIA,3,14,14,0,0,0
202223,PAPC695004,SCUOLA SECONDARIA II GRADO,3,6,6,0,0,0
202223,MIPL15500R,SCUOLA SECONDARIA II GRADO,1,27,26,1,0,1
202223,VASLQ8500T,SCUOLA SECONDARIA II GRADO,2,22,21,1,0,1
202223,NA1E09200C,SCUOLA PRIMARIA,5,30,30,0,0,0
202223,RM1M15000B,SCUOLA SECONDARIA I GRADO,1,21,21,0,0,0
202223,CR1E00800N,SCUOLA PRIMARIA,4,16,13,3,0,3
202223,BATD01500V,SCUOLA SECONDARIA II GRADO,3,16,15,1,0,1
202223,BG1E01100G,SCUOLA PRIMARIA,5,18,18,0,0,0
202223,TO1E03700A,SCUOLA PRIMARIA,2,50,48,2,0,2
202223,RM1E08300L,SCUOLA PRIMARIA,4,39,37,2,0,2
202223,VA1E4D500Q,SCUOLA PRIMARIA,4,34,31,3,0,3
202223,GRPC64500E,SCUOLA SECONDARIA II GRADO,3,10,10,0,0,0
202223,RM1E5U5009,SCUOLA PRIMARIA,3,8,8,0,0,0
202223,CT1EG5500S,SCUOLA PRIMARIA,5,13,13,0,0,0
202223,TOPL20500L,SCUOLA SECONDARIA II GRADO,5,24,23,1,0,1
202223,RMPSRQ500V,SCUOLA SECONDARIA II GRADO,4,27,26,1,0,1
202223,MIPLRL500B,SCUOLA SECONDARIA II GRADO,5,29,29,0,0,0
202223,PD1E00300D,SCUOLA PRIMARIA,2,24,22,2,1,1
202223,MBPSTE500O,SCUOLA SECONDARIA II GRADO,5,20,20,0,0,0
202223,MBTD37500N,SCUOLA SECONDARIA II GRADO,5,29,28,1,0,1
202223,RMPC10500A,SCUOLA SECONDARIA II GRADO,1,23,23,0,0,0
202223,RM1M03800X,SCUOLA SECONDARIA I GRADO,2,8,7,1,0,1
202223,MI1M050002,SCUOLA SECONDARIA I GRADO,1,14,13,1,0,1
202223,TV1E01500T,SCUOLA PRIMARIA,1,31,30,1,1,0
202223,NAPMS6500L,SCUOLA SECONDARIA II GRADO,1,10,10,0,0,0
202223,VI1M01200V,SCUOLA SECONDARIA I GRADO,2,43,43,0,0,0
202223,CZ1E002002,SCUOLA PRIMARIA,2,18,16,2,0,2
202223,PA1EAT500P,SCUOLA PRIMARIA,1,50,46,4,0,4
202223,NA1E13100T,SCUOLA PRIMARIA,1,11,10,1,0,1
202223,VT1E00300T,SCUOLA PRIMARIA,3,20,20,0,0,0
202223,PATDAH500E,SCUOLA SECONDARIA II GRADO,4,3,3,0,0,0
202223,VRPC025006,SCUOLA SECONDARIA II GRADO,1,1,1,0,0,0
202223,BG1E028001,SCUOLA PRIMARIA,5,26,25,1,1,0
202223,CETL04500C,SCUOLA SECONDARIA II GRADO,1,3,3,0,0,0
202223,TEPS335003,SCUOLA SECONDARIA II GRADO,2,3,3,0,0,0
202223,CSPM025005,SCUOLA SECONDARIA II GRADO,4,5,5,0,0,0
202223,CSPQ025009,SCUOLA SECONDARIA II GRADO,4,8,8,0,0,0
202223,GE1E01600G,SCUOLA PRIMARIA,2,24,21,3,1,2
202223,RG1E004008,SCUOLA PRIMARIA,1,10,10,0,0,0
202223,MISL025006,SCUOLA SECONDARIA II GRADO,3,51,51,0,0,0
202223,RNPM015006,SCUOLA SECONDARIA II GRADO,2,45,28,17,1,16
202223,CTPL00500R,SCUOLA SECONDARIA II GRADO,5,10,10,0,0,0
202223,TO1EPI500H,SCUOLA PRIMARIA,3,17,16,1,0,1
202223,RMPLNG500S,SCUOLA SECONDARIA II GRADO,3,6,5,1,0,1
202223,PATD43500N,SCUOLA SECONDARIA II GRADO,4,2,2,0,0,0
202223,NA1E136001,SCUOLA PRIMARIA,5,16,15,1,0,1
202223,VRRI01500X,SCUOLA SECONDARIA II GRADO,3,9,8,1,1,0
202223,MI1E06400P,SCUOLA PRIMARIA,4,12,11,1,1,0
202223,RM1E19500Q,SCUOLA PRIMARIA,5,36,27,9,1,8
202223,RM1E022005,SCUOLA PRIMARIA,5,16,14,2,0,2
202223,VI1E001007,SCUOLA PRIMARIA,1,38,31,7,0,7
202223,VE1M01200G,SCUOLA SECONDARIA I GRADO,3,22,22,0,0,0
202223,SRRHFP500H,SCUOLA SECONDARIA II GRADO,3,6,6,0,0,0
202223,SARHZG500U,SCUOLA SECONDARIA II GRADO,3,15,15,0,0,0
202223,CS1M00100G,SCUOLA SECONDARIA I GRADO,1,19,19,0,0,0
202223,NO1M001009,SCUOLA SECONDARIA I GRADO,2,76,73,3,0,3
202223,AL1M00700V,SCUOLA SECONDARIA I GRADO,2,35,35,0,0,0
202223,TV1E01600N,SCUOLA PRIMARIA,4,46,40,6,3,3
202223,GE1E026006,SCUOLA PRIMARIA,5,23,22,1,1,0
202223,BOTB02500D,SCUOLA SECONDARIA II GRADO,2,13,11,2,0,2
202223,NARFV15001,SCUOLA SECONDARIA II GRADO,3,7,7,0,0,0
202223,BG1M01300C,SCUOLA SECONDARIA I GRADO,2,159,157,2,0,2
202223,CTPL075003,SCUOLA SECONDARIA II GRADO,5,14,14,0,0,0
202223,RM1E10800Q,SCUOLA PRIMARIA,2,29,26,3,2,1
202223,NATD5N500Q,SCUOLA SECONDARIA II GRADO,4,3,3,0,0,0
202223,APTDCF500V,SCUOLA SECONDARIA II GRADO,3,2,1,1,1,0
202223,NA1E127006,SCUOLA PRIMARIA,1,53,53,0,0,0
202223,CE1EO0500I,SCUOLA PRIMARIA,5,25,24,1,0,1
202223,MI1E059007,SCUOLA PRIMARIA,2,42,38,4,0,4
202223,NA1E221004,SCUOLA PRIMARIA,1,10,7,3,0,3
202223,RM1M087005,SCUOLA SECONDARIA I GRADO,1,18,15,3,1,2
202223,BA1E018009,SCUOLA PRIMARIA,1,51,50,1,0,1
202223,BSSLVV500P,SCUOLA SECONDARIA II GRADO,4,14,13,1,1,0
202223,RM1E015002,SCUOLA PRIMARIA,1,48,40,8,1,7
202223,CA1E01000G,SCUOLA PRIMARIA,1,18,18,0,0,0
202223,RM1E049005,SCUOLA PRIMARIA,5,34,34,0,0,0
202223,AGTD00500C,SCUOLA SECONDARIA II GRADO,5,54,52,2,1,1
202223,MERHF3500O,SCUOLA SECONDARIA II GRADO,3,4,4,0,0,0
202223,SATDD75001,SCUOLA SECONDARIA II GRADO,2,4,4,0,0,0
202223,LC1E00700C,SCUOLA PRIMARIA,1,18,18,0,0,0
202223,PRPSAV500N,SCUOLA SECONDARIA II GRADO,3,17,17,0,0,0
202223,BG1M022007,SCUOLA SECONDARIA I GRADO,3,64,64,0,0,0
202223,NA1E24500L,SCUOLA PRIMARIA,1,17,17,0,0,0
202223,RC1E01000Q,SCUOLA PRIMARIA,3,18,18,0,0,0
202223,NA1E121007,SCUOLA PRIMARIA,3,14,14,0,0,0
202223,NAPS3S500N,SCUOLA SECONDARIA II GRADO,2,7,7,0,0,0
202223,CEPL00500E,SCUOLA SECONDARIA II GRADO,3,9,9,0,0,0
202223,RM1MTI500F,SCUOLA SECONDARIA I GRADO,2,23,14,9,0,9
202223,TVTD02500D,SCUOLA SECONDARIA II GRADO,1,28,26,2,0,2
202223,NATFUA500M,SCUOLA SECONDARIA II GRADO,2,4,4,0,0,0
202223,NATL25500P,SCUOLA SECONDARIA II GRADO,2,14,14,0,0,0
202223,CA1E00200L,SCUOLA PRIMARIA,1,15,15,0,0,0
202223,NA1E18200P,SCUOLA PRIMARIA,5,48,48,0,0,0
202223,RN1E00900L,SCUOLA PRIMARIA,5,20,16,4,2,2
202223,PE1E00600G,SCUOLA PRIMARIA,5,16,16,0,0,0
202223,CE1E052004,SCUOLA PRIMARIA,1,36,35,1,0,1
202223,PEPMPL500U,SCUOLA SECONDARIA II GRADO,1,41,38,3,0,3
202223,ME1E01300E,SCUOLA PRIMARIA,4,8,8,0,0,0
202223,MIRF6M5002,SCUOLA SECONDARIA II GRADO,5,10,5,5,0,5
202223,BGTB015001,SCUOLA SECONDARIA II GRADO,4,55,47,8,3,5
202223,VAPS2O5006,SCUOLA SECONDARIA II GRADO,1,5,5,0,0,0
202223,SSTD02500P,SCUOLA SECONDARIA II GRADO,2,2,2,0,0,0
202223,TO1M004008,SCUOLA SECONDARIA I GRADO,2,64,62,2,0,2
202223,VATFGA500N,SCUOLA SECONDARIA II GRADO,1,3,1,2,0,2
202223,PRPM015008,SCUOLA SECONDARIA II GRADO,5,14,14,0,0,0
202223,TVPM4Q500B,SCUOLA SECONDARIA II GRADO,3,10,10,0,0,0
202223,MI1E12000T,SCUOLA PRIMARIA,1,16,16,0,0,0
202223,BGTFUM500Z,SCUOLA SECONDARIA II GRADO,5,13,13,0,0,0
202223,NA1E15300P,SCUOLA PRIMARIA,3,9,8,1,0,1
202223,PA1E01800B,SCUOLA PRIMARIA,4,22,22,0,0,0
202223,MIPSOC500H,SCUOLA SECONDARIA II GRADO,2,11,7,4,0,4
202223,MBPS365007,SCUOLA SECONDARIA II GRADO,4,16,16,0,0,0
202223,AP1E00100X,SCUOLA PRIMARIA,1,15,14,1,1,0
202223,RM1E17300V,SCUOLA PRIMARIA,3,16,15,1,0,1
202223,PNPS03500L,SCUOLA SECONDARIA II GRADO,5,9,7,2,0,2
202223,LC1M040009,SCUOLA SECONDARIA I GRADO,3,52,52,0,0,0
202223,MI1E02200L,SCUOLA PRIMARIA,2,20,20,0,0,0
202223,FIPL06500X,SCUOLA SECONDARIA II GRADO,2,9,9,0,0,0
202223,BSPS08500V,SCUOLA SECONDARIA II GRADO,2,24,24,0,0,0
202223,VE1M00400L,SCUOLA SECONDARIA I GRADO,2,26,26,0,0,0
202223,CB1E002007,SCUOLA PRIMARIA,2,15,14,1,1,0
202223,BRTD04500A,SCUOLA SECONDARIA II GRADO,2,1,1,0,0,0
202223,BS1E00700C,SCUOLA PRIMARIA,5,25,25,0,0,0
202223,CRPS02500L,SCUOLA SECONDARIA II GRADO,4,17,14,3,0,3
202223,LISL00500B,SCUOLA SECONDARIA II GRADO,3,10,10,0,0,0
202223,AGTD685001,SCUOLA SECONDARIA II GRADO,4,3,3,0,0,0
202223,TO1E02700Q,SCUOLA PRIMARIA,3,48,38,10,2,8
202223,FI1M01100R,SCUOLA SECONDARIA I GRADO,3,26,17,9,0,9
202223,RM1EVQ500H,SCUOLA PRIMARIA,3,20,20,0,0,0
202223,CTRHMM500U,SCUOLA SECONDARIA II GRADO,5,48,48,0,0,0
202223,VE1E01200A,SCUOLA PRIMARIA,3,13,13,0,0,0
202223,RM1E06200G,SCUOLA PRIMARIA,2,14,13,1,0,1
202223,BGPL16500Q,SCUOLA SECONDARIA II GRADO,2,27,26,1,0,1
202223,VR1M00800G,SCUOLA SECONDARIA I GRADO,1,60,56,4,1,3
202223,RMPMDD500Q,SCUOLA SECONDARIA II GRADO,3,12,12,0,0,0
202223,UD1M00700C,SCUOLA SECONDARIA I GRADO,1,40,38,2,0,2
202223,FG1E01300E,SCUOLA PRIMARIA,3,11,11,0,0,0
202223,MI1E025004,SCUOLA PRIMARIA,3,41,40,1,0,1
202223,RMTD55500T,SCUOLA SECONDARIA II GRADO,2,3,3,0,0,0
202223,RMPS72500B,SCUOLA SECONDARIA II GRADO,3,10,6,4,3,1
202223,RA1M00400C,SCUOLA SECONDARIA I GRADO,1,45,41,4,1,3
202223,RM1E036003,SCUOLA PRIMARIA,3,37,37,0,0,0
202223,BO1E01500R,SCUOLA PRIMARIA,3,32,31,1,0,1
202223,BORI03500C,SCUOLA SECONDARIA II GRADO,2,27,26,1,1,0
202223,MERHFN500I,SCUOLA SECONDARIA II GRADO,3,4,4,0,0,0
202223,PA1E04000L,SCUOLA PRIMARIA,3,24,24,0,0,0
202223,COPSCP5007,SCUOLA SECONDARIA II GRADO,3,16,16,0,0,0
202223,NA1E23100P,SCUOLA PRIMARIA,3,11,11,0,0,0
202223,NATF215004,SCUOLA SECONDARIA II GRADO,1,10,10,0,0,0
202223,NA1E25200Q,SCUOLA PRIMARIA,4,15,15,0,0,0
202223,NA1E27900Q,SCUOLA PRIMARIA,1,13,13,0,0,0
202223,BLPM01500Q,SCUOLA SECONDARIA II GRADO,2,21,21,0,0,0
202223,FG1E02500R,SCUOLA PRIMARIA,5,23,22,1,0,1
202223,MS1E00500P,SCUOLA PRIMARIA,3,15,15,0,0,0
202223,RMPMQB5004,SCUOLA SECONDARIA II GRADO,3,22,21,1,0,1
202223,BA1E026008,SCUOLA PRIMARIA,3,22,22,0,0,0
202223,AP1E005007,SCUOLA PRIMARIA,5,22,20,2,0,2
202223,NA1E15900N,SCUOLA PRIMARIA,4,10,10,0,0,0
202223,MI1M041007,SCUOLA SECONDARIA I GRADO,1,179,173,6,1,5
202223,FRPS1T500V,SCUOLA SECONDARIA II GRADO,1,20,20,0,0,0
202223,VA1MIT5001,SCUOLA SECONDARIA I GRADO,3,32,32,0,0,0
202223,FO1E00400N,SCUOLA PRIMARIA,3,50,48,2,1,1
202223,BSPSL9500N,SCUOLA SECONDARIA II GRADO,2,18,18,0,0,0
202223,VATFE2500M,SCUOLA SECONDARIA II GRADO,1,19,19,0,0,0
202223,FI1E021006,SCUOLA PRIMARIA,5,15,15,0,0,0
202223,SATFIF5007,SCUOLA SECONDARIA II GRADO,3,3,3,0,0,0
202223,RM1E15400D,SCUOLA PRIMARIA,1,10,8,2,2,0
202223,GEPL01500Q,SCUOLA SECONDARIA II GRADO,5,139,134,5,0,5
202223,RMPS235006,SCUOLA SECONDARIA II GRADO,1,18,18,0,0,0
202223,PI1E00100Q,SCUOLA PRIMARIA,1,37,34,3,2,1
202223,SARHDF500N,SCUOLA SECONDARIA II GRADO,3,13,13,0,0,0
202223,RM1E07400T,SCUOLA PRIMARIA,4,9,6,3,0,3
202223,PAPMUP500I,SCUOLA SECONDARIA II GRADO,4,7,7,0,0,0
202223,TS1E008001,SCUOLA PRIMARIA,4,19,18,1,0,1
202223,CERIN35009,SCUOLA SECONDARIA II GRADO,2,7,7,0,0,0
202223,RM1E01100P,SCUOLA PRIMARIA,1,20,18,2,0,2
202223,LU1ETH500S,SCUOLA PRIMARIA,3,7,5,2,0,2
202223,NA1EPH500O,SCUOLA PRIMARIA,2,20,20,0,0,0
202223,NA1M03500D,SCUOLA SECONDARIA I GRADO,1,13,13,0,0,0
202223,NA1MPT5003,SCUOLA SECONDARIA I GRADO,1,18,16,2,0,2
202223,VC1E00200E,SCUOLA PRIMARIA,2,25,25,0,0,0
202223,BG1E00400C,SCUOLA PRIMARIA,5,30,27,3,0,3
202223,VEPC02500E,SCUOLA SECONDARIA II GRADO,1,12,10,2,0,2
202223,RE1E002002,SCUOLA PRIMARIA,2,51,45,6,1,5
202223,TO1E02100R,SCUOLA PRIMARIA,3,50,50,0,0,0
202223,MIPMU4500Z,SCUOLA SECONDARIA II GRADO,2,21,21,0,0,0
202223,BOPS525001,SCUOLA SECONDARIA II GRADO,5,25,24,1,1,0
202223,RM1E06900A,SCUOLA PRIMARIA,5,14,14,0,0,0
202223,LTPM02500Q,SCUOLA SECONDARIA II GRADO,1,10,10,0,0,0
202223,CETAVH500S,SCUOLA SECONDARIA II GRADO,1,3,3,0,0,0
202223,RM1E212008,SCUOLA PRIMARIA,2,91,79,12,1,11
202223,PA1MB95007,SCUOLA SECONDARIA I GRADO,3,73,72,1,0,1
202223,TOPM085002,SCUOLA SECONDARIA II GRADO,1,18,18,0,0,0
202223,CE1E00600A,SCUOLA PRIMARIA,3,13,13,0,0,0
202223,MI1E054004,SCUOLA PRIMARIA,4,12,11,1,0,1
202223,CS1E00600D,SCUOLA PRIMARIA,5,20,20,0,0,0
202223,RM1E09600P,SCUOLA PRIMARIA,1,47,46,1,0,1
202223,BOPM8F500M,SCUOLA SECONDARIA II GRADO,5,11,11,0,0,0
202223,CTTFOR5002,SCUOLA SECONDARIA II GRADO,2,1,1,0,0,0
202223,CE1E030007,SCUOLA PRIMARIA,4,20,19,1,1,0
202223,LT1E01000Q,SCUOLA PRIMARIA,3,11,11,0,0,0
202223,PAPC14500P,SCUOLA SECONDARIA II GRADO,2,4,4,0,0,0
202223,AVTF005001,SCUOLA SECONDARIA II GRADO,3,5,5,0,0,0
202223,TOPMP2500E,SCUOLA SECONDARIA II GRADO,2,11,10,1,1,0
202223,COTL045001,SCUOLA SECONDARIA II GRADO,1,6,6,0,0,0
202223,TOPLM6500B,SCUOLA SECONDARIA II GRADO,4,7,7,0,0,0
202223,BGTF1A500N,SCUOLA SECONDARIA II GRADO,3,8,7,1,0,1
202223,RM1E114003,SCUOLA PRIMARIA,4,25,25,0,0,0
202223,NA1E11100L,SCUOLA PRIMARIA,5,15,15,0,0,0
202223,BG1E02400N,SCUOLA PRIMARIA,5,21,21,0,0,0
202223,BNRHZS500C,SCUOLA SECONDARIA II GRADO,4,8,7,1,0,1
202223,CEPSSR500Q,SCUOLA SECONDARIA II GRADO,3,9,9,0,0,0
202223,NA1E09000R,SCUOLA PRIMARIA,5,32,32,0,0,0
202223,MNPS00500L,SCUOLA SECONDARIA II GRADO,5,20,20,0,0,0
202223,PVPM025004,SCUOLA SECONDARIA II GRADO,1,13,12,1,0,1
202223,PVPSTA500Q,SCUOLA SECONDARIA II GRADO,3,9,9,0,0,0
202223,TPSD015003,SCUOLA SECONDARIA II GRADO,3,54,54,0,0,0
202223,MI1EES500O,SCUOLA PRIMARIA,3,10,10,0,0,0
202223,LE1E009009,SCUOLA PRIMARIA,1,5,5,0,0,0
202223,CE1E03200V,SCUOLA PRIMARIA,5,22,17,5,1,4
202223,BS1E02100P,SCUOLA PRIMARIA,3,32,29,3,1,2
202223,BS1M00800D,SCUOLA SECONDARIA I GRADO,2,26,25,1,0,1
202223,VRTF005006,SCUOLA SECONDARIA II GRADO,3,235,228,7,2,5
202223,MI1E09300P,SCUOLA PRIMARIA,5,15,15,0,0,0
202223,NAPS555009,SCUOLA SECONDARIA II GRADO,4,4,4,0,0,0
202223,MI1E02700Q,SCUOLA PRIMARIA,5,19,19,0,0,0
202223,TVRA3C5009,SCUOLA SECONDARIA II GRADO,2,25,25,0,0,0
202223,NATABS5008,SCUOLA SECONDARIA II GRADO,4,6,5,1,0,1
202223,RM1E177006,SCUOLA PRIMARIA,5,17,16,1,0,1
202223,RM1E16500X,SCUOLA PRIMARIA,5,21,21,0,0,0
202223,SATABS5008,SCUOLA SECONDARIA II GRADO,2,8,8,0,0,0
202223,VTPS0F500B,SCUOLA SECONDARIA II GRADO,4,8,8,0,0,0
202223,TV1E018009,SCUOLA PRIMARIA,5,26,26,0,0,0
202223,TV1E005007,SCUOLA PRIMARIA,4,20,19,1,0,1
202223,PAPS3Q5009,SCUOLA SECONDARIA II GRADO,3,35,34,1,1,0
202223,PATD26500Q,SCUOLA SECONDARIA II GRADO,2,7,7,0,0,0
202223,CE1E029003,SCUOLA PRIMARIA,1,8,8,0,0,0
202223,LTTDPM500P,SCUOLA SECONDARIA II GRADO,1,4,3,1,1,0
202223,CETD15500D,SCUOLA SECONDARIA II GRADO,5,40,38,2,1,1
202223,CETF36500S,SCUOLA SECONDARIA II GRADO,5,76,75,1,1,0
202223,GE1M01700L,SCUOLA SECONDARIA I GRADO,3,45,41,4,0,4
202223,RMPL48500Q,SCUOLA SECONDARIA II GRADO,1,4,0,4,1,3
202223,MB1M026002,SCUOLA SECONDARIA I GRADO,1,48,46,2,0,2
202223,RMSLR1500M,SCUOLA SECONDARIA II GRADO,5,29,25,4,1,3
202223,NARI11500A,SCUOLA SECONDARIA II GRADO,2,8,8,0,0,0
202223,PI1E00300B,SCUOLA PRIMARIA,3,18,17,1,0,1
202223,RM1E044002,SCUOLA PRIMARIA,5,39,39,0,0,0
202223,RNRCCE500C,SCUOLA SECONDARIA II GRADO,4,27,19,8,0,8
202223,VR1M013003,SCUOLA SECONDARIA I GRADO,1,69,67,2,1,1
202223,PD1M00800T,SCUOLA SECONDARIA I GRADO,2,63,57,6,0,6
202223,RMPM5R5008,SCUOLA SECONDARIA II GRADO,2,10,9,1,0,1
202223,NA1E28200G,SCUOLA PRIMARIA,2,11,10,1,0,1
202223,NA1E09700G,SCUOLA PRIMARIA,2,45,45,0,0,0
202223,RC1E995002,SCUOLA PRIMARIA,5,2,0,2,0,2
202223,RM1M128006,SCUOLA SECONDARIA I GRADO,3,73,73,0,0,0
202223,CR1E00300E,SCUOLA PRIMARIA,2,32,27,5,1,4
202223,SAPS005004,SCUOLA SECONDARIA II GRADO,4,5,5,0,0,0
202223,BG1E001001,SCUOLA PRIMARIA,5,47,46,1,0,1
202223,CA1E01500P,SCUOLA PRIMARIA,5,21,21,0,0,0
202223,MB1E040003,SCUOLA PRIMARIA,1,11,11,0,0,0
202223,PEPC025003,SCUOLA SECONDARIA II GRADO,4,1,1,0,0,0
202223,GE1E00800L,SCUOLA PRIMARIA,3,13,11,2,1,1
202223,AL1E6U500H,SCUOLA PRIMARIA,2,11,11,0,0,0
202223,FI1E063008,SCUOLA PRIMARIA,4,12,10,2,0,2
202223,BGSD01500E,SCUOLA SECONDARIA II GRADO,4,35,35,0,0,0
202223,SSPS02500V,SCUOLA SECONDARIA II GRADO,3,8,8,0,0,0
202223,RMPC33500X,SCUOLA SECONDARIA II GRADO,5,10,10,0,0,0
202223,BG1M00900R,SCUOLA SECONDARIA I GRADO,2,48,48,0,0,0
202223,COPSUC5004,SCUOLA SECONDARIA II GRADO,4,26,26,0,0,0
202223,NA1E03700X,SCUOLA PRIMARIA,1,37,34,3,0,3
202223,VR1E020001,SCUOLA PRIMARIA,1,48,37,11,3,8
202223,CO1M01100G,SCUOLA SECONDARIA I GRADO,3,34,34,0,0,0
202223,RMPM9A500G,SCUOLA SECONDARIA II GRADO,3,22,22,0,0,0
202223,MIPL30500D,SCUOLA SECONDARIA II GRADO,2,26,23,3,0,3
202223,RM1M07800A,SCUOLA SECONDARIA I GRADO,2,46,45,1,1,0
202223,CA1E01100B,SCUOLA PRIMARIA,2,32,31,1,0,1
202223,MI1M03100L,SCUOLA SECONDARIA I GRADO,2,64,64,0,0,0
202223,PDPS065002,SCUOLA SECONDARIA II GRADO,3,50,48,2,0,2
202223,NAPMGU500T,SCUOLA SECONDARIA II GRADO,2,14,14,0,0,0
202223,PEPS005001,SCUOLA SECONDARIA II GRADO,3,35,35,0,0,0
202223,VI1M00700B,SCUOLA SECONDARIA I GRADO,3,26,24,2,1,1
202223,BSRF06500X,SCUOLA SECONDARIA II GRADO,1,21,20,1,0,1
202223,VAPM04500D,SCUOLA SECONDARIA II GRADO,2,30,30,0,0,0
202223,BSPM6Z500C,SCUOLA SECONDARIA II GRADO,5,12,12,0,0,0
202223,NATF7H500T,SCUOLA SECONDARIA II GRADO,5,166,158,8,2,6
202223,RM1E11600P,SCUOLA PRIMARIA,2,17,12,5,1,4
202223,VRTD04500A,SCUOLA SECONDARIA II GRADO,2,18,18,0,0,0
202223,VRPLHM500A,SCUOLA SECONDARIA II GRADO,2,26,26,0,0,0
202223,MIPS8E5005,SCUOLA SECONDARIA II GRADO,2,4,2,2,0,2
202223,MOPS02500E,SCUOLA SECONDARIA II GRADO,3,25,25,0,0,0
202223,MBPS0G5007,SCUOLA SECONDARIA II GRADO,1,40,40,0,0,0
202223,BSTF8F5009,SCUOLA SECONDARIA II GRADO,2,5,5,0,0,0
202223,TO1E00500V,SCUOLA PRIMARIA,5,22,15,7,4,3
202223,RG1E00700Q,SCUOLA PRIMARIA,1,11,11,0,0,0
202223,CETAVH500S,SCUOLA SECONDARIA II GRADO,3,7,7,0,0,0
202223,MIRC1N500Z,SCUOLA SECONDARIA II GRADO,3,4,4,0,0,0
202223,BS1E0E500A,SCUOLA PRIMARIA,4,13,12,1,0,1
202223,TO1M01400V,SCUOLA SECONDARIA I GRADO,3,9,8,1,1,0
202223,PR1E01000V,SCUOLA PRIMARIA,2,43,39,4,2,2
202223,FIPSZD500T,SCUOLA SECONDARIA II GRADO,3,9,8,1,0,1
202223,CT1E00600L,SCUOLA PRIMARIA,3,11,9,2,0,2
202223,MIPSEA5006,SCUOLA SECONDARIA II GRADO,3,14,14,0,0,0
202223,MB1EP85003,SCUOLA PRIMARIA,1,23,23,0,0,0
202223,RMTD43500Q,SCUOLA SECONDARIA II GRADO,3,5,5,0,0,0
202223,MBPS28500G,SCUOLA SECONDARIA II GRADO,3,6,6,0,0,0
202223,CA1M4N500E,SCUOLA SECONDARIA I GRADO,1,11,11,0,0,0
202223,RM1E051005,SCUOLA PRIMARIA,1,18,17,1,0,1
202223,RE1E006009,SCUOLA PRIMARIA,5,20,19,1,1,0
202223,MI1E01500D,SCUOLA PRIMARIA,4,38,36,2,0,2
202223,AGTA6O500F,SCUOLA SECONDARIA II GRADO,3,6,6,0,0,0
202223,CS1M00100G,SCUOLA SECONDARIA I GRADO,3,11,11,0,0,0
202223,BOPSPI500D,SCUOLA SECONDARIA II GRADO,2,30,29,1,1,0
202223,VA1E01400G,SCUOLA PRIMARIA,3,8,8,0,0,0
202223,SA1E009006,SCUOLA PRIMARIA,3,12,12,0,0,0
202223,NARH02500L,SCUOLA SECONDARIA II GRADO,1,10,10,0,0,0
202223,CT1M011009,SCUOLA SECONDARIA I GRADO,1,44,21,23,0,23
202223,BG1M00500D,SCUOLA SECONDARIA I GRADO,2,20,19,1,0,1
202223,BGPMS4500R,SCUOLA SECONDARIA II GRADO,4,8,8,0,0,0
202223,NA1E05500D,SCUOLA PRIMARIA,2,46,46,0,0,0
202223,NA1E24500L,SCUOLA PRIMARIA,2,22,22,0,0,0
202223,GE1M015001,SCUOLA SECONDARIA I GRADO,1,30,30,0,0,0
202223,NATDE6500C,SCUOLA SECONDARIA II GRADO,2,3,3,0,0,0
202223,CN1M00400Q,SCUOLA SECONDARIA I GRADO,1,11,8,3,0,3
202223,MBRH00500P,SCUOLA SECONDARIA II GRADO,2,57,56,1,0,1
202223,CRPC035004,SCUOLA SECONDARIA II GRADO,3,8,8,0,0,0
202223,RMPSHQ500O,SCUOLA SECONDARIA II GRADO,1,20,20,0,0,0
202223,LIPL01500X,SCUOLA SECONDARIA II GRADO,2,3,3,0,0,0
202223,MOPC005006,SCUOLA SECONDARIA II GRADO,2,10,10,0,0,0
202223,APPSR5500N,SCUOLA SECONDARIA II GRADO,3,2,2,0,0,0
202223,TO1E05600Q,SCUOLA PRIMARIA,5,10,10,0,0,0
202223,RMPS555002,SCUOLA SECONDARIA II GRADO,3,27,27,0,0,0
202223,RMPS335003,SCUOLA SECONDARIA II GRADO,5,26,26,0,0,0
202223,RE1E00400N,SCUOLA PRIMARIA,4,18,18,0,0,0
202223,AGTD4Q5003,SCUOLA SECONDARIA II GRADO,2,6,6,0,0,0
202223,GE1E026006,SCUOLA PRIMARIA,2,10,10,0,0,0
202223,PV1E007008,SCUOLA PRIMARIA,1,16,14,2,0,2
202223,PG1E00500A,SCUOLA PRIMARIA,5,23,23,0,0,0
202223,VA1E010008,SCUOLA PRIMARIA,3,36,36,0,0,0
202223,METD065008,SCUOLA SECONDARIA II GRADO,5,24,24,0,0,0
202223,NA1E02000E,SCUOLA PRIMARIA,1,19,18,1,0,1
202223,NA1E239009,SCUOLA PRIMARIA,4,19,19,0,0,0
202223,CZ1EQB500O,SCUOLA PRIMARIA,5,18,17,1,0,1
202223,RMRH12500C,SCUOLA SECONDARIA II GRADO,2,14,13,1,0,1
202223,NATD51500C,SCUOLA SECONDARIA II GRADO,2,30,30,0,0,0
202223,MBTD37500N,SCUOLA SECONDARIA II GRADO,1,13,13,0,0,0
202223,MIPSOC500H,SCUOLA SECONDARIA II GRADO,3,4,3,1,1,0
202223,SAPS09500G,SCUOLA SECONDARIA II GRADO,1,10,6,4,1,3
202223,SAPL65500L,SCUOLA SECONDARIA II GRADO,2,6,5,1,0,1
202223,NA1E17400Q,SCUOLA PRIMARIA,5,9,9,0,0,0
202223,NA1E192009,SCUOLA PRIMARIA,1,10,9,1,0,1
202223,VR1E00700E,SCUOLA PRIMARIA,4,46,46,0,0,0
202223,VIPS01500A,SCUOLA SECONDARIA II GRADO,5,17,17,0,0,0
202223,TS1E00400N,SCUOLA PRIMARIA,5,15,15,0,0,0
202223,BSPS08500V,SCUOLA SECONDARIA II GRADO,3,24,21,3,0,3
202223,SSTD00500D,SCUOLA SECONDARIA II GRADO,1,5,5,0,0,0
202223,NATF9E5003,SCUOLA SECONDARIA II GRADO,4,3,3,0,0,0
202223,RM1E135004,SCUOLA PRIMARIA,2,14,13,1,0,1
202223,NA1E00400L,SCUOLA PRIMARIA,4,10,3,7,0,7
202223,RM1E16700G,SCUOLA PRIMARIA,5,29,29,0,0,0
202223,NAPMEF500M,SCUOLA SECONDARIA II GRADO,3,4,4,0,0,0
202223,FR1M00100E,SCUOLA SECONDARIA I GRADO,1,10,10,0,0,0
202223,RM1E001004,SCUOLA PRIMARIA,4,24,22,2,0,2
202223,ME1E00900V,SCUOLA PRIMARIA,2,10,6,4,0,4
202223,PATD00500A,SCUOLA SECONDARIA II GRADO,5,65,64,1,0,1
202223,NA1ED8500Q,SCUOLA PRIMARIA,5,10,10,0,0,0
202223,FITF265001,SCUOLA SECONDARIA II GRADO,4,9,5,4,0,4
202223,VB1E001004,SCUOLA PRIMARIA,3,10,9,1,0,1
202223,SATFPG500G,SCUOLA SECONDARIA II GRADO,1,7,7,0,0,0
202223,PC1E001007,SCUOLA PRIMARIA,1,17,16,1,1,0
202223,TVTF015005,SCUOLA SECONDARIA II GRADO,2,30,30,0,0,0
202223,NA1E21500R,SCUOLA PRIMARIA,2,17,17,0,0,0
202223,MO1M0B500E,SCUOLA SECONDARIA I GRADO,1,11,11,0,0,0
202223,VI1E00500E,SCUOLA PRIMARIA,1,40,40,0,0,0
202223,NA1E05900R,SCUOLA PRIMARIA,4,21,21,0,0,0
202223,TV1M007004,SCUOLA SECONDARIA I GRADO,3,82,79,3,2,1
202223,NA1E200003,SCUOLA PRIMARIA,1,10,9,1,0,1
202223,BORI03500C,SCUOLA SECONDARIA II GRADO,3,24,23,1,0,1
202223,RM1M010004,SCUOLA SECONDARIA I GRADO,2,28,27,1,1,0
202223,CTTD145005,SCUOLA SECONDARIA II GRADO,2,2,2,0,0,0
202223,RM1EGU500T,SCUOLA PRIMARIA,5,36,34,2,1,1
202223,CT1M01600C,SCUOLA SECONDARIA I GRADO,3,17,17,0,0,0
202223,LC1E002009,SCUOLA PRIMARIA,1,53,52,1,0,1
202223,VE1M001005,SCUOLA SECONDARIA I GRADO,2,27,25,2,0,2
202223,BGPC05500B,SCUOLA SECONDARIA II GRADO,1,18,17,1,0,1
202223,SATLGF500Z,SCUOLA SECONDARIA II GRADO,4,8,8,0,0,0
202223,PAPMB55005,SCUOLA SECONDARIA II GRADO,5,24,24,0,0,0
202223,CO1E013002,SCUOLA PRIMARIA,1,31,28,3,0,3
202223,TOPL03500P,SCUOLA SECONDARIA II GRADO,5,23,23,0,0,0
202223,TO1M05700R,SCUOLA SECONDARIA I GRADO,3,19,18,1,1,0
202223,AR1E00300R,SCUOLA PRIMARIA,1,8,7,1,1,0
202223,RCPC02500G,SCUOLA SECONDARIA II GRADO,3,9,9,0,0,0
202223,RM1M110001,SCUOLA SECONDARIA I GRADO,2,19,13,6,0,6
202223,NA1E219004,SCUOLA PRIMARIA,1,18,18,0,0,0
202223,MI1E074009,SCUOLA PRIMARIA,3,46,37,9,0,9
202223,TPTDS9500A,SCUOLA SECONDARIA II GRADO,4,1,1,0,0,0
202223,TORI05500A,SCUOLA SECONDARIA II GRADO,2,1,1,0,0,0
202223,RMPS54500B,SCUOLA SECONDARIA II GRADO,3,5,5,0,0,0
202223,MI1M041007,SCUOLA SECONDARIA I GRADO,2,179,174,5,1,4
202223,NAPSZI500L,SCUOLA SECONDARIA II GRADO,1,28,28,0,0,0
202223,SRPM475001,SCUOLA SECONDARIA II GRADO,1,7,7,0,0,0
202223,MIPM06500R,SCUOLA SECONDARIA II GRADO,3,12,12,0,0,0
202223,NA1E198008,SCUOLA PRIMARIA,5,11,11,0,0,0
202223,SATDP9500M,SCUOLA SECONDARIA II GRADO,2,7,7,0,0,0
202223,RM1ERP500L,SCUOLA PRIMARIA,1,17,17,0,0,0
202223,AG1E006007,SCUOLA PRIMARIA,5,26,26,0,0,0
202223,PAPC07500N,SCUOLA SECONDARIA II GRADO,2,6,6,0,0,0
202223,NATDGC5003,SCUOLA SECONDARIA II GRADO,1,8,8,0,0,0
202223,NATF215004,SCUOLA SECONDARIA II GRADO,3,14,14,0,0,0
202223,BL1E00100G,SCUOLA PRIMARIA,2,25,25,0,0,0
202223,RMRF00500V,SCUOLA SECONDARIA II GRADO,2,6,6,0,0,0
202223,FG1E00500G,SCUOLA PRIMARIA,1,25,25,0,0,0
202223,FG1E023005,SCUOLA PRIMARIA,1,12,12,0,0,0
202223,NATL175003,SCUOLA SECONDARIA II GRADO,3,3,3,0,0,0
202223,BA1E01100E,SCUOLA PRIMARIA,2,11,11,0,0,0
202223,CL1E003004,SCUOLA PRIMARIA,1,20,20,0,0,0
202223,CN1E00200V,SCUOLA PRIMARIA,2,17,17,0,0,0
202223,RA1E00300B,SCUOLA PRIMARIA,2,34,31,3,2,1
202223,TOTB005001,SCUOLA SECONDARIA II GRADO,2,9,8,1,1,0
202223,CE1E04700L,SCUOLA PRIMARIA,1,10,10,0,0,0
202223,FITD01500X,SCUOLA SECONDARIA II GRADO,2,8,6,2,0,2
202223,SATDST500C,SCUOLA SECONDARIA II GRADO,5,48,48,0,0,0
202223,TOPS04500E,SCUOLA SECONDARIA II GRADO,5,30,30,0,0,0
202223,RM1E11800A,SCUOLA PRIMARIA,3,26,24,2,1,1
202223,RMPSVA5006,SCUOLA SECONDARIA II GRADO,1,48,46,2,0,2
202223,NAPS045004,SCUOLA SECONDARIA II GRADO,2,21,20,1,0,1
202223,AV1E00500N,SCUOLA PRIMARIA,1,13,13,0,0,0
202223,PV1M008009,SCUOLA SECONDARIA I GRADO,1,51,51,0,0,0
202223,CLSD00500B,SCUOLA SECONDARIA II GRADO,3,30,29,1,1,0
202223,TV1EAE500L,SCUOLA PRIMARIA,4,23,23,0,0,0
202223,SARHTF500G,SCUOLA SECONDARIA II GRADO,3,4,4,0,0,0
202223,SARFTV500I,SCUOLA SECONDARIA II GRADO,4,3,3,0,0,0
202223,NAPLIA500F,SCUOLA SECONDARIA II GRADO,5,67,60,7,2,5
202223,CE1E04000T,SCUOLA PRIMARIA,3,34,30,4,0,4
202223,CE1E043009,SCUOLA PRIMARIA,5,28,28,0,0,0
202223,FRTD0N500M,SCUOLA SECONDARIA II GRADO,2,2,2,0,0,0
202223,RM1E00500B,SCUOLA PRIMARIA,5,25,25,0,0,0
202223,NA1M00600D,SCUOLA SECONDARIA I GRADO,3,23,23,0,0,0
202223,PR1E001004,SCUOLA PRIMARIA,5,44,44,0,0,0
202223,PR1E00800V,SCUOLA PRIMARIA,1,25,25,0,0,0
202223,FI1E001001,SCUOLA PRIMARIA,5,18,18,0,0,0
202223,VB1M02000P,SCUOLA SECONDARIA I GRADO,2,20,19,1,0,1
202223,FI1E014003,SCUOLA PRIMARIA,1,14,11,3,0,3
202223,BGPS00500D,SCUOLA SECONDARIA II GRADO,4,26,26,0,0,0
202223,NA1E13300D,SCUOLA PRIMARIA,1,19,19,0,0,0
202223,UDPLO3500Z,SCUOLA SECONDARIA II GRADO,5,16,15,1,1,0
202223,BG1E01700E,SCUOLA PRIMARIA,1,1,0,1,0,1
202223,LCPMEE500S,SCUOLA SECONDARIA II GRADO,5,26,26,0,0,0
202223,GE1E020007,SCUOLA PRIMARIA,2,25,25,0,0,0
202223,LT1E01000Q,SCUOLA PRIMARIA,4,15,13,2,0,2
202223,TO1M039007,SCUOLA SECONDARIA I GRADO,1,136,131,5,2,3
202223,RM1E200002,SCUOLA PRIMARIA,2,5,5,0,0,0
202223,CE1E00900T,SCUOLA PRIMARIA,1,21,21,0,0,0
202223,RMPM08500E,SCUOLA SECONDARIA II GRADO,4,24,24,0,0,0
202223,MI1E08400X,SCUOLA PRIMARIA,1,25,23,2,1,1
202223,SAPMBS5006,SCUOLA SECONDARIA II GRADO,5,70,69,1,0,1
202223,NO1E00200X,SCUOLA PRIMARIA,2,45,43,2,0,2
202223,LOPS01500A,SCUOLA SECONDARIA II GRADO,1,10,10,0,0,0
202223,TPTD80500R,SCUOLA SECONDARIA II GRADO,4,6,6,0,0,0
202223,PGRF8G5009,SCUOLA SECONDARIA II GRADO,4,1,1,0,0,0
202223,TOPS955001,SCUOLA SECONDARIA II GRADO,1,4,4,0,0,0
202223,TO1E053008,SCUOLA PRIMARIA,1,26,25,1,0,1
202223,MB1E058008,SCUOLA PRIMARIA,1,28,28,0,0,0
202223,NOPC05500E,SCUOLA SECONDARIA II GRADO,5,52,52,0,0,0
202223,FI1M01600X,SCUOLA SECONDARIA I GRADO,1,46,43,3,2,1
202223,LT1E00300L,SCUOLA PRIMARIA,5,21,21,0,0,0
202223,VR1M026005,SCUOLA SECONDARIA I GRADO,2,50,46,4,1,3
202223,SS1E01000X,SCUOLA PRIMARIA,5,10,10,0,0,0
202223,NA1E022006,SCUOLA PRIMARIA,5,54,54,0,0,0
202223,TVPS015003,SCUOLA SECONDARIA II GRADO,3,42,42,0,0,0
202223,AVTF125004,SCUOLA SECONDARIA II GRADO,3,9,9,0,0,0
202223,MIPLVI500L,SCUOLA SECONDARIA II GRADO,5,31,31,0,0,0
202223,BNPC015006,SCUOLA SECONDARIA II GRADO,4,6,6,0,0,0
202223,RMPC05500E,SCUOLA SECONDARIA II GRADO,4,8,8,0,0,0
202223,NA1E099007,SCUOLA PRIMARIA,4,10,10,0,0,0
202223,CR1E005006,SCUOLA PRIMARIA,5,15,15,0,0,0
202223,MI1E132004,SCUOLA PRIMARIA,4,21,20,1,1,0
202223,SARF195006,SCUOLA SECONDARIA II GRADO,4,5,5,0,0,0
202223,LCTL02500D,SCUOLA SECONDARIA II GRADO,5,4,4,0,0,0
202223,TO1E04900L,SCUOLA PRIMARIA,2,44,44,0,0,0
202223,RMPC44500B,SCUOLA SECONDARIA II GRADO,3,23,22,1,0,1
202223,CT1E00100D,SCUOLA PRIMARIA,1,16,15,1,0,1
202223,CT1E053006,SCUOLA PRIMARIA,2,17,17,0,0,0
202223,NAPS355009,SCUOLA SECONDARIA II GRADO,3,12,12,0,0,0
202223,SATD13500L,SCUOLA SECONDARIA II GRADO,5,70,66,4,2,2
202223,BGPS065005,SCUOLA SECONDARIA II GRADO,2,8,8,0,0,0
202223,SAPSL4500R,SCUOLA SECONDARIA II GRADO,3,23,21,2,0,2
202223,RNTL025002,SCUOLA SECONDARIA II GRADO,2,3,3,0,0,0
202223,RM1E056008,SCUOLA PRIMARIA,2,22,22,0,0,0
202223,RM1E051005,SCUOLA PRIMARIA,3,19,15,4,3,1
202223,PARI045006,SCUOLA SECONDARIA II GRADO,2,1,1,0,0,0
202223,CETF6B500H,SCUOLA SECONDARIA II GRADO,3,10,10,0,0,0
202223,MISL075007,SCUOLA SECONDARIA II GRADO,3,62,61,1,0,1
202223,SV1E00400A,SCUOLA PRIMARIA,4,21,21,0,0,0
202223,BSPS13500P,SCUOLA SECONDARIA II GRADO,3,15,14,1,0,1
202223,VAPS06500N,SCUOLA SECONDARIA II GRADO,5,19,17,2,0,2
202223,VAPMV0500Q,SCUOLA SECONDARIA II GRADO,1,18,18,0,0,0
202223,GE1ELE500C,SCUOLA PRIMARIA,4,22,22,0,0,0
202223,MIPS735002,SCUOLA SECONDARIA II GRADO,5,25,24,1,1,0
202223,RMTB00500D,SCUOLA SECONDARIA II GRADO,1,7,5,2,2,0
202223,PGPS00500G,SCUOLA SECONDARIA II GRADO,5,25,25,0,0,0
202223,PT1M00200Q,SCUOLA SECONDARIA I GRADO,3,29,28,1,0,1
202223,RM1E00800V,SCUOLA PRIMARIA,2,24,24,0,0,0
202223,RO1M00300G,SCUOLA SECONDARIA I GRADO,1,14,14,0,0,0
202223,PD1E076018,SCUOLA PRIMARIA,3,22,22,0,0,0
202223,CO1E01000E,SCUOLA PRIMARIA,4,31,31,0,0,0
202223,CAPS8T5007,SCUOLA SECONDARIA II GRADO,2,5,5,0,0,0
202223,RMPM9A500G,SCUOLA SECONDARIA II GRADO,2,21,21,0,0,0
202223,FIPSCR500M,SCUOLA SECONDARIA II GRADO,1,5,4,1,0,1
202223,MO1E00600X,SCUOLA PRIMARIA,2,9,8,1,0,1
202223,VI1M00700B,SCUOLA SECONDARIA I GRADO,2,17,16,1,0,1
202223,VA1E02200E,SCUOLA PRIMARIA,1,42,41,1,1,0
202223,FI1E03300C,SCUOLA PRIMARIA,3,23,23,0,0,0
202223,TO1E03000G,SCUOLA PRIMARIA,5,11,10,1,0,1
202223,RM1E078005,SCUOLA PRIMARIA,1,28,28,0,0,0
202223,NA1E20300E,SCUOLA PRIMARIA,2,17,17,0,0,0
202223,VA1E01800V,SCUOLA PRIMARIA,4,18,17,1,0,1
202223,IM1E00600C,SCUOLA PRIMARIA,5,21,17,4,0,4
202223,BSPLLZ5006,SCUOLA SECONDARIA II GRADO,5,19,19,0,0,0
202223,CO1E01400T,SCUOLA PRIMARIA,3,53,53,0,0,0
202223,RM1E130001,SCUOLA PRIMARIA,4,8,6,2,0,2
202223,MIPL125001,SCUOLA SECONDARIA II GRADO,4,190,180,10,2,8
202223,MBPSLD5004,SCUOLA SECONDARIA II GRADO,2,14,14,0,0,0
202223,PCTD015006,SCUOLA SECONDARIA II GRADO,5,19,19,0,0,0
202223,PD1E01000L,SCUOLA PRIMARIA,4,51,49,2,0,2
202223,MI1E03100B,SCUOLA PRIMARIA,5,55,54,1,0,1
202223,NATLZC500Z,SCUOLA SECONDARIA II GRADO,5,138,137,1,0,1
202223,RA1E00200G,SCUOLA PRIMARIA,2,37,34,3,0,3
202223,MI1M00200L,SCUOLA SECONDARIA I GRADO,1,22,21,1,1,0
202223,NAPM31500X,SCUOLA SECONDARIA II GRADO,5,55,53,2,0,2
202223,PETN015009,SCUOLA SECONDARIA II GRADO,1,2,1,1,0,1
202223,RM1E01300A,SCUOLA PRIMARIA,2,13,13,0,0,0
202223,MEPMEB500L,SCUOLA SECONDARIA II GRADO,2,4,3,1,0,1
202223,METAR6500G,SCUOLA SECONDARIA II GRADO,2,2,2,0,0,0
202223,NA1M060006,SCUOLA SECONDARIA I GRADO,1,4,3,1,0,1
202223,BS1M02300G,SCUOLA SECONDARIA I GRADO,1,85,82,3,0,3
202223,FI1E01800A,SCUOLA PRIMARIA,1,6,6,0,0,0
202223,NA1E23600T,SCUOLA PRIMARIA,2,11,11,0,0,0
202223,NATFIQ500E,SCUOLA SECONDARIA II GRADO,5,69,68,1,1,0
202223,PD1E004009,SCUOLA PRIMARIA,5,16,16,0,0,0
202223,BG1E027005,SCUOLA PRIMARIA,4,20,19,1,0,1
202223,RMSL015004,SCUOLA SECONDARIA II GRADO,3,18,17,1,0,1
202223,MBPS245005,SCUOLA SECONDARIA II GRADO,1,14,14,0,0,0
202223,CN1E001003,SCUOLA PRIMARIA,1,20,16,4,1,3
202223,APPC0Q500G,SCUOLA SECONDARIA II GRADO,5,29,29,0,0,0
202223,NA1E17000C,SCUOLA PRIMARIA,5,17,17,0,0,0
202223,REPSQE5008,SCUOLA SECONDARIA II GRADO,3,18,17,1,0,1
202223,VR1E009006,SCUOLA PRIMARIA,5,23,23,0,0,0
202223,RG1E0O5005,SCUOLA PRIMARIA,1,9,9,0,0,0
202223,FRPSII500H,SCUOLA SECONDARIA II GRADO,4,9,8,1,1,0
202223,LUPL01500A,SCUOLA SECONDARIA II GRADO,4,25,21,4,0,4
202223,TO1ED5500F,SCUOLA PRIMARIA,3,18,18,0,0,0
202223,NATF41500Q,SCUOLA SECONDARIA II GRADO,1,1,1,0,0,0
202223,SATFET500V,SCUOLA SECONDARIA II GRADO,5,69,68,1,0,1
202223,RMTD58500N,SCUOLA SECONDARIA II GRADO,4,32,32,0,0,0
202223,RMTD545007,SCUOLA SECONDARIA II GRADO,2,8,6,2,1,1
202223,MI1M097007,SCUOLA SECONDARIA I GRADO,1,19,19,0,0,0
202223,PVPL02500T,SCUOLA SECONDARIA II GRADO,4,10,10,0,0,0
202223,NATD305004,SCUOLA SECONDARIA II GRADO,5,59,54,5,2,3
202223,MI1E137007,SCUOLA PRIMARIA,3,6,5,1,0,1
202223,MI1E016009,SCUOLA PRIMARIA,4,28,28,0,0,0
202223,BOPS05500C,SCUOLA SECONDARIA II GRADO,1,21,20,1,0,1
202223,SA1E01400N,SCUOLA PRIMARIA,3,21,21,0,0,0
202223,CTPL00500R,SCUOLA SECONDARIA II GRADO,3,6,6,0,0,0
202223,RM1E06100Q,SCUOLA PRIMARIA,2,25,25,0,0,0
202223,CO1M013007,SCUOLA SECONDARIA I GRADO,2,51,51,0,0,0
202223,COPL025008,SCUOLA SECONDARIA II GRADO,1,30,29,1,1,0
202223,RMPSPG500N,SCUOLA SECONDARIA II GRADO,2,7,5,2,0,2
202223,VARF5F500H,SCUOLA SECONDARIA II GRADO,1,6,1,5,0,5
202223,CE1EO0500I,SCUOLA PRIMARIA,4,25,24,1,1,0
202223,AT1E00300B,SCUOLA PRIMARIA,1,15,15,0,0,0
202223,RM1M08900R,SCUOLA SECONDARIA I GRADO,2,25,21,4,1,3
202223,BR1E00200T,SCUOLA PRIMARIA,5,12,12,0,0,0
202223,NA1E21100D,SCUOLA PRIMARIA,5,10,10,0,0,0
202223,MI1E06400P,SCUOLA PRIMARIA,2,26,25,1,0,1
202223,BS1E01200X,SCUOLA PRIMARIA,5,25,25,0,0,0
202223,RM1E022005,SCUOLA PRIMARIA,4,14,14,0,0,0
202223,RMPS46500Q,SCUOLA SECONDARIA II GRADO,1,16,12,4,0,4
202223,PV1E001009,SCUOLA PRIMARIA,1,44,44,0,0,0
202223,NARFV15001,SCUOLA SECONDARIA II GRADO,2,9,9,0,0,0
202223,LC1E004001,SCUOLA PRIMARIA,2,26,26,0,0,0
202223,RM1E12300T,SCUOLA PRIMARIA,3,44,43,1,0,1
202223,RMRFB3500L,SCUOLA SECONDARIA II GRADO,1,8,8,0,0,0
202223,MIPL335009,SCUOLA SECONDARIA II GRADO,4,21,21,0,0,0
202223,RMPSIZ500B,SCUOLA SECONDARIA II GRADO,1,27,26,1,0,1
202223,RM1MHD500Z,SCUOLA SECONDARIA I GRADO,3,8,7,1,1,0
202223,MI1E06000B,SCUOLA PRIMARIA,3,37,28,9,0,9
202223,BSSLVV500P,SCUOLA SECONDARIA II GRADO,3,9,9,0,0,0
202223,NA1E17900V,SCUOLA PRIMARIA,2,9,9,0,0,0
202223,CA1M01200C,SCUOLA SECONDARIA I GRADO,3,31,29,2,0,2
202223,RM1E03100X,SCUOLA PRIMARIA,5,18,17,1,0,1
202223,RN1E00400D,SCUOLA PRIMARIA,3,23,23,0,0,0
202223,LE1E005002,SCUOLA PRIMARIA,3,16,11,5,1,4
202223,TV1E00800P,SCUOLA PRIMARIA,1,36,32,4,0,4
202223,CE1E05400Q,SCUOLA PRIMARIA,5,16,16,0,0,0
202223,NAPMEF500M,SCUOLA SECONDARIA II GRADO,4,4,4,0,0,0
202223,CTTF005004,SCUOLA SECONDARIA II GRADO,3,3,3,0,0,0
202223,ME1E00900V,SCUOLA PRIMARIA,3,10,8,2,0,2
202223,IM1E00500L,SCUOLA PRIMARIA,2,19,18,1,0,1
202223,PR1E00400G,SCUOLA PRIMARIA,4,39,38,1,0,1
202223,PRPSAV500N,SCUOLA SECONDARIA II GRADO,2,15,14,1,1,0
202223,BO1E013005,SCUOLA PRIMARIA,4,22,22,0,0,0
202223,RM1E121006,SCUOLA PRIMARIA,2,23,23,0,0,0
202223,NA1E13900C,SCUOLA PRIMARIA,1,19,19,0,0,0
202223,BGTFUM500Z,SCUOLA SECONDARIA II GRADO,3,10,10,0,0,0
202223,CT1E010008,SCUOLA PRIMARIA,3,14,12,2,0,2
202223,RM1MZ7500R,SCUOLA SECONDARIA I GRADO,1,13,13,0,0,0
202223,MIPSQB5007,SCUOLA SECONDARIA II GRADO,1,28,28,0,0,0
202223,MOTD02500A,SCUOLA SECONDARIA II GRADO,5,20,20,0,0,0
202223,NO1E00300Q,SCUOLA PRIMARIA,2,52,51,1,0,1
202223,CHTF00500E,SCUOLA SECONDARIA II GRADO,4,3,3,0,0,0
202223,MI1M070007,SCUOLA SECONDARIA I GRADO,1,40,33,7,0,7
202223,RN1E01000R,SCUOLA PRIMARIA,1,22,22,0,0,0
202223,LE1M00400B,SCUOLA SECONDARIA I GRADO,1,29,29,0,0,0
202223,TV1E01000P,SCUOLA PRIMARIA,2,42,39,3,2,1
202223,VA1M01000D,SCUOLA SECONDARIA I GRADO,2,69,68,1,1,0
202223,PO1E00700X,SCUOLA PRIMARIA,5,40,26,14,0,14
202223,MITD25500P,SCUOLA SECONDARIA II GRADO,4,5,5,0,0,0
202223,PO1E013007,SCUOLA PRIMARIA,2,19,13,6,0,6
202223,BSPS06500N,SCUOLA SECONDARIA II GRADO,3,37,36,1,0,1
202223,NATF365002,SCUOLA SECONDARIA II GRADO,3,4,4,0,0,0
202223,MI1E12100N,SCUOLA PRIMARIA,4,22,20,2,0,2
202223,NA1E06200L,SCUOLA PRIMARIA,2,55,55,0,0,0
202223,CSPSSP500D,SCUOLA SECONDARIA II GRADO,1,8,8,0,0,0
202223,AGSL015004,SCUOLA SECONDARIA II GRADO,5,9,9,0,0,0
202223,AL1E00300A,SCUOLA PRIMARIA,2,12,12,0,0,0
202223,CE1E036006,SCUOLA PRIMARIA,4,12,8,4,2,2
202223,FI1M00500D,SCUOLA SECONDARIA I GRADO,2,32,27,5,0,5
202223,LU1E00700B,SCUOLA PRIMARIA,2,16,15,1,0,1
202223,NA1E029001,SCUOLA PRIMARIA,5,29,29,0,0,0
202223,CO1E01400T,SCUOLA PRIMARIA,4,43,41,2,0,2
202223,UDPSBD500N,SCUOLA SECONDARIA II GRADO,2,29,28,1,0,1
202223,RMPS5G5003,SCUOLA SECONDARIA II GRADO,4,3,3,0,0,0
202223,RM1E04200A,SCUOLA PRIMARIA,5,25,23,2,0,2
202223,SRPL005001,SCUOLA SECONDARIA II GRADO,1,9,8,1,0,1
202223,AGTDE45003,SCUOLA SECONDARIA II GRADO,4,18,18,0,0,0
202223,FI1M01100R,SCUOLA SECONDARIA I GRADO,1,18,16,2,0,2
202223,CE1E066002,SCUOLA PRIMARIA,2,25,24,1,0,1
202223,MIPMGC500D,SCUOLA SECONDARIA II GRADO,2,23,22,1,1,0
202223,CTRHMM500U,SCUOLA SECONDARIA II GRADO,4,11,11,0,0,0
202223,BSPM4P500U,SCUOLA SECONDARIA II GRADO,3,18,18,0,0,0
202223,TVPL08500G,SCUOLA SECONDARIA II GRADO,3,28,28,0,0,0
202223,AVTFVM500N,SCUOLA SECONDARIA II GRADO,4,9,9,0,0,0
202223,NA1E25400B,SCUOLA PRIMARIA,3,15,14,1,0,1
202223,VA1E00100D,SCUOLA PRIMARIA,4,32,32,0,0,0
202223,BGTFF0500O,SCUOLA SECONDARIA II GRADO,4,17,17,0,0,0
202223,VRPL01500D,SCUOLA SECONDARIA II GRADO,1,30,30,0,0,0
202223,VARH01500A,SCUOLA SECONDARIA II GRADO,2,29,26,3,1,2
202223,RM1M04700P,SCUOLA SECONDARIA I GRADO,3,19,19,0,0,0
202223,BA1E00300G,SCUOLA PRIMARIA,2,33,32,1,1,0
202223,CR1E00700T,SCUOLA PRIMARIA,3,17,14,3,2,1
202223,NATLT3500M,SCUOLA SECONDARIA II GRADO,1,8,8,0,0,0
202223,CA1E013003,SCUOLA PRIMARIA,5,30,30,0,0,0
202223,MB1E05000N,SCUOLA PRIMARIA,5,38,36,2,0,2
202223,RMPC545008,SCUOLA SECONDARIA II GRADO,5,17,17,0,0,0
202223,VI1E01300D,SCUOLA PRIMARIA,4,27,26,1,1,0
202223,TA1E00500X,SCUOLA PRIMARIA,4,15,15,0,0,0
202223,SV1M00200X,SCUOLA SECONDARIA I GRADO,2,18,17,1,1,0
202223,CETFQ95001,SCUOLA SECONDARIA II GRADO,2,9,5,4,0,4
202223,RMPC26500V,SCUOLA SECONDARIA II GRADO,1,32,32,0,0,0
202223,MI1M10000T,SCUOLA SECONDARIA I GRADO,3,10,9,1,0,1
202223,PS1E003007,SCUOLA PRIMARIA,3,20,20,0,0,0
202223,CORF8L5003,SCUOLA SECONDARIA II GRADO,5,4,4,0,0,0
202223,NA1E234006,SCUOLA PRIMARIA,1,15,15,0,0,0
202223,RM1E13900B,SCUOLA PRIMARIA,1,23,22,1,1,0
202223,NATF1Z500S,SCUOLA SECONDARIA II GRADO,5,48,47,1,0,1
202223,MIPLMC5009,SCUOLA SECONDARIA II GRADO,4,6,6,0,0,0
202223,SATF5M500Z,SCUOLA SECONDARIA II GRADO,4,3,3,0,0,0
202223,MIPSE7500I,SCUOLA SECONDARIA II GRADO,2,34,32,2,0,2
202223,RMPS25500B,SCUOLA SECONDARIA II GRADO,3,16,16,0,0,0
202223,NATHE15007,SCUOLA SECONDARIA II GRADO,1,4,4,0,0,0
202223,TVPSIL5006,SCUOLA SECONDARIA II GRADO,2,12,12,0,0,0
202223,PVTBDH500G,SCUOLA SECONDARIA II GRADO,1,3,3,0,0,0
202223,AP1M001005,SCUOLA SECONDARIA I GRADO,3,15,15,0,0,0
202223,MI1E12600R,SCUOLA PRIMARIA,3,72,68,4,1,3
202223,RMTF145002,SCUOLA SECONDARIA II GRADO,3,12,11,1,1,0
202223,VA1MUI500S,SCUOLA SECONDARIA I GRADO,1,15,13,2,0,2
202223,VE1E01000P,SCUOLA PRIMARIA,3,24,24,0,0,0
202223,VAPS025007,SCUOLA SECONDARIA II GRADO,5,16,16,0,0,0
202223,VE1E00100X,SCUOLA PRIMARIA,1,14,13,1,0,1
202223,FI1E021006,SCUOLA PRIMARIA,3,17,17,0,0,0
202223,CE1E00900T,SCUOLA PRIMARIA,2,20,20,0,0,0
202223,MI1E08400X,SCUOLA PRIMARIA,2,18,14,4,0,4
202223,VRPSI5500C,SCUOLA SECONDARIA II GRADO,1,16,16,0,0,0
202223,PA1E014004,SCUOLA PRIMARIA,3,75,72,3,0,3
202223,ARPM015009,SCUOLA SECONDARIA II GRADO,3,37,36,1,0,1
202223,GEPL01500Q,SCUOLA SECONDARIA II GRADO,4,149,143,6,1,5
202223,TO1E00100G,SCUOLA PRIMARIA,1,48,46,2,1,1
202223,VV1E00100R,SCUOLA PRIMARIA,1,21,20,1,0,1
202223,CETD15500D,SCUOLA SECONDARIA II GRADO,2,25,24,1,0,1
202223,PDPS035006,SCUOLA SECONDARIA II GRADO,5,29,28,1,0,1
202223,NATF2S500C,SCUOLA SECONDARIA II GRADO,2,4,4,0,0,0
202223,MI1E07900C,SCUOLA PRIMARIA,5,22,22,0,0,0
202223,AQ1E003006,SCUOLA PRIMARIA,1,14,14,0,0,0
202223,NOPS03500C,SCUOLA SECONDARIA II GRADO,4,50,49,1,0,1
202223,MN1M001009,SCUOLA SECONDARIA I GRADO,1,40,37,3,1,2
202223,SAPM3S500H,SCUOLA SECONDARIA II GRADO,4,8,8,0,0,0
202223,TO1E02100R,SCUOLA PRIMARIA,4,51,49,2,1,1
202223,BOPS525001,SCUOLA SECONDARIA II GRADO,3,22,22,0,0,0
202223,NARFRT500R,SCUOLA SECONDARIA II GRADO,2,6,6,0,0,0
202223,TVPS57500F,SCUOLA SECONDARIA II GRADO,4,36,36,0,0,0
202223,BS1M02100X,SCUOLA SECONDARIA I GRADO,1,32,28,4,0,4
202223,BG1M01200L,SCUOLA SECONDARIA I GRADO,3,42,42,0,0,0
202223,CTPM415005,SCUOLA SECONDARIA II GRADO,4,2,2,0,0,0
202223,TOPS19500C,SCUOLA SECONDARIA II GRADO,4,14,14,0,0,0
202223,RM1E142007,SCUOLA PRIMARIA,2,50,49,1,0,1
202223,TOPM085002,SCUOLA SECONDARIA II GRADO,2,10,10,0,0,0
202223,FE1E00100N,SCUOLA PRIMARIA,5,44,31,13,5,8
202223,BN1E001006,SCUOLA PRIMARIA,5,35,35,0,0,0
202223,NA1E09200C,SCUOLA PRIMARIA,4,26,26,0,0,0
202223,RMPS03500C,SCUOLA SECONDARIA II GRADO,2,42,42,0,0,0
202223,CR1E00800N,SCUOLA PRIMARIA,3,18,17,1,1,0
202223,BATD01500V,SCUOLA SECONDARIA II GRADO,2,3,3,0,0,0
202223,TO1E03700A,SCUOLA PRIMARIA,3,32,31,1,1,0
202223,FRTDI4500L,SCUOLA SECONDARIA II GRADO,2,1,1,0,0,0
202223,ME1E00300X,SCUOLA PRIMARIA,3,18,18,0,0,0
202223,RM1M003001,SCUOLA SECONDARIA I GRADO,1,40,39,1,0,1
202223,IM1E003001,SCUOLA PRIMARIA,1,22,20,2,2,0
202223,RMPC545008,SCUOLA SECONDARIA II GRADO,3,10,10,0,0,0
202223,MIPC16500D,SCUOLA SECONDARIA II GRADO,3,22,22,0,0,0
202223,PD1E00300D,SCUOLA PRIMARIA,1,23,23,0,0,0
202223,PCPS01500A,SCUOLA SECONDARIA II GRADO,4,1,1,0,0,0
202223,RM1M03800X,SCUOLA SECONDARIA I GRADO,3,16,15,1,0,1
202223,RMPS165005,SCUOLA SECONDARIA II GRADO,3,4,4,0,0,0
202223,VR1E003007,SCUOLA PRIMARIA,5,22,22,0,0,0
202223,RGPS98500R,SCUOLA SECONDARIA II GRADO,4,4,4,0,0,0
202223,PAPS8N500C,SCUOLA SECONDARIA II GRADO,4,10,10,0,0,0
202223,BGPS12500G,SCUOLA SECONDARIA II GRADO,1,11,11,0,0,0
202223,CETD115003,SCUOLA SECONDARIA II GRADO,3,4,4,0,0,0
202223,VA1M01900X,SCUOLA SECONDARIA I GRADO,2,39,39,0,0,0
202223,CTPSQC5001,SCUOLA SECONDARIA II GRADO,1,7,7,0,0,0
202223,GE1E034005,SCUOLA PRIMARIA,3,5,5,0,0,0
202223,MI1MIN5009,SCUOLA SECONDARIA I GRADO,3,43,42,1,0,1
202223,VT1E00300T,SCUOLA PRIMARIA,4,15,15,0,0,0
202223,BG1E01600P,SCUOLA PRIMARIA,2,57,55,2,0,2
202223,VRPC025006,SCUOLA SECONDARIA II GRADO,2,6,5,1,0,1
202223,MIPS175007,SCUOLA SECONDARIA II GRADO,4,42,42,0,0,0
202223,TO1E01500D,SCUOLA PRIMARIA,3,19,16,3,1,2
202223,RMPS08500D,SCUOLA SECONDARIA II GRADO,5,32,32,0,0,0
202223,MBPL20500D,SCUOLA SECONDARIA II GRADO,2,41,40,1,0,1
202223,NATABS5008,SCUOLA SECONDARIA II GRADO,3,8,8,0,0,0
202223,BG1E01100G,SCUOLA PRIMARIA,1,18,18,0,0,0
202223,MI1M083009,SCUOLA SECONDARIA I GRADO,1,28,27,1,0,1
202223,SATABS5008,SCUOLA SECONDARIA II GRADO,3,11,11,0,0,0
202223,MI1E004003,SCUOLA PRIMARIA,2,45,41,4,0,4
202223,RG1E00300C,SCUOLA PRIMARIA,5,26,26,0,0,0
202223,GE1E01600G,SCUOLA PRIMARIA,1,19,18,1,1,0
202223,FOPS5G500N,SCUOLA SECONDARIA II GRADO,1,52,49,3,2,1
202223,MIPS09500G,SCUOLA SECONDARIA II GRADO,4,61,58,3,0,3
202223,PAPS3Q5009,SCUOLA SECONDARIA II GRADO,1,51,49,2,0,2
202223,RO1E00100P,SCUOLA PRIMARIA,2,18,17,1,0,1
202223,TO1M041007,SCUOLA SECONDARIA I GRADO,2,53,53,0,0,0
202223,TO1EPI500H,SCUOLA PRIMARIA,4,24,22,2,0,2
202223,BGPMDF500L,SCUOLA SECONDARIA II GRADO,2,13,13,0,0,0
202223,FIPSO9500R,SCUOLA SECONDARIA II GRADO,5,7,6,1,0,1
202223,VASLQ8500T,SCUOLA SECONDARIA II GRADO,3,12,12,0,0,0
202223,MO1EF4500G,SCUOLA PRIMARIA,1,36,30,6,2,4
202223,VI1E001007,SCUOLA PRIMARIA,2,31,27,4,0,4
202223,CS1ENE5005,SCUOLA PRIMARIA,5,14,14,0,0,0
202223,FI1E027005,SCUOLA PRIMARIA,1,6,5,1,0,1
202223,RM1E08700X,SCUOLA PRIMARIA,4,17,16,1,0,1
202223,RM1E08300L,SCUOLA PRIMARIA,5,53,53,0,0,0
202223,VA1E4D500Q,SCUOLA PRIMARIA,5,36,33,3,0,3
202223,LTPSU65008,SCUOLA SECONDARIA II GRADO,1,1,1,0,0,0
202223,RM1E5U5009,SCUOLA PRIMARIA,4,10,9,1,1,0
202223,CT1EG5500S,SCUOLA PRIMARIA,4,10,10,0,0,0
202223,BGPL06500X,SCUOLA SECONDARIA II GRADO,1,10,10,0,0,0
202223,TOPL66500H,SCUOLA SECONDARIA II GRADO,1,13,13,0,0,0
202223,RM1E10800Q,SCUOLA PRIMARIA,3,27,24,3,3,0
202223,RC1E995002,SCUOLA PRIMARIA,2,3,1,2,0,2
202223,NA1E09800B,SCUOLA PRIMARIA,5,21,20,1,0,1
202223,RM1M130006,SCUOLA SECONDARIA I GRADO,3,35,35,0,0,0
202223,RM1M087005,SCUOLA SECONDARIA I GRADO,2,9,8,1,0,1
202223,BA1E01600N,SCUOLA PRIMARIA,5,16,16,0,0,0
202223,RM1E014006,SCUOLA PRIMARIA,5,18,17,1,0,1
202223,RMTL395001,SCUOLA SECONDARIA II GRADO,2,1,1,0,0,0
202223,NAPM5I5007,SCUOLA SECONDARIA II GRADO,2,13,13,0,0,0
202223,VI1M01200V,SCUOLA SECONDARIA I GRADO,3,46,45,1,0,1
202223,CZ1E002002,SCUOLA PRIMARIA,1,15,14,1,0,1
202223,MERHF3500O,SCUOLA SECONDARIA II GRADO,2,2,2,0,0,0
202223,SVPM02500N,SCUOLA SECONDARIA II GRADO,5,22,22,0,0,0
202223,PA1E80500Q,SCUOLA PRIMARIA,3,12,12,0,0,0
202223,NA1E130002,SCUOLA PRIMARIA,5,10,10,0,0,0
202223,RMPC235003,SCUOLA SECONDARIA II GRADO,5,6,6,0,0,0
202223,BG1E028001,SCUOLA PRIMARIA,4,24,23,1,0,1
202223,TEPS335003,SCUOLA SECONDARIA II GRADO,3,4,4,0,0,0
202223,NA1E18200P,SCUOLA PRIMARIA,4,25,25,0,0,0
202223,CSPQ025009,SCUOLA SECONDARIA II GRADO,3,4,4,0,0,0
202223,PDPS065002,SCUOLA SECONDARIA II GRADO,1,65,62,3,0,3
202223,RNPM015006,SCUOLA SECONDARIA II GRADO,3,50,35,15,0,15
202223,LU1E00600G,SCUOLA PRIMARIA,4,21,20,1,1,0
202223,SV1E005006,SCUOLA PRIMARIA,3,37,36,1,0,1
202223,NA1E136001,SCUOLA PRIMARIA,4,25,22,3,0,3
202223,MI1E11900N,SCUOLA PRIMARIA,5,19,19,0,0,0
202223,VRRI01500X,SCUOLA SECONDARIA II GRADO,4,4,3,1,1,0
202223,PA1E01800B,SCUOLA PRIMARIA,3,21,20,1,1,0
202223,NATD21500T,SCUOLA SECONDARIA II GRADO,2,8,8,0,0,0
202223,RM1E17300V,SCUOLA PRIMARIA,4,24,23,1,0,1
202223,PNPS03500L,SCUOLA SECONDARIA II GRADO,4,13,13,0,0,0
202223,SARHZG500U,SCUOLA SECONDARIA II GRADO,4,13,13,0,0,0
202223,AL1M00700V,SCUOLA SECONDARIA I GRADO,1,18,18,0,0,0
202223,TV1E01600N,SCUOLA PRIMARIA,5,24,23,1,1,0
202223,FIPL06500X,SCUOLA SECONDARIA II GRADO,1,13,12,1,0,1
202223,VE1M00400L,SCUOLA SECONDARIA I GRADO,3,27,23,4,1,3
202223,RN1M010002,SCUOLA SECONDARIA I GRADO,3,23,23,0,0,0
202223,CTPL075003,SCUOLA SECONDARIA II GRADO,4,3,3,0,0,0
202223,BG1M01300C,SCUOLA SECONDARIA I GRADO,1,129,129,0,0,0
202223,MI1E08100C,SCUOLA PRIMARIA,1,12,12,0,0,0
202223,NA1E03900G,SCUOLA PRIMARIA,1,28,28,0,0,0
202223,NA1E051006,SCUOLA PRIMARIA,5,32,29,3,0,3
202223,PDPS00500A,SCUOLA SECONDARIA II GRADO,1,25,25,0,0,0
202223,COPL08500X,SCUOLA SECONDARIA II GRADO,4,29,27,2,0,2
202223,NA1E12900T,SCUOLA PRIMARIA,2,16,16,0,0,0
202223,CE1E01100T,SCUOLA PRIMARIA,4,29,28,1,0,1
202223,UD1M008008,SCUOLA SECONDARIA I GRADO,2,41,41,0,0,0
202223,BRTD04500A,SCUOLA SECONDARIA II GRADO,1,2,2,0,0,0
202223,MI1E059007,SCUOLA PRIMARIA,1,48,43,5,1,4
202223,BS1E00700C,SCUOLA PRIMARIA,4,26,26,0,0,0
202223,RM1E030004,SCUOLA PRIMARIA,3,17,16,1,1,0
202223,PN1E002004,SCUOLA PRIMARIA,4,40,39,1,1,0
202223,RMPS53500R,SCUOLA SECONDARIA II GRADO,1,12,10,2,1,1
202223,RM1E049005,SCUOLA PRIMARIA,4,24,24,0,0,0
202223,SP1E00500Q,SCUOLA PRIMARIA,3,21,20,1,0,1
202223,SA1E02600X,SCUOLA PRIMARIA,1,21,21,0,0,0
202223,PT1E004006,SCUOLA PRIMARIA,2,14,14,0,0,0
202223,SA1E009006,SCUOLA PRIMARIA,4,13,12,1,0,1
202223,RM1EVQ500H,SCUOLA PRIMARIA,4,30,28,2,2,0
202223,PG1M001008,SCUOLA SECONDARIA I GRADO,2,17,15,2,0,2
202223,NARFZO500E,SCUOLA SECONDARIA II GRADO,5,99,90,9,1,8
202223,LT1E006004,SCUOLA PRIMARIA,4,13,13,0,0,0
202223,BG1M022007,SCUOLA SECONDARIA I GRADO,2,47,46,1,0,1
202223,NA1E027009,SCUOLA PRIMARIA,4,22,22,0,0,0
202223,NA1E24400R,SCUOLA PRIMARIA,5,16,16,0,0,0
202223,RMPM3G5002,SCUOLA SECONDARIA II GRADO,3,2,2,0,0,0
202223,RM1E11700E,SCUOLA PRIMARIA,3,8,7,1,1,0
202223,NATD48500T,SCUOLA SECONDARIA II GRADO,2,9,9,0,0,0
202223,NATDE6500C,SCUOLA SECONDARIA II GRADO,1,5,5,0,0,0
202223,CEPL00500E,SCUOLA SECONDARIA II GRADO,2,9,7,2,0,2
202223,MI1E025004,SCUOLA PRIMARIA,2,51,48,3,0,3
202223,RM1MTI500F,SCUOLA SECONDARIA I GRADO,3,19,14,5,0,5
202223,TVTD02500D,SCUOLA SECONDARIA II GRADO,2,16,16,0,0,0
202223,SAPMFG500M,SCUOLA SECONDARIA II GRADO,5,134,121,13,4,9
202223,TOTF01500R,SCUOLA SECONDARIA II GRADO,5,52,52,0,0,0
202223,APPSR5500N,SCUOLA SECONDARIA II GRADO,2,4,3,1,0,1
202223,CA1EN7500O,SCUOLA PRIMARIA,5,24,22,2,1,1
202223,RM1E036003,SCUOLA PRIMARIA,2,35,34,1,0,1
202223,BO1E01500R,SCUOLA PRIMARIA,2,36,36,0,0,0
202223,PE1E00600G,SCUOLA PRIMARIA,4,31,28,3,2,1
202223,ME1E01300E,SCUOLA PRIMARIA,3,11,10,1,0,1
202223,VA1M01000D,SCUOLA SECONDARIA I GRADO,1,52,51,1,0,1
202223,MIRF6M5002,SCUOLA SECONDARIA II GRADO,4,20,10,10,0,10
202223,BGTB015001,SCUOLA SECONDARIA II GRADO,3,62,52,10,4,6
202223,VAPS2O5006,SCUOLA SECONDARIA II GRADO,2,4,4,0,0,0
202223,SSPL015003,SCUOLA SECONDARIA II GRADO,1,1,1,0,0,0
202223,TVPMVC5000,SCUOLA SECONDARIA II GRADO,1,25,25,0,0,0
202223,COPSCP5007,SCUOLA SECONDARIA II GRADO,2,12,11,1,1,0
202223,TVPM4Q500B,SCUOLA SECONDARIA II GRADO,4,4,4,0,0,0
202223,NA1E241009,SCUOLA PRIMARIA,1,11,11,0,0,0
202223,BGTFUM500Z,SCUOLA SECONDARIA II GRADO,4,15,14,1,1,0
202223,MIPSOC500H,SCUOLA SECONDARIA II GRADO,1,12,6,6,0,6
202223,MS1E00100B,SCUOLA PRIMARIA,3,14,14,0,0,0
202223,AP1E005007,SCUOLA PRIMARIA,4,18,15,3,2,1
202223,MI1E02200L,SCUOLA PRIMARIA,1,13,9,4,0,4
202223,PDTF015003,SCUOLA SECONDARIA II GRADO,1,10,9,1,1,0
202223,RMPL00500B,SCUOLA SECONDARIA II GRADO,5,28,28,0,0,0
202223,FRPM9Q500B,SCUOLA SECONDARIA II GRADO,5,52,43,9,5,4
202223,BGPSAF500M,SCUOLA SECONDARIA II GRADO,4,4,4,0,0,0
202223,PRPS015007,SCUOLA SECONDARIA II GRADO,1,8,8,0,0,0
202223,SATFIF5007,SCUOLA SECONDARIA II GRADO,4,8,8,0,0,0
202223,CO1E00100Q,SCUOLA PRIMARIA,4,41,38,3,0,3
202223,MOTD02500A,SCUOLA SECONDARIA II GRADO,2,19,17,2,0,2
202223,PGTDEI500F,SCUOLA SECONDARIA II GRADO,5,11,10,1,0,1
202223,MI1E009006,SCUOLA PRIMARIA,4,117,113,4,2,2
202223,AGTD685001,SCUOLA SECONDARIA II GRADO,3,4,4,0,0,0
202223,TO1E02700Q,SCUOLA PRIMARIA,4,52,47,5,1,4
202223,RMPL1M500I,SCUOLA SECONDARIA II GRADO,4,7,5,2,0,2
202223,FI1M01100R,SCUOLA SECONDARIA I GRADO,2,48,43,5,1,4
202223,RM1E07400T,SCUOLA PRIMARIA,5,16,15,1,0,1
202223,TS1E008001,SCUOLA PRIMARIA,5,22,20,2,2,0
202223,BOTF2S5000,SCUOLA SECONDARIA II GRADO,2,27,27,0,0,0
202223,VA1E008008,SCUOLA PRIMARIA,3,36,35,1,0,1
202223,VE1E01200A,SCUOLA PRIMARIA,4,15,15,0,0,0
202223,RM1E01000V,SCUOLA PRIMARIA,5,22,22,0,0,0
202223,PO1E005008,SCUOLA PRIMARIA,5,25,19,6,0,6
202223,NA1EPH500O,SCUOLA PRIMARIA,1,20,20,0,0,0
202223,NA1M03400N,SCUOLA SECONDARIA I GRADO,3,27,26,1,0,1
202223,VAPS5H500H,SCUOLA SECONDARIA II GRADO,4,27,27,0,0,0
202223,BGPL16500Q,SCUOLA SECONDARIA II GRADO,1,16,16,0,0,0
202223,VA1E00100D,SCUOLA PRIMARIA,3,23,21,2,0,2
202223,PA1E00400D,SCUOLA PRIMARIA,5,17,17,0,0,0
202223,RMTD55500T,SCUOLA SECONDARIA II GRADO,3,10,10,0,0,0
202223,MB1M01000C,SCUOLA SECONDARIA I GRADO,2,49,48,1,0,1
202223,RMTB04500X,SCUOLA SECONDARIA II GRADO,2,14,12,2,2,0
202223,LO1E00300V,SCUOLA PRIMARIA,2,16,16,0,0,0
202223,PGPM02500T,SCUOLA SECONDARIA II GRADO,3,9,6,3,0,3
202223,RMPS97500P,SCUOLA SECONDARIA II GRADO,2,17,17,0,0,0
202223,RMPS72500B,SCUOLA SECONDARIA II GRADO,4,9,9,0,0,0
202223,SR1E3H5006,SCUOLA PRIMARIA,1,8,8,0,0,0
202223,RE1M00100B,SCUOLA SECONDARIA I GRADO,1,17,16,1,0,1
202223,BO1MZN5006,SCUOLA SECONDARIA I GRADO,1,44,40,4,1,3
202223,NA1E1M500R,SCUOLA PRIMARIA,5,8,3,5,0,5
202223,BORI03500C,SCUOLA SECONDARIA II GRADO,1,25,21,4,0,4
202223,RM1E212008,SCUOLA PRIMARIA,3,77,73,4,1,3
202223,NARHTO500T,SCUOLA SECONDARIA II GRADO,1,3,3,0,0,0
202223,PA1E04000L,SCUOLA PRIMARIA,2,14,14,0,0,0
202223,PA1EDC5004,SCUOLA PRIMARIA,5,18,18,0,0,0
202223,NA1E25200Q,SCUOLA PRIMARIA,3,11,11,0,0,0
202223,FETD9H500S,SCUOLA SECONDARIA II GRADO,1,9,4,5,0,5
202223,APRFSQ500B,SCUOLA SECONDARIA II GRADO,3,1,0,1,1,0
202223,MI1E054004,SCUOLA PRIMARIA,3,6,6,0,0,0
202223,MS1E00500P,SCUOLA PRIMARIA,2,21,21,0,0,0
202223,RMPMQB5004,SCUOLA SECONDARIA II GRADO,4,21,21,0,0,0
202223,CL1E002008,SCUOLA PRIMARIA,5,17,17,0,0,0
202223,CA1E01500P,SCUOLA PRIMARIA,3,18,18,0,0,0
202223,NA1E15900N,SCUOLA PRIMARIA,3,10,10,0,0,0
202223,MI1M04000B,SCUOLA SECONDARIA I GRADO,3,52,52,0,0,0
202223,BOPM8F500M,SCUOLA SECONDARIA II GRADO,4,17,17,0,0,0
202223,VI1M01500A,SCUOLA SECONDARIA I GRADO,1,13,12,1,1,0
202223,GRPC64500E,SCUOLA SECONDARIA II GRADO,2,10,10,0,0,0
202223,PA1E04500Q,SCUOLA PRIMARIA,3,27,26,1,0,1
202223,AG1E006007,SCUOLA PRIMARIA,4,16,16,0,0,0
202223,COPSUC5004,SCUOLA SECONDARIA II GRADO,2,26,26,0,0,0
202223,FI1E021006,SCUOLA PRIMARIA,4,25,25,0,0,0
202223,AVTF005001,SCUOLA SECONDARIA II GRADO,2,6,5,1,0,1
202223,NATDFO5000,SCUOLA SECONDARIA II GRADO,5,132,128,4,0,4
202223,COTEA1500D,SCUOLA SECONDARIA II GRADO,5,4,1,3,0,3
202223,RM1E14400V,SCUOLA PRIMARIA,2,8,3,5,0,5
202223,RMRF00500V,SCUOLA SECONDARIA II GRADO,3,5,4,1,1,0
202223,RMPS235006,SCUOLA SECONDARIA II GRADO,2,26,26,0,0,0
202223,RMPS135009,SCUOLA SECONDARIA II GRADO,3,6,6,0,0,0
202223,PVPLHO500H,SCUOLA SECONDARIA II GRADO,5,7,6,1,1,0
202223,PVPSTA500Q,SCUOLA SECONDARIA II GRADO,2,19,19,0,0,0
202223,MI1M077002,SCUOLA SECONDARIA I GRADO,2,35,35,0,0,0
202223,MI1EES500O,SCUOLA PRIMARIA,2,27,23,4,0,4
202223,CE1E045001,SCUOLA PRIMARIA,4,14,13,1,0,1
202223,NAPM115006,SCUOLA SECONDARIA II GRADO,2,19,19,0,0,0
202223,FRTD00500N,SCUOLA SECONDARIA II GRADO,5,120,109,11,4,7
202223,CERIN35009,SCUOLA SECONDARIA II GRADO,1,8,8,0,0,0
202223,LU1ETH500S,SCUOLA PRIMARIA,2,2,1,1,1,0
202223,BS1E02100P,SCUOLA PRIMARIA,2,20,20,0,0,0
202223,BSPS2M500I,SCUOLA SECONDARIA II GRADO,5,18,14,4,2,2
202223,TO1M00900B,SCUOLA SECONDARIA I GRADO,2,78,77,1,0,1
202223,FI1E013007,SCUOLA PRIMARIA,2,15,10,5,0,5
202223,VRTF005006,SCUOLA SECONDARIA II GRADO,4,227,225,2,1,1
202223,AR1E002001,SCUOLA PRIMARIA,2,19,19,0,0,0
202223,ATRI02500P,SCUOLA SECONDARIA II GRADO,5,17,11,6,0,6
202223,NA1E15500A,SCUOLA PRIMARIA,5,16,16,0,0,0
202223,VEPC02500E,SCUOLA SECONDARIA II GRADO,2,5,5,0,0,0
202223,NA1E06700Q,SCUOLA PRIMARIA,4,35,35,0,0,0
202223,TV1E019005,SCUOLA PRIMARIA,1,18,17,1,0,1
202223,GE1E02300P,SCUOLA PRIMARIA,2,26,20,6,0,6
202223,FR1E00600C,SCUOLA PRIMARIA,1,18,18,0,0,0
202223,MIPMU4500Z,SCUOLA SECONDARIA II GRADO,1,24,22,2,0,2
202223,BOPS525001,SCUOLA SECONDARIA II GRADO,4,32,31,1,0,1
202223,FRPM9Q500B,SCUOLA SECONDARIA II GRADO,3,1,1,0,0,0
202223,CERHZ85003,SCUOLA SECONDARIA II GRADO,1,6,5,1,0,1
202223,CERVEN500Q,SCUOLA SECONDARIA II GRADO,5,36,36,0,0,0
202223,LTTD595008,SCUOLA SECONDARIA II GRADO,5,51,47,4,4,0
202223,SATFUB5003,SCUOLA SECONDARIA II GRADO,4,3,2,1,1,0
202223,CE1E00600A,SCUOLA PRIMARIA,2,21,19,2,2,0
202223,VARFS2500Z,SCUOLA SECONDARIA II GRADO,2,9,9,0,0,0
202223,OR1E00100R,SCUOLA PRIMARIA,5,19,19,0,0,0
202223,CS1E00600D,SCUOLA PRIMARIA,4,17,17,0,0,0
202223,NARI11500A,SCUOLA SECONDARIA II GRADO,1,6,6,0,0,0
202223,TO1E020001,SCUOLA PRIMARIA,1,19,18,1,1,0
202223,LT1E01000Q,SCUOLA PRIMARIA,1,11,11,0,0,0
202223,AVPM03500Q,SCUOLA SECONDARIA II GRADO,5,19,19,0,0,0
202223,PAPC12500D,SCUOLA SECONDARIA II GRADO,5,32,32,0,0,0
202223,TOPLM6500B,SCUOLA SECONDARIA II GRADO,5,3,3,0,0,0
202223,RMPM08500E,SCUOLA SECONDARIA II GRADO,5,22,21,1,0,1
202223,NA1E11100L,SCUOLA PRIMARIA,4,1,1,0,0,0
202223,CE1M00600G,SCUOLA SECONDARIA I GRADO,2,55,54,1,1,0
202223,CEPSSR500Q,SCUOLA SECONDARIA II GRADO,1,9,9,0,0,0
202223,NA1E09700G,SCUOLA PRIMARIA,1,35,35,0,0,0
202223,NA1E09000R,SCUOLA PRIMARIA,4,29,29,0,0,0
202223,RM1M129002,SCUOLA SECONDARIA I GRADO,1,18,18,0,0,0
202223,CR1E00300E,SCUOLA PRIMARIA,1,34,31,3,1,2
202223,LI1M00300V,SCUOLA SECONDARIA I GRADO,2,18,17,1,1,0
202223,MNPS00500L,SCUOLA SECONDARIA II GRADO,4,24,24,0,0,0
202223,TPSD015003,SCUOLA SECONDARIA II GRADO,4,39,35,4,2,2
202223,MB1E037007,SCUOLA PRIMARIA,5,42,39,3,2,1
202223,AGTD00500C,SCUOLA SECONDARIA II GRADO,4,3,3,0,0,0
202223,GE1E00800L,SCUOLA PRIMARIA,2,7,7,0,0,0
202223,PEPC025003,SCUOLA SECONDARIA II GRADO,3,2,2,0,0,0
202223,SATDD75001,SCUOLA SECONDARIA II GRADO,3,5,5,0,0,0
202223,PAPC695004,SCUOLA SECONDARIA II GRADO,2,1,1,0,0,0
202223,MI1MMU500B,SCUOLA SECONDARIA I GRADO,1,54,51,3,1,2
202223,FIPL07500E,SCUOLA SECONDARIA II GRADO,5,5,4,1,1,0
202223,BO1E00800N,SCUOLA PRIMARIA,5,16,12,4,0,4
202223,NA1E149003,SCUOLA PRIMARIA,4,6,6,0,0,0
202223,MI1E09300P,SCUOLA PRIMARIA,4,10,8,2,2,0
202223,VRPQ02500E,SCUOLA SECONDARIA II GRADO,4,24,24,0,0,0
202223,RM1M07800A,SCUOLA SECONDARIA I GRADO,3,28,27,1,0,1
202223,NAPS3S500N,SCUOLA SECONDARIA II GRADO,1,15,15,0,0,0
202223,NAPS555009,SCUOLA SECONDARIA II GRADO,3,1,1,0,0,0
202223,RM1E180002,SCUOLA PRIMARIA,1,31,24,7,0,7
202223,CE1E05000C,SCUOLA PRIMARIA,5,29,26,3,0,3
202223,CTTD34500V,SCUOLA SECONDARIA II GRADO,5,31,30,1,1,0
202223,VTPSP5500E,SCUOLA SECONDARIA II GRADO,1,7,7,0,0,0
202223,CE1E028007,SCUOLA PRIMARIA,5,8,8,0,0,0
202223,FO1E00300T,SCUOLA PRIMARIA,1,10,9,1,0,1
202223,VATFGA500N,SCUOLA SECONDARIA II GRADO,3,8,7,1,0,1
202223,RM1E105008,SCUOLA PRIMARIA,4,15,14,1,0,1
202223,RMPL48500Q,SCUOLA SECONDARIA II GRADO,2,9,9,0,0,0
202223,RM1E11600P,SCUOLA PRIMARIA,3,10,10,0,0,0
202223,VRPS055005,SCUOLA SECONDARIA II GRADO,3,49,48,1,0,1
202223,MIPS20500T,SCUOLA SECONDARIA II GRADO,4,24,24,0,0,0
202223,VRPLHM500A,SCUOLA SECONDARIA II GRADO,3,22,20,2,0,2
202223,AV1E010005,SCUOLA PRIMARIA,5,26,26,0,0,0
202223,MB1M02400A,SCUOLA SECONDARIA I GRADO,3,77,71,6,2,4
202223,MIPSRF5008,SCUOLA SECONDARIA II GRADO,5,5,5,0,0,0
202223,RMSLVB5007,SCUOLA SECONDARIA II GRADO,1,10,9,1,1,0
202223,NA1E065004,SCUOLA PRIMARIA,5,10,9,1,0,1
202223,NO1M01100X,SCUOLA SECONDARIA I GRADO,3,110,102,8,0,8
202223,RG1E00600X,SCUOLA PRIMARIA,5,17,16,1,1,0
202223,PARI025001,SCUOLA SECONDARIA II GRADO,5,18,18,0,0,0
202223,VT1M00600E,SCUOLA SECONDARIA I GRADO,2,21,20,1,1,0
202223,TO1M01600E,SCUOLA SECONDARIA I GRADO,1,87,86,1,0,1
202223,BGPL04500P,SCUOLA SECONDARIA II GRADO,4,22,22,0,0,0
202223,VR1M013003,SCUOLA SECONDARIA I GRADO,2,80,78,2,0,2
202223,UD1MD8500H,SCUOLA SECONDARIA I GRADO,3,16,12,4,1,3
202223,SATL00500A,SCUOLA SECONDARIA II GRADO,2,4,4,0,0,0
202223,CB1E002007,SCUOLA PRIMARIA,1,21,19,2,2,0
202223,RMPM5R5008,SCUOLA SECONDARIA II GRADO,3,7,7,0,0,0
202223,NA1E28100Q,SCUOLA PRIMARIA,5,39,39,0,0,0
202223,FIPM69500H,SCUOLA SECONDARIA II GRADO,5,7,7,0,0,0
202223,FIPSZD500T,SCUOLA SECONDARIA II GRADO,2,7,7,0,0,0
202223,MI1E090007,SCUOLA PRIMARIA,1,10,8,2,0,2
202223,RC1E995002,SCUOLA PRIMARIA,3,1,1,0,0,0
202223,BG1E001001,SCUOLA PRIMARIA,4,46,44,2,0,2
202223,CA1M01500X,SCUOLA SECONDARIA I GRADO,3,21,21,0,0,0
202223,TO1E047001,SCUOLA PRIMARIA,1,25,14,11,3,8
202223,RM1E09500V,SCUOLA PRIMARIA,1,27,23,4,0,4
202223,AL1E6U500H,SCUOLA PRIMARIA,1,10,10,0,0,0
202223,VA1E01400G,SCUOLA PRIMARIA,4,14,14,0,0,0
202223,CT1M00700N,SCUOLA SECONDARIA I GRADO,3,14,14,0,0,0
202223,NA1E03400C,SCUOLA PRIMARIA,5,47,47,0,0,0
202223,VR1E020001,SCUOLA PRIMARIA,2,46,40,6,2,4
202223,CO1M01100G,SCUOLA SECONDARIA I GRADO,2,25,24,1,0,1
202223,RMPME45007,SCUOLA SECONDARIA II GRADO,1,5,5,0,0,0
202223,MIPL30500D,SCUOLA SECONDARIA II GRADO,1,11,10,1,0,1
202223,FIPLV0500F,SCUOLA SECONDARIA II GRADO,3,10,10,0,0,0
202223,MBRH00500P,SCUOLA SECONDARIA II GRADO,1,50,49,1,0,1
202223,BA1E02500C,SCUOLA PRIMARIA,3,13,13,0,0,0
202223,SAPLLV500D,SCUOLA SECONDARIA II GRADO,1,8,8,0,0,0
202223,MOPC005006,SCUOLA SECONDARIA II GRADO,1,4,4,0,0,0
202223,RA1M00300L,SCUOLA SECONDARIA I GRADO,3,14,13,1,1,0
202223,TO1E05800B,SCUOLA PRIMARIA,1,21,10,11,4,7
202223,RMTF285009,SCUOLA SECONDARIA II GRADO,5,59,58,1,1,0
202223,PDPS065002,SCUOLA SECONDARIA II GRADO,2,50,50,0,0,0
202223,PG1E00500A,SCUOLA PRIMARIA,4,18,18,0,0,0
202223,BGSLN6500G,SCUOLA SECONDARIA II GRADO,4,22,22,0,0,0
202223,VAPM04500D,SCUOLA SECONDARIA II GRADO,3,25,24,1,0,1
202223,SRTD08500V,SCUOLA SECONDARIA II GRADO,5,27,26,1,0,1
202223,BSPSTZ5004,SCUOLA SECONDARIA II GRADO,4,13,13,0,0,0
202223,BSPLLZ5006,SCUOLA SECONDARIA II GRADO,3,21,21,0,0,0
202223,MI1MA05006,SCUOLA SECONDARIA I GRADO,2,23,22,1,0,1
202223,MOPS02500E,SCUOLA SECONDARIA II GRADO,2,21,20,1,0,1
202223,SAPS09500G,SCUOLA SECONDARIA II GRADO,2,4,4,0,0,0
202223,TO1E00600P,SCUOLA PRIMARIA,1,15,14,1,0,1
202223,NA1E17400Q,SCUOLA PRIMARIA,4,22,22,0,0,0
202223,APPS9N5001,SCUOLA SECONDARIA II GRADO,5,30,30,0,0,0
202223,BGPS135006,SCUOLA SECONDARIA II GRADO,2,8,8,0,0,0
202223,BGRF2Q5004,SCUOLA SECONDARIA II GRADO,3,21,21,0,0,0
202223,SSTD00500D,SCUOLA SECONDARIA II GRADO,2,5,5,0,0,0
202223,RM1E15400D,SCUOLA PRIMARIA,2,8,7,1,0,1
202223,NATFIQ500E,SCUOLA SECONDARIA II GRADO,4,2,2,0,0,0
202223,GE1M02500G,SCUOLA SECONDARIA I GRADO,2,25,24,1,0,1
202223,NA1E12900T,SCUOLA PRIMARIA,3,12,12,0,0,0
202223,MIPSEA5006,SCUOLA SECONDARIA II GRADO,2,27,27,0,0,0
202223,MBPS28500G,SCUOLA SECONDARIA II GRADO,2,7,7,0,0,0
202223,RM1E171007,SCUOLA PRIMARIA,1,25,21,4,0,4
202223,PN1E002004,SCUOLA PRIMARIA,5,44,43,1,1,0
202223,SARHDF500N,SCUOLA SECONDARIA II GRADO,4,12,11,1,1,0
202223,MI1E01500D,SCUOLA PRIMARIA,3,32,24,8,1,7
202223,RE1E006009,SCUOLA PRIMARIA,4,14,13,1,1,0
202223,VR1E01000A,SCUOLA PRIMARIA,1,37,34,3,1,2
202223,PAPMUP500I,SCUOLA SECONDARIA II GRADO,3,8,8,0,0,0
202223,VA1MAR500M,SCUOLA SECONDARIA I GRADO,2,22,21,1,0,1
202223,NARH065003,SCUOLA SECONDARIA II GRADO,4,13,13,0,0,0
202223,FITF265001,SCUOLA SECONDARIA II GRADO,3,11,10,1,0,1
202223,BSPS06500N,SCUOLA SECONDARIA II GRADO,1,39,37,2,1,1
202223,BG1M00500D,SCUOLA SECONDARIA I GRADO,1,17,17,0,0,0
202223,CTPM345004,SCUOLA SECONDARIA II GRADO,4,8,8,0,0,0
202223,GE1M014005,SCUOLA SECONDARIA I GRADO,3,49,48,1,0,1
202223,RMSLZ35008,SCUOLA SECONDARIA II GRADO,1,4,3,1,0,1
202223,RMPSHQ500O,SCUOLA SECONDARIA II GRADO,2,26,23,3,1,2
202223,PI1E00200G,SCUOLA PRIMARIA,1,18,18,0,0,0
202223,MI1E003007,SCUOLA PRIMARIA,2,52,50,2,0,2
202223,RE1E002002,SCUOLA PRIMARIA,1,42,40,2,0,2
202223,GE1E026006,SCUOLA PRIMARIA,1,17,17,0,0,0
202223,VA1E010008,SCUOLA PRIMARIA,4,26,26,0,0,0
202223,SA1E01400N,SCUOLA PRIMARIA,4,21,21,0,0,0
202223,RM1M010004,SCUOLA SECONDARIA I GRADO,3,30,29,1,0,1
202223,LC1E00100D,SCUOLA PRIMARIA,5,20,19,1,1,0
202223,RM1E20200N,SCUOLA PRIMARIA,4,25,24,1,1,0
202223,PAPC00500B,SCUOLA SECONDARIA II GRADO,2,6,6,0,0,0
202223,PD1M006006,SCUOLA SECONDARIA I GRADO,2,30,29,1,1,0
202223,CTPS10500V,SCUOLA SECONDARIA II GRADO,1,2,2,0,0,0
202223,SATLGF500Z,SCUOLA SECONDARIA II GRADO,5,69,69,0,0,0
202223,GE1E03000T,SCUOLA PRIMARIA,5,21,21,0,0,0
202223,NATD51500C,SCUOLA SECONDARIA II GRADO,1,26,26,0,0,0
202223,BNPS3O5006,SCUOLA SECONDARIA II GRADO,5,68,65,3,0,3
202223,TPTDS9500A,SCUOLA SECONDARIA II GRADO,5,8,8,0,0,0
202223,VIPS3I500B,SCUOLA SECONDARIA II GRADO,1,38,36,2,0,2
202223,NAPMRM500O,SCUOLA SECONDARIA II GRADO,2,12,12,0,0,0
202223,CTTFOR5002,SCUOLA SECONDARIA II GRADO,1,2,2,0,0,0
202223,NA1E198008,SCUOLA PRIMARIA,4,13,12,1,0,1
202223,TVPS02500N,SCUOLA SECONDARIA II GRADO,5,23,23,0,0,0
202223,NA1E243001,SCUOLA PRIMARIA,3,10,10,0,0,0
202223,RM1E135004,SCUOLA PRIMARIA,3,14,13,1,0,1
202223,CZPM00500Q,SCUOLA SECONDARIA II GRADO,1,16,16,0,0,0
202223,BO1E00400A,SCUOLA PRIMARIA,4,22,21,1,0,1
202223,PVPS775003,SCUOLA SECONDARIA II GRADO,2,7,7,0,0,0
202223,NAPL19500R,SCUOLA SECONDARIA II GRADO,3,20,19,1,0,1
202223,TV1E00800P,SCUOLA PRIMARIA,2,26,22,4,2,2
202223,NAPMEF500M,SCUOLA SECONDARIA II GRADO,2,4,3,1,0,1
202223,FR1EZQ500N,SCUOLA PRIMARIA,5,6,5,1,0,1
202223,PATD00500A,SCUOLA SECONDARIA II GRADO,4,3,3,0,0,0
202223,NA1MT6500T,SCUOLA SECONDARIA I GRADO,1,7,4,3,0,3
202223,VB1E001004,SCUOLA PRIMARIA,4,17,17,0,0,0
202223,SATFPG500G,SCUOLA SECONDARIA II GRADO,2,7,7,0,0,0
202223,PATL9C5004,SCUOLA SECONDARIA II GRADO,5,9,9,0,0,0
202223,MI1E11900N,SCUOLA PRIMARIA,1,16,15,1,0,1
202223,TVTF015005,SCUOLA SECONDARIA II GRADO,3,16,15,1,0,1
202223,NA1E21500R,SCUOLA PRIMARIA,1,15,15,0,0,0
202223,VI1E00500E,SCUOLA PRIMARIA,2,34,33,1,0,1
202223,NA1E05900R,SCUOLA PRIMARIA,3,17,17,0,0,0
202223,SR1E005001,SCUOLA PRIMARIA,2,23,20,3,0,3
202223,NAPLIA500F,SCUOLA SECONDARIA II GRADO,4,5,5,0,0,0
202223,CE1E04000T,SCUOLA PRIMARIA,2,39,35,4,0,4
202223,RM1E00500B,SCUOLA PRIMARIA,4,25,24,1,0,1
202223,PO1E00700X,SCUOLA PRIMARIA,3,43,29,14,0,14
202223,CTTD145005,SCUOLA SECONDARIA II GRADO,1,2,2,0,0,0
202223,MITD25500P,SCUOLA SECONDARIA II GRADO,3,12,12,0,0,0
202223,NA1M00600D,SCUOLA SECONDARIA I GRADO,2,20,19,1,1,0
202223,FI1E001001,SCUOLA PRIMARIA,4,25,25,0,0,0
202223,BGPC02500G,SCUOLA SECONDARIA II GRADO,5,5,5,0,0,0
202223,PAPMB55005,SCUOLA SECONDARIA II GRADO,4,10,10,0,0,0
202223,TO1M7Q5005,SCUOLA SECONDARIA I GRADO,1,15,15,0,0,0
202223,APRFSQ500B,SCUOLA SECONDARIA II GRADO,4,1,1,0,0,0
202223,AR1E002001,SCUOLA PRIMARIA,5,9,9,0,0,0
202223,CEPS875001,SCUOLA SECONDARIA II GRADO,3,18,18,0,0,0
202223,RMTD49500B,SCUOLA SECONDARIA II GRADO,5,37,37,0,0,0
202223,RM1M110001,SCUOLA SECONDARIA I GRADO,3,16,11,5,0,5
202223,NA1E218008,SCUOLA PRIMARIA,5,13,13,0,0,0
202223,MI1E074009,SCUOLA PRIMARIA,2,27,27,0,0,0
202223,LO1M03000C,SCUOLA SECONDARIA I GRADO,3,31,29,2,0,2
202223,RM1E02900X,SCUOLA PRIMARIA,4,15,12,3,1,2
202223,RM1E044002,SCUOLA PRIMARIA,4,44,43,1,0,1
202223,SRPM475001,SCUOLA SECONDARIA II GRADO,2,9,9,0,0,0
202223,FI1E06100L,SCUOLA PRIMARIA,1,22,21,1,0,1
202223,PV1E008004,SCUOLA PRIMARIA,1,19,17,2,0,2
202223,SA1E01000A,SCUOLA PRIMARIA,4,13,13,0,0,0
202223,RNTD02500G,SCUOLA SECONDARIA II GRADO,1,4,3,1,0,1
202223,NARH25500E,SCUOLA SECONDARIA II GRADO,2,15,15,0,0,0
202223,PA1E04500Q,SCUOLA PRIMARIA,4,26,26,0,0,0
202223,PD1M00800T,SCUOLA SECONDARIA I GRADO,1,43,41,2,1,1
202223,PAPM25500A,SCUOLA SECONDARIA II GRADO,4,10,10,0,0,0
202223,BL1E00100G,SCUOLA PRIMARIA,1,27,27,0,0,0
202223,FG1E00300X,SCUOLA PRIMARIA,5,18,18,0,0,0
202223,NA1E128002,SCUOLA PRIMARIA,3,10,10,0,0,0
202223,NO1E00200X,SCUOLA PRIMARIA,1,37,36,1,0,1
202223,CA1E01500P,SCUOLA PRIMARIA,4,15,15,0,0,0
202223,TOTB005001,SCUOLA SECONDARIA II GRADO,3,10,7,3,3,0
202223,MI1M00700Q,SCUOLA SECONDARIA I GRADO,1,62,57,5,0,5
202223,TOPS955001,SCUOLA SECONDARIA II GRADO,2,4,4,0,0,0
202223,AGTDE45003,SCUOLA SECONDARIA II GRADO,3,8,8,0,0,0
202223,CE1E045001,SCUOLA PRIMARIA,5,14,14,0,0,0
202223,BO1E020008,SCUOLA PRIMARIA,4,44,41,3,0,3
202223,PV1E00500L,SCUOLA PRIMARIA,5,43,43,0,0,0
202223,BGSD01500E,SCUOLA SECONDARIA II GRADO,3,28,27,1,0,1
202223,RM1E15200T,SCUOLA PRIMARIA,2,15,13,2,2,0
202223,RMPSVA5006,SCUOLA SECONDARIA II GRADO,2,57,52,5,0,5
202223,RM1E11800A,SCUOLA PRIMARIA,4,24,22,2,0,2
202223,BL1M00200L,SCUOLA SECONDARIA I GRADO,2,43,42,1,1,0
202223,NA1E10900L,SCUOLA PRIMARIA,4,13,12,1,1,0
202223,RM1M14800B,SCUOLA SECONDARIA I GRADO,2,18,17,1,0,1
202223,GEPS04500R,SCUOLA SECONDARIA II GRADO,5,24,24,0,0,0
202223,RM1M05000E,SCUOLA SECONDARIA I GRADO,3,34,34,0,0,0
202223,MI1E04200T,SCUOLA PRIMARIA,5,45,44,1,0,1
202223,NATLSN5005,SCUOLA SECONDARIA II GRADO,5,105,101,4,0,4
202223,CLSD00500B,SCUOLA SECONDARIA II GRADO,2,24,22,2,1,1
202223,MI1E132004,SCUOLA PRIMARIA,3,11,11,0,0,0
202223,SARFTV500I,SCUOLA SECONDARIA II GRADO,5,65,56,9,1,8
202223,RMTND1500F,SCUOLA SECONDARIA II GRADO,3,6,5,1,0,1
202223,NAPSP25001,SCUOLA SECONDARIA II GRADO,2,5,5,0,0,0
202223,LCTL02500D,SCUOLA SECONDARIA II GRADO,4,1,1,0,0,0
202223,TV1E00400B,SCUOLA PRIMARIA,2,46,46,0,0,0
202223,BS1E02200E,SCUOLA PRIMARIA,5,41,37,4,0,4
202223,PR1E001004,SCUOLA PRIMARIA,4,50,50,0,0,0
202223,PR1E007003,SCUOLA PRIMARIA,5,22,22,0,0,0
202223,NATF6G5004,SCUOLA SECONDARIA II GRADO,5,105,98,7,4,3
202223,NA1E23200E,SCUOLA PRIMARIA,4,10,10,0,0,0
202223,UDPS01500B,SCUOLA SECONDARIA II GRADO,1,15,13,2,1,1
202223,CSTN015007,SCUOLA SECONDARIA II GRADO,5,12,11,1,0,1
202223,NAPS355009,SCUOLA SECONDARIA II GRADO,2,13,13,0,0,0
202223,MBPS1Q500V,SCUOLA SECONDARIA II GRADO,3,21,20,1,1,0
202223,MI1E12600R,SCUOLA PRIMARIA,2,74,72,2,0,2
202223,LCPMEE500S,SCUOLA SECONDARIA II GRADO,4,25,25,0,0,0
202223,RM1E06200G,SCUOLA PRIMARIA,4,16,16,0,0,0
202223,PO1E01700E,SCUOLA PRIMARIA,4,19,13,6,0,6
202223,PR1E01000V,SCUOLA PRIMARIA,1,38,36,2,1,1
202223,SATFRP500A,SCUOLA SECONDARIA II GRADO,2,7,7,0,0,0
202223,MI1E083004,SCUOLA PRIMARIA,5,51,49,2,1,1
202223,NOPL6T5005,SCUOLA SECONDARIA II GRADO,5,14,14,0,0,0
202223,SAPMDN500T,SCUOLA SECONDARIA II GRADO,5,9,9,0,0,0
202223,MO1M005009,SCUOLA SECONDARIA I GRADO,1,74,74,0,0,0
202223,PGRF8G5009,SCUOLA SECONDARIA II GRADO,3,7,5,2,1,1
202223,NA1E06700Q,SCUOLA PRIMARIA,1,45,44,1,0,1
202223,TO1E053008,SCUOLA PRIMARIA,2,31,29,2,2,0
202223,NOPC05500E,SCUOLA SECONDARIA II GRADO,4,56,56,0,0,0
202223,PT1M00200Q,SCUOLA SECONDARIA I GRADO,2,27,25,2,0,2
202223,FI1M015004,SCUOLA SECONDARIA I GRADO,3,18,17,1,0,1
202223,BOPSPI500D,SCUOLA SECONDARIA II GRADO,1,28,28,0,0,0
202223,LT1E00300L,SCUOLA PRIMARIA,4,27,27,0,0,0
202223,SS1E01100Q,SCUOLA PRIMARIA,1,10,10,0,0,0
202223,NA1E022006,SCUOLA PRIMARIA,4,35,35,0,0,0
202223,VR1M026005,SCUOLA SECONDARIA I GRADO,3,40,35,5,1,4
202223,CN1M001008,SCUOLA SECONDARIA I GRADO,3,30,29,1,0,1
202223,BNPC015006,SCUOLA SECONDARIA II GRADO,3,6,6,0,0,0
202223,SAPM3S500H,SCUOLA SECONDARIA II GRADO,5,67,65,2,0,2
202223,MO1E00600X,SCUOLA PRIMARIA,1,14,10,4,0,4
202223,LIPL01500X,SCUOLA SECONDARIA II GRADO,1,5,4,1,0,1
202223,RMPS8Q500R,SCUOLA SECONDARIA II GRADO,5,27,26,1,0,1
202223,RMPS555002,SCUOLA SECONDARIA II GRADO,4,24,24,0,0,0
202223,TO1E07500P,SCUOLA PRIMARIA,1,31,29,2,0,2
202223,TO1E04900L,SCUOLA PRIMARIA,3,44,44,0,0,0
202223,PSTF005006,SCUOLA SECONDARIA II GRADO,5,31,30,1,0,1
202223,FI1E03300C,SCUOLA PRIMARIA,2,15,15,0,0,0
202223,NA1E01200G,SCUOLA PRIMARIA,4,14,14,0,0,0
202223,BOPS3D500P,SCUOLA SECONDARIA II GRADO,2,9,9,0,0,0
202223,SATD9L5009,SCUOLA SECONDARIA II GRADO,5,30,30,0,0,0
202223,BS1M013001,SCUOLA SECONDARIA I GRADO,2,71,70,1,1,0
202223,RMPC44500B,SCUOLA SECONDARIA II GRADO,4,20,20,0,0,0
202223,BSPMN8500Q,SCUOLA SECONDARIA II GRADO,2,19,18,1,1,0
202223,MIPC005001,SCUOLA SECONDARIA II GRADO,5,19,19,0,0,0
202223,RM1E130001,SCUOLA PRIMARIA,5,19,15,4,1,3
202223,MIPL125001,SCUOLA SECONDARIA II GRADO,3,200,189,11,2,9
202223,PATDCH5009,SCUOLA SECONDARIA II GRADO,5,7,7,0,0,0
202223,PC1E00300V,SCUOLA PRIMARIA,5,22,20,2,0,2
202223,PCTD015006,SCUOLA SECONDARIA II GRADO,4,11,8,3,0,3
202223,UD1E001008,SCUOLA PRIMARIA,2,16,16,0,0,0
202223,NATNHS5003,SCUOLA SECONDARIA II GRADO,4,10,10,0,0,0
202223,TATF035003,SCUOLA SECONDARIA II GRADO,5,52,52,0,0,0
202223,RA1E00200G,SCUOLA PRIMARIA,1,29,26,3,0,3
202223,MI1M00100R,SCUOLA SECONDARIA I GRADO,3,81,81,0,0,0
202223,NA1E07600E,SCUOLA PRIMARIA,1,37,36,1,0,1
202223,TO1E054004,SCUOLA PRIMARIA,5,17,16,1,0,1
202223,CE1E05400Q,SCUOLA PRIMARIA,3,17,17,0,0,0
202223,VA1M01500L,SCUOLA SECONDARIA I GRADO,3,68,67,1,0,1
202223,TARF2M500U,SCUOLA SECONDARIA II GRADO,5,26,26,0,0,0
202223,RM1E056008,SCUOLA PRIMARIA,1,22,22,0,0,0
202223,CETF6B500H,SCUOLA SECONDARIA II GRADO,2,9,9,0,0,0
202223,MISL075007,SCUOLA SECONDARIA II GRADO,2,56,56,0,0,0
202223,BS1M02200Q,SCUOLA SECONDARIA I GRADO,3,20,20,0,0,0
202223,VAPMV0500Q,SCUOLA SECONDARIA II GRADO,2,20,20,0,0,0
202223,MI1MIN5009,SCUOLA SECONDARIA I GRADO,1,50,47,3,1,2
202223,PATFCO500Z,SCUOLA SECONDARIA II GRADO,1,2,2,0,0,0
202223,RM1M079006,SCUOLA SECONDARIA I GRADO,3,49,48,1,0,1
202223,BG1E027005,SCUOLA PRIMARIA,3,15,15,0,0,0
202223,ATPS715002,SCUOLA SECONDARIA II GRADO,4,7,7,0,0,0
202223,GEPS70500C,SCUOLA SECONDARIA II GRADO,3,47,47,0,0,0
202223,RMTB00500D,SCUOLA SECONDARIA II GRADO,2,12,10,2,2,0
202223,MB1M02900D,SCUOLA SECONDARIA I GRADO,3,33,33,0,0,0
202223,RMPS165005,SCUOLA SECONDARIA II GRADO,4,16,16,0,0,0
202223,TO1E00800A,SCUOLA PRIMARIA,1,11,11,0,0,0
202223,PGPS00500G,SCUOLA SECONDARIA II GRADO,4,19,16,3,1,2
202223,PVTL025009,SCUOLA SECONDARIA II GRADO,5,17,16,1,0,1
202223,NA1E058001,SCUOLA PRIMARIA,4,15,15,0,0,0
202223,RE1M00600E,SCUOLA SECONDARIA I GRADO,3,42,40,2,1,1
202223,REPSQE5008,SCUOLA SECONDARIA II GRADO,2,12,12,0,0,0
202223,PAPS8N500C,SCUOLA SECONDARIA II GRADO,3,15,15,0,0,0
202223,RM1E00800V,SCUOLA PRIMARIA,1,13,13,0,0,0
202223,CETF01500C,SCUOLA SECONDARIA II GRADO,2,21,21,0,0,0
202223,LUPL01500A,SCUOLA SECONDARIA II GRADO,3,7,5,2,1,1
202223,TO1M03200C,SCUOLA SECONDARIA I GRADO,2,59,59,0,0,0
202223,SATLO6500Z,SCUOLA SECONDARIA II GRADO,3,2,2,0,0,0
202223,CO1E01000E,SCUOLA PRIMARIA,3,24,24,0,0,0
202223,NATF37500L,SCUOLA SECONDARIA II GRADO,5,69,68,1,1,0
202223,CAPS8T5007,SCUOLA SECONDARIA II GRADO,1,9,9,0,0,0
202223,MO1E00300C,SCUOLA PRIMARIA,4,55,51,4,0,4
202223,BG1E01000Q,SCUOLA PRIMARIA,5,21,21,0,0,0
202223,RM1E09700E,SCUOLA PRIMARIA,5,52,51,1,0,1
202223,AGTL4P500L,SCUOLA SECONDARIA II GRADO,5,8,8,0,0,0
202223,VA1E02200E,SCUOLA PRIMARIA,2,38,38,0,0,0
202223,NA1E20300E,SCUOLA PRIMARIA,1,18,18,0,0,0
202223,RM1E05300R,SCUOLA PRIMARIA,3,21,20,1,1,0
202223,VE1M001005,SCUOLA SECONDARIA I GRADO,3,12,12,0,0,0
202223,TO1M042003,SCUOLA SECONDARIA I GRADO,1,27,27,0,0,0
202223,CTPL00500R,SCUOLA SECONDARIA II GRADO,2,5,5,0,0,0
202223,BSPLLZ5006,SCUOLA SECONDARIA II GRADO,4,22,21,1,0,1
202223,CO1E01400T,SCUOLA PRIMARIA,2,47,46,1,0,1
202223,RC1E01100G,SCUOLA PRIMARIA,3,10,6,4,2,2
202223,VARF5F500H,SCUOLA SECONDARIA II GRADO,2,7,6,1,0,1
202223,RMRFB3500L,SCUOLA SECONDARIA II GRADO,5,29,23,6,0,6
202223,FIPSFU500L,SCUOLA SECONDARIA II GRADO,5,5,5,0,0,0
202223,RMPSPG500N,SCUOLA SECONDARIA II GRADO,3,11,11,0,0,0
202223,NATD9F500E,SCUOLA SECONDARIA II GRADO,3,4,4,0,0,0
202223,CE1EO0500I,SCUOLA PRIMARIA,3,20,20,0,0,0
202223,RCPC02500G,SCUOLA SECONDARIA II GRADO,2,11,11,0,0,0
202223,NA1E100006,SCUOLA PRIMARIA,4,28,25,3,0,3
202223,MN1E001004,SCUOLA PRIMARIA,1,10,7,3,1,2
202223,NA1E194001,SCUOLA PRIMARIA,3,18,18,0,0,0
202223,NAPSP85001,SCUOLA SECONDARIA II GRADO,5,4,3,1,0,1
202223,SP1E00500Q,SCUOLA PRIMARIA,5,24,23,1,0,1
202223,MIPM06500R,SCUOLA SECONDARIA II GRADO,2,7,7,0,0,0
202223,SATF02500B,SCUOLA SECONDARIA II GRADO,1,3,3,0,0,0
202223,MESL0P500H,SCUOLA SECONDARIA II GRADO,5,2,1,1,0,1
202223,RM1E10800Q,SCUOLA PRIMARIA,5,29,27,2,0,2
202223,MIPL335009,SCUOLA SECONDARIA II GRADO,3,24,21,3,0,3
202223,VATD12500X,SCUOLA SECONDARIA II GRADO,3,22,21,1,0,1
202223,PD1E004009,SCUOLA PRIMARIA,4,20,18,2,2,0
202223,NA1E09800B,SCUOLA PRIMARIA,3,10,10,0,0,0
202223,RM1M13300N,SCUOLA SECONDARIA I GRADO,1,41,40,1,0,1
202223,MBPS23500E,SCUOLA SECONDARIA II GRADO,5,12,12,0,0,0
202223,CLTD9T500A,SCUOLA SECONDARIA II GRADO,5,24,24,0,0,0
202223,NA1E17900V,SCUOLA PRIMARIA,1,13,13,0,0,0
202223,NA1E17000C,SCUOLA PRIMARIA,4,20,18,2,0,2
202223,MB1E04900D,SCUOLA PRIMARIA,4,42,37,5,1,4
202223,FRPSII500H,SCUOLA SECONDARIA II GRADO,3,17,17,0,0,0
202223,FITD01500X,SCUOLA SECONDARIA II GRADO,1,8,6,2,0,2
202223,IM1E00500L,SCUOLA PRIMARIA,1,14,13,1,0,1
202223,PR1E00400G,SCUOLA PRIMARIA,3,34,29,5,1,4
202223,TOPS07500A,SCUOLA SECONDARIA II GRADO,1,27,26,1,0,1
202223,PD1E00800L,SCUOLA PRIMARIA,5,22,21,1,1,0
202223,RMTD58500N,SCUOLA SECONDARIA II GRADO,5,65,62,3,1,2
202223,RM1M02700D,SCUOLA SECONDARIA I GRADO,2,35,31,4,1,3
202223,RM1E193004,SCUOLA PRIMARIA,5,50,49,1,1,0
202223,NA1E23100P,SCUOLA PRIMARIA,1,14,14,0,0,0
202223,MI1M09500G,SCUOLA SECONDARIA I GRADO,3,82,80,2,2,0
202223,NATD27500D,SCUOLA SECONDARIA II GRADO,2,10,10,0,0,0
202223,MBPMZF5000,SCUOLA SECONDARIA II GRADO,3,6,5,1,1,0
202223,PVPL02500T,SCUOLA SECONDARIA II GRADO,3,6,6,0,0,0
202223,NATD305004,SCUOLA SECONDARIA II GRADO,4,5,5,0,0,0
202223,MI1M069003,SCUOLA SECONDARIA I GRADO,3,51,50,1,0,1
202223,MI1E137007,SCUOLA PRIMARIA,2,10,9,1,0,1
202223,SARHTF500G,SCUOLA SECONDARIA II GRADO,4,9,9,0,0,0
202223,MI1E016009,SCUOLA PRIMARIA,3,28,27,1,0,1
202223,SO1E00100E,SCUOLA PRIMARIA,3,13,13,0,0,0
202223,TV1E01000P,SCUOLA PRIMARIA,3,43,39,4,4,0
202223,VR1E017005,SCUOLA PRIMARIA,2,17,17,0,0,0
202223,BGPM15500V,SCUOLA SECONDARIA II GRADO,2,6,6,0,0,0
202223,BGPS00500D,SCUOLA SECONDARIA II GRADO,3,20,20,0,0,0
202223,COPL01500N,SCUOLA SECONDARIA II GRADO,5,12,12,0,0,0
202223,BNTDOO5001,SCUOLA SECONDARIA II GRADO,4,3,3,0,0,0
202223,RMTD70500E,SCUOLA SECONDARIA II GRADO,1,14,12,2,0,2
202223,BR1E00200T,SCUOLA PRIMARIA,4,18,18,0,0,0
202223,RM1M08900R,SCUOLA SECONDARIA I GRADO,3,25,25,0,0,0
202223,RM1E19600G,SCUOLA PRIMARIA,1,13,12,1,1,0
202223,RM1E022005,SCUOLA PRIMARIA,3,10,8,2,0,2
202223,RMPS46500Q,SCUOLA SECONDARIA II GRADO,2,10,7,3,0,3
202223,AGSL015004,SCUOLA SECONDARIA II GRADO,4,5,5,0,0,0
202223,CSPSDO500P,SCUOLA SECONDARIA II GRADO,5,8,8,0,0,0
202223,PTPS3N5004,SCUOLA SECONDARIA II GRADO,5,29,28,1,1,0
202223,GE1E012008,SCUOLA PRIMARIA,1,19,19,0,0,0
202223,GE1E020007,SCUOLA PRIMARIA,1,29,28,1,1,0
202223,AN1E00500L,SCUOLA PRIMARIA,2,1,1,0,0,0
202223,NARFV15001,SCUOLA SECONDARIA II GRADO,1,14,14,0,0,0
202223,NA1E029001,SCUOLA PRIMARIA,4,20,20,0,0,0
202223,MI1E08000L,SCUOLA PRIMARIA,4,14,12,2,0,2
202223,CTPM315008,SCUOLA SECONDARIA II GRADO,2,5,5,0,0,0
202223,PDPM00500B,SCUOLA SECONDARIA II GRADO,5,50,50,0,0,0
202223,NATD5N500Q,SCUOLA SECONDARIA II GRADO,3,3,3,0,0,0
202223,BN1ES9500O,SCUOLA PRIMARIA,2,10,10,0,0,0
202223,NA1E121007,SCUOLA PRIMARIA,2,17,17,0,0,0
202223,RMPSIZ500B,SCUOLA SECONDARIA II GRADO,2,14,14,0,0,0
202223,RM1MMF500S,SCUOLA SECONDARIA I GRADO,1,61,61,0,0,0
202223,BSSLVV500P,SCUOLA SECONDARIA II GRADO,2,13,13,0,0,0
202223,RM1E01600T,SCUOLA PRIMARIA,4,12,11,1,0,1
202223,CA1M01200C,SCUOLA SECONDARIA I GRADO,2,60,59,1,0,1
202223,RM1E03100X,SCUOLA PRIMARIA,4,10,10,0,0,0
202223,RN1E00400D,SCUOLA PRIMARIA,4,50,50,0,0,0
202223,NA1E01900A,SCUOLA PRIMARIA,3,18,18,0,0,0
202223,CE1E066002,SCUOLA PRIMARIA,1,11,11,0,0,0
202223,CTTF005004,SCUOLA SECONDARIA II GRADO,2,4,4,0,0,0
202223,TVPL08500G,SCUOLA SECONDARIA II GRADO,4,23,23,0,0,0
202223,RM1E121006,SCUOLA PRIMARIA,3,35,35,0,0,0
202223,AVTFVM500N,SCUOLA SECONDARIA II GRADO,3,8,8,0,0,0
202223,ENTDID500H,SCUOLA SECONDARIA II GRADO,4,1,0,1,0,1
202223,NA1E13800L,SCUOLA PRIMARIA,5,13,12,1,0,1
202223,TOPL11500A,SCUOLA SECONDARIA II GRADO,1,17,17,0,0,0
202223,RMPSPN500P,SCUOLA SECONDARIA II GRADO,1,25,25,0,0,0
202223,NA1E11700G,SCUOLA PRIMARIA,3,25,25,0,0,0
202223,RMPC05500E,SCUOLA SECONDARIA II GRADO,5,9,9,0,0,0
202223,RM1M04900A,SCUOLA SECONDARIA I GRADO,1,19,18,1,0,1
202223,CEPL00500E,SCUOLA SECONDARIA II GRADO,1,7,7,0,0,0
202223,MI1E024008,SCUOLA PRIMARIA,5,24,23,1,0,1
202223,RM1MZ7500R,SCUOLA SECONDARIA I GRADO,2,10,8,2,1,1
202223,MIPSQ55000,SCUOLA SECONDARIA II GRADO,5,18,18,0,0,0
202223,MOTD02500A,SCUOLA SECONDARIA II GRADO,4,23,23,0,0,0
202223,NO1E00300Q,SCUOLA PRIMARIA,1,52,52,0,0,0
202223,BSTF4M5001,SCUOLA SECONDARIA II GRADO,3,6,5,1,1,0
202223,RM1E01800D,SCUOLA PRIMARIA,5,10,9,1,0,1
202223,SARF17500D,SCUOLA SECONDARIA II GRADO,3,10,10,0,0,0
202223,LE1M00300G,SCUOLA SECONDARIA I GRADO,3,21,20,1,0,1
202223,VITB15500E,SCUOLA SECONDARIA II GRADO,1,15,14,1,0,1
202223,RMPCAM500U,SCUOLA SECONDARIA II GRADO,1,3,3,0,0,0
202223,PAPSVD500Q,SCUOLA SECONDARIA II GRADO,2,9,7,2,0,2
202223,CTTFQT500Q,SCUOLA SECONDARIA II GRADO,1,1,1,0,0,0
202223,TA1E00500X,SCUOLA PRIMARIA,5,19,17,2,1,1
202223,PO1E00700X,SCUOLA PRIMARIA,4,32,19,13,0,13
202223,MESD01500T,SCUOLA SECONDARIA II GRADO,5,23,23,0,0,0
202223,PS1E003007,SCUOLA PRIMARIA,2,21,19,2,2,0
202223,UD1M003005,SCUOLA SECONDARIA I GRADO,1,26,26,0,0,0
202223,UD1E00400Q,SCUOLA PRIMARIA,3,17,16,1,1,0
202223,MI1E12100N,SCUOLA PRIMARIA,3,46,42,4,1,3
202223,MIPS415006,SCUOLA SECONDARIA II GRADO,3,11,9,2,0,2
202223,NAPS5P500P,SCUOLA SECONDARIA II GRADO,1,2,2,0,0,0
202223,NATL95500B,SCUOLA SECONDARIA II GRADO,4,4,4,0,0,0
202223,NA1E06200L,SCUOLA PRIMARIA,1,50,50,0,0,0
202223,RN1E006005,SCUOLA PRIMARIA,2,18,17,1,0,1
202223,LCRF085005,SCUOLA SECONDARIA II GRADO,4,18,17,1,0,1
202223,CE1E036006,SCUOLA PRIMARIA,3,12,9,3,0,3
202223,RI1E00100D,SCUOLA PRIMARIA,4,12,12,0,0,0
202223,BGPSAF500M,SCUOLA SECONDARIA II GRADO,2,12,12,0,0,0
202223,MIPSVC500V,SCUOLA SECONDARIA II GRADO,5,23,23,0,0,0
202223,NA1EAN500C,SCUOLA PRIMARIA,5,19,18,1,0,1
202223,RM1E198007,SCUOLA PRIMARIA,5,33,33,0,0,0
202223,GE1ELE500C,SCUOLA PRIMARIA,3,6,6,0,0,0
202223,ARPM015009,SCUOLA SECONDARIA II GRADO,2,26,26,0,0,0
202223,MIPS16500L,SCUOLA SECONDARIA II GRADO,3,77,77,0,0,0
202223,RMPS655007,SCUOLA SECONDARIA II GRADO,1,2,2,0,0,0
202223,PO1E00200R,SCUOLA PRIMARIA,3,17,14,3,0,3
202223,FI1E030001,SCUOLA PRIMARIA,5,10,10,0,0,0
202223,SRPL005001,SCUOLA SECONDARIA II GRADO,2,5,5,0,0,0
202223,FI1M010001,SCUOLA SECONDARIA I GRADO,3,28,24,4,0,4
202223,PV1E00600C,SCUOLA PRIMARIA,1,13,6,7,0,7
202223,BOTF2S5000,SCUOLA SECONDARIA II GRADO,1,51,46,5,1,4
202223,RO1M00300G,SCUOLA SECONDARIA I GRADO,2,18,18,0,0,0
202223,CTRHMM500U,SCUOLA SECONDARIA II GRADO,3,11,11,0,0,0
202223,VE1E01200A,SCUOLA PRIMARIA,5,19,19,0,0,0
202223,PD1E076018,SCUOLA PRIMARIA,2,18,18,0,0,0
202223,VA1E00100D,SCUOLA PRIMARIA,5,40,37,3,0,3
202223,TV1M01100Q,SCUOLA SECONDARIA I GRADO,2,101,100,1,1,0
202223,NATDNH500U,SCUOLA SECONDARIA II GRADO,5,43,41,2,0,2
202223,GE1E03600R,SCUOLA PRIMARIA,4,21,20,1,0,1
202223,NA1E25400B,SCUOLA PRIMARIA,2,18,18,0,0,0
202223,CE1E00300V,SCUOLA PRIMARIA,5,18,18,0,0,0
202223,BGTFF0500O,SCUOLA SECONDARIA II GRADO,3,22,21,1,0,1
202223,FG1E01300E,SCUOLA PRIMARIA,2,16,16,0,0,0
202223,NOPS03500C,SCUOLA SECONDARIA II GRADO,3,44,44,0,0,0
202223,BA1E00300G,SCUOLA PRIMARIA,1,27,27,0,0,0
202223,MN1E00300Q,SCUOLA PRIMARIA,5,32,31,1,1,0
202223,LO1E00300V,SCUOLA PRIMARIA,1,22,21,1,1,0
202223,CA1E013003,SCUOLA PRIMARIA,4,30,30,0,0,0
202223,NA1E199004,SCUOLA PRIMARIA,5,10,10,0,0,0
202223,VI1E01300D,SCUOLA PRIMARIA,5,26,25,1,1,0
202223,RM1ERP500L,SCUOLA PRIMARIA,3,14,13,1,0,1
202223,TVPS57500F,SCUOLA SECONDARIA II GRADO,5,38,38,0,0,0
202223,TVPC035005,SCUOLA SECONDARIA II GRADO,4,8,8,0,0,0
202223,TOPS19500C,SCUOLA SECONDARIA II GRADO,5,21,21,0,0,0
202223,RMPC26500V,SCUOLA SECONDARIA II GRADO,2,25,25,0,0,0
202223,RM1E156005,SCUOLA PRIMARIA,3,4,3,1,0,1
202223,CORA025003,SCUOLA SECONDARIA II GRADO,4,12,11,1,0,1
202223,CORF8L5003,SCUOLA SECONDARIA II GRADO,4,7,4,3,0,3
202223,NA1E23200E,SCUOLA PRIMARIA,5,10,10,0,0,0
202223,RM1E142007,SCUOLA PRIMARIA,3,53,52,1,0,1
202223,TOPS005004,SCUOLA SECONDARIA II GRADO,1,24,24,0,0,0
202223,MIPLMC5009,SCUOLA SECONDARIA II GRADO,3,7,6,1,0,1
202223,FG1E022009,SCUOLA PRIMARIA,1,33,33,0,0,0
202223,SATF5M500Z,SCUOLA SECONDARIA II GRADO,5,38,38,0,0,0
202223,MI1E03100B,SCUOLA PRIMARIA,4,62,59,3,0,3
202223,TVPSIL5006,SCUOLA SECONDARIA II GRADO,3,20,20,0,0,0
202223,NATHCU5009,SCUOLA SECONDARIA II GRADO,5,20,19,1,0,1
202223,PVPLHO500H,SCUOLA SECONDARIA II GRADO,3,7,6,1,0,1
202223,AP1M001005,SCUOLA SECONDARIA I GRADO,2,19,19,0,0,0
202223,SARHGU5003,SCUOLA SECONDARIA II GRADO,1,3,2,1,1,0
202223,NAPL00500C,SCUOLA SECONDARIA II GRADO,4,10,10,0,0,0
202223,RMTF145002,SCUOLA SECONDARIA II GRADO,4,11,11,0,0,0
202223,NAPM31500X,SCUOLA SECONDARIA II GRADO,4,3,2,1,0,1
202223,PEPC8E500U,SCUOLA SECONDARIA II GRADO,3,10,10,0,0,0
202223,VA1MUI500S,SCUOLA SECONDARIA I GRADO,2,2,2,0,0,0
202223,RM1E01300A,SCUOLA PRIMARIA,1,13,13,0,0,0
202223,NA1M059002,SCUOLA SECONDARIA I GRADO,3,6,6,0,0,0
202223,BSPSL9500N,SCUOLA SECONDARIA II GRADO,1,24,24,0,0,0
202223,VE1E00100X,SCUOLA PRIMARIA,2,25,24,1,1,0
202223,FI1E01700E,SCUOLA PRIMARIA,5,40,38,2,0,2
202223,COPSTL500E,SCUOLA SECONDARIA II GRADO,4,11,11,0,0,0
202223,NA1E23600T,SCUOLA PRIMARIA,1,16,16,0,0,0
202223,VRPSI5500C,SCUOLA SECONDARIA II GRADO,2,28,27,1,1,0
202223,CSTDIB500Z,SCUOLA SECONDARIA II GRADO,5,25,24,1,0,1
202223,PA1E014004,SCUOLA PRIMARIA,2,85,85,0,0,0
202223,GEPL01500Q,SCUOLA SECONDARIA II GRADO,3,138,132,6,0,6
202223,RMPS235006,SCUOLA SECONDARIA II GRADO,3,24,24,0,0,0
202223,PV1M00600N,SCUOLA SECONDARIA I GRADO,3,50,47,3,1,2
202223,APPC0Q500G,SCUOLA SECONDARIA II GRADO,4,7,7,0,0,0
202223,TO1E00100G,SCUOLA PRIMARIA,2,47,47,0,0,0
202223,LCRC4F500Q,SCUOLA SECONDARIA II GRADO,1,8,5,3,0,3
202223,FRTD00500N,SCUOLA SECONDARIA II GRADO,4,5,4,1,1,0
202223,VA1M01900X,SCUOLA SECONDARIA I GRADO,3,16,16,0,0,0
202223,BSRF06500X,SCUOLA SECONDARIA II GRADO,5,23,22,1,1,0
202223,PDPS035006,SCUOLA SECONDARIA II GRADO,4,30,30,0,0,0
202223,SATFH5500B,SCUOLA SECONDARIA II GRADO,1,4,4,0,0,0
202223,MI1E07900C,SCUOLA PRIMARIA,4,22,21,1,0,1
202223,TO1E02100R,SCUOLA PRIMARIA,5,50,48,2,2,0
202223,RM1E07000E,SCUOLA PRIMARIA,1,31,29,2,1,1
202223,BO1M00800V,SCUOLA SECONDARIA I GRADO,2,22,19,3,1,2
202223,FO1M00600E,SCUOLA SECONDARIA I GRADO,3,49,47,2,0,2
202223,BOPS525001,SCUOLA SECONDARIA II GRADO,2,26,26,0,0,0
202223,MIPS09500G,SCUOLA SECONDARIA II GRADO,3,56,54,2,0,2
202223,PAPS10500B,SCUOLA SECONDARIA II GRADO,5,12,12,0,0,0
202223,NARFRT500R,SCUOLA SECONDARIA II GRADO,1,4,4,0,0,0
202223,SATD4U500A,SCUOLA SECONDARIA II GRADO,1,10,10,0,0,0
202223,BG1M01200L,SCUOLA SECONDARIA I GRADO,2,59,59,0,0,0
202223,CTPM415005,SCUOLA SECONDARIA II GRADO,3,2,2,0,0,0
202223,FE1E00100N,SCUOLA PRIMARIA,4,43,27,16,3,13
202223,VASLQ8500T,SCUOLA SECONDARIA II GRADO,4,14,11,3,0,3
202223,BN1E001006,SCUOLA PRIMARIA,4,41,38,3,1,2
202223,NA1E12600A,SCUOLA PRIMARIA,4,10,10,0,0,0
202223,MCPL0P500L,SCUOLA SECONDARIA II GRADO,5,21,20,1,0,1
202223,VAPSE5500O,SCUOLA SECONDARIA II GRADO,1,20,19,1,1,0
202223,NA1E09200C,SCUOLA PRIMARIA,3,19,19,0,0,0
202223,RCTDO0500U,SCUOLA SECONDARIA II GRADO,5,25,23,2,0,2
202223,BATD01500V,SCUOLA SECONDARIA II GRADO,1,4,4,0,0,0
202223,TO1E054004,SCUOLA PRIMARIA,4,15,15,0,0,0
202223,FI1E026009,SCUOLA PRIMARIA,5,25,23,2,0,2
202223,RM1E100005,SCUOLA PRIMARIA,2,20,19,1,0,1
202223,ME1E00300X,SCUOLA PRIMARIA,2,21,21,0,0,0
202223,SATDG0500E,SCUOLA SECONDARIA II GRADO,4,17,17,0,0,0
202223,GRPS005002,SCUOLA SECONDARIA II GRADO,5,10,10,0,0,0
202223,PA1E4O500T,SCUOLA PRIMARIA,1,18,17,1,0,1
202223,PAPC12500D,SCUOLA SECONDARIA II GRADO,4,53,53,0,0,0
202223,AVTFTA500S,SCUOLA SECONDARIA II GRADO,3,6,6,0,0,0
202223,PATFCO500Z,SCUOLA SECONDARIA II GRADO,2,3,3,0,0,0
202223,TOPL66500H,SCUOLA SECONDARIA II GRADO,2,21,18,3,0,3
202223,PD1E00200N,SCUOLA PRIMARIA,5,23,21,2,1,1
202223,RMPSRP5006,SCUOLA SECONDARIA II GRADO,2,16,7,9,2,7
202223,RM1M079006,SCUOLA SECONDARIA I GRADO,2,42,42,0,0,0
202223,MITF11500N,SCUOLA SECONDARIA II GRADO,4,187,185,2,0,2
202223,MI1E06000B,SCUOLA PRIMARIA,2,35,31,4,1,3
202223,MNPS00500L,SCUOLA SECONDARIA II GRADO,3,16,16,0,0,0
202223,SAPS975006,SCUOLA SECONDARIA II GRADO,4,4,4,0,0,0
202223,CE1E05400Q,SCUOLA PRIMARIA,4,12,12,0,0,0
202223,VI1M01300P,SCUOLA SECONDARIA I GRADO,1,27,26,1,0,1
202223,CETD115003,SCUOLA SECONDARIA II GRADO,2,7,7,0,0,0
202223,CTTN01500A,SCUOLA SECONDARIA II GRADO,5,14,13,1,0,1
202223,MITB025006,SCUOLA SECONDARIA II GRADO,5,37,32,5,0,5
202223,BO1E013005,SCUOLA PRIMARIA,3,22,22,0,0,0
202223,BGTFUM500Z,SCUOLA SECONDARIA II GRADO,2,6,6,0,0,0
202223,VRPC025006,SCUOLA SECONDARIA II GRADO,3,8,8,0,0,0
202223,BG1E028001,SCUOLA PRIMARIA,3,16,16,0,0,0
202223,RMPS0V500L,SCUOLA SECONDARIA II GRADO,1,1,1,0,0,0
202223,NATABS5008,SCUOLA SECONDARIA II GRADO,2,7,7,0,0,0
202223,PVPS03500N,SCUOLA SECONDARIA II GRADO,4,9,6,3,1,2
202223,MI1M08100N,SCUOLA SECONDARIA I GRADO,3,47,46,1,0,1
202223,MI1E445002,SCUOLA PRIMARIA,5,53,51,2,0,2
202223,LC1M01000D,SCUOLA SECONDARIA I GRADO,2,35,34,1,0,1
202223,GE1E01500Q,SCUOLA PRIMARIA,5,12,12,0,0,0
202223,RO1E00100P,SCUOLA PRIMARIA,3,23,22,1,0,1
202223,LU1E00600G,SCUOLA PRIMARIA,3,25,21,4,0,4
202223,TO1M041007,SCUOLA SECONDARIA I GRADO,3,50,49,1,0,1
202223,VRPSN9500T,SCUOLA SECONDARIA II GRADO,2,26,24,2,0,2
202223,PA1E01000R,SCUOLA PRIMARIA,2,18,18,0,0,0
202223,NATD21500T,SCUOLA SECONDARIA II GRADO,1,8,8,0,0,0
202223,VI1E001007,SCUOLA PRIMARIA,3,40,33,7,1,6
202223,SARHZG500U,SCUOLA SECONDARIA II GRADO,5,138,130,8,4,4
202223,RM1E08700X,SCUOLA PRIMARIA,5,18,17,1,0,1
202223,AL1M006003,SCUOLA SECONDARIA I GRADO,3,37,33,4,0,4
202223,FI1M00500D,SCUOLA SECONDARIA I GRADO,1,26,22,4,0,4
202223,CERHFI5007,SCUOLA SECONDARIA II GRADO,3,25,25,0,0,0
202223,LTPST2500E,SCUOLA SECONDARIA II GRADO,5,51,46,5,3,2
202223,NA1E03800Q,SCUOLA PRIMARIA,5,10,10,0,0,0
202223,BGPL055009,SCUOLA SECONDARIA II GRADO,5,22,21,1,0,1
202223,RMPLNG500S,SCUOLA SECONDARIA II GRADO,2,3,3,0,0,0
202223,FIPM69500H,SCUOLA SECONDARIA II GRADO,4,9,9,0,0,0
202223,RM1E10800Q,SCUOLA PRIMARIA,4,28,26,2,1,1
202223,CE1E07100D,SCUOLA PRIMARIA,3,11,11,0,0,0
202223,RC1E01100G,SCUOLA PRIMARIA,5,11,11,0,0,0
202223,NA1E09800B,SCUOLA PRIMARIA,4,14,14,0,0,0
202223,MI1E05700G,SCUOLA PRIMARIA,5,45,44,1,0,1
202223,SAPL025004,SCUOLA SECONDARIA II GRADO,5,14,12,2,0,2
202223,RM1E014006,SCUOLA PRIMARIA,4,26,21,5,2,3
202223,RM1E049005,SCUOLA PRIMARIA,3,18,17,1,0,1
202223,RMTL395001,SCUOLA SECONDARIA II GRADO,3,4,2,2,1,1
202223,PERF71500A,SCUOLA SECONDARIA II GRADO,2,6,5,1,0,1
202223,PG1E00400E,SCUOLA PRIMARIA,3,12,11,1,0,1
202223,PT1E00600T,SCUOLA PRIMARIA,3,15,10,5,0,5
202223,SA1E02600X,SCUOLA PRIMARIA,2,12,12,0,0,0
202223,MERHF3500O,SCUOLA SECONDARIA II GRADO,1,8,7,1,0,1
202223,SVPS015002,SCUOLA SECONDARIA II GRADO,1,25,25,0,0,0
202223,BSPM4P500U,SCUOLA SECONDARIA II GRADO,2,19,19,0,0,0
202223,BNTLN2500A,SCUOLA SECONDARIA II GRADO,4,6,4,2,1,1
202223,NATD48500T,SCUOLA SECONDARIA II GRADO,1,4,4,0,0,0
202223,RM1E11000Q,SCUOLA PRIMARIA,5,34,33,1,1,0
202223,VRPL01500D,SCUOLA SECONDARIA II GRADO,2,27,27,0,0,0
202223,VARH01500A,SCUOLA SECONDARIA II GRADO,3,29,27,2,0,2
202223,NAPSAT500N,SCUOLA SECONDARIA II GRADO,4,3,3,0,0,0
202223,CR1E00700T,SCUOLA PRIMARIA,2,17,16,1,0,1
202223,AP1E00400B,SCUOLA PRIMARIA,5,16,15,1,0,1
202223,CA1EN7500O,SCUOLA PRIMARIA,4,21,18,3,1,2
202223,NA1E18200P,SCUOLA PRIMARIA,3,30,29,1,0,1
202223,RMTFNG5000,SCUOLA SECONDARIA II GRADO,1,7,6,1,0,1
202223,MB1E05000N,SCUOLA PRIMARIA,4,51,50,1,0,1
202223,PEPS005001,SCUOLA SECONDARIA II GRADO,2,25,24,1,1,0
202223,MIRF6M5002,SCUOLA SECONDARIA II GRADO,3,25,4,21,0,21
202223,BGTB015001,SCUOLA SECONDARIA II GRADO,2,61,54,7,2,5
202223,SV1E005006,SCUOLA PRIMARIA,4,38,36,2,1,1
202223,CETFQ95001,SCUOLA SECONDARIA II GRADO,1,8,1,7,0,7
202223,NATF545002,SCUOLA SECONDARIA II GRADO,5,63,61,2,0,2
202223,MI1M10000T,SCUOLA SECONDARIA I GRADO,2,8,7,1,1,0
202223,BNTDOO5001,SCUOLA SECONDARIA II GRADO,5,70,65,5,2,3
202223,RM1M06300L,SCUOLA SECONDARIA I GRADO,2,17,16,1,0,1
202223,MIPSO8500I,SCUOLA SECONDARIA II GRADO,5,9,9,0,0,0
202223,PNPS03500L,SCUOLA SECONDARIA II GRADO,3,10,10,0,0,0
202223,MI1E02100R,SCUOLA PRIMARIA,5,25,24,1,0,1
202223,RGPMSZ500N,SCUOLA SECONDARIA II GRADO,2,1,1,0,0,0
202223,FIPL005008,SCUOLA SECONDARIA II GRADO,5,12,11,1,0,1
202223,MI1E08000L,SCUOLA PRIMARIA,5,9,9,0,0,0
202223,NA1E051006,SCUOLA PRIMARIA,4,42,41,1,0,1
202223,VR1EEF5000,SCUOLA PRIMARIA,3,53,53,0,0,0
202223,COPL08500X,SCUOLA SECONDARIA II GRADO,3,27,26,1,0,1
202223,GE1M02500G,SCUOLA SECONDARIA I GRADO,1,26,25,1,0,1
202223,NA1E12900T,SCUOLA PRIMARIA,1,18,18,0,0,0
202223,CE1E01100T,SCUOLA PRIMARIA,3,31,31,0,0,0
202223,CO1E00100Q,SCUOLA PRIMARIA,3,37,32,5,0,5
202223,UD1M008008,SCUOLA SECONDARIA I GRADO,3,28,28,0,0,0
202223,MB1EF5500A,SCUOLA PRIMARIA,3,14,12,2,1,1
202223,MBPC27500T,SCUOLA SECONDARIA II GRADO,1,18,18,0,0,0
202223,RM1E19400X,SCUOLA PRIMARIA,3,17,17,0,0,0
202223,MBPS28500G,SCUOLA SECONDARIA II GRADO,1,5,5,0,0,0
202223,PN1E002004,SCUOLA PRIMARIA,3,31,30,1,1,0
202223,RMPS53500R,SCUOLA SECONDARIA II GRADO,2,18,17,1,1,0
202223,TO1E02200L,SCUOLA PRIMARIA,5,42,39,3,1,2
202223,RMPL22500A,SCUOLA SECONDARIA II GRADO,1,9,8,1,1,0
202223,RGPM00500A,SCUOLA SECONDARIA II GRADO,5,6,6,0,0,0
202223,PT1E004006,SCUOLA PRIMARIA,1,14,11,3,1,2
202223,ALPMQR5008,SCUOLA SECONDARIA II GRADO,4,8,7,1,0,1
202223,VA1E008008,SCUOLA PRIMARIA,4,34,34,0,0,0
202223,RM1EVQ500H,SCUOLA PRIMARIA,5,22,22,0,0,0
202223,NARFZO500E,SCUOLA SECONDARIA II GRADO,4,6,6,0,0,0
202223,LT1E006004,SCUOLA PRIMARIA,2,18,18,0,0,0
202223,CETD15500D,SCUOLA SECONDARIA II GRADO,1,9,8,1,0,1
202223,PD1M01000T,SCUOLA SECONDARIA I GRADO,3,73,72,1,0,1
202223,RMPM3G5002,SCUOLA SECONDARIA II GRADO,4,2,2,0,0,0
202223,MC1EMU5009,SCUOLA PRIMARIA,1,21,19,2,1,1
202223,PA1E00400D,SCUOLA PRIMARIA,4,24,22,2,1,1
202223,MI1E025004,SCUOLA PRIMARIA,1,39,38,1,0,1
202223,RMTD55500T,SCUOLA SECONDARIA II GRADO,4,7,7,0,0,0
202223,MB1M01000C,SCUOLA SECONDARIA I GRADO,1,42,41,1,0,1
202223,NA1E006008,SCUOLA PRIMARIA,3,39,36,3,0,3
202223,SAPMNI5000,SCUOLA SECONDARIA II GRADO,1,1,1,0,0,0
202223,APPSR5500N,SCUOLA SECONDARIA II GRADO,1,2,2,0,0,0
202223,TOTF055007,SCUOLA SECONDARIA II GRADO,1,3,2,1,1,0
202223,RM1E036003,SCUOLA PRIMARIA,1,26,26,0,0,0
202223,AGTD4Q5003,SCUOLA SECONDARIA II GRADO,1,3,3,0,0,0
202223,BO1E01500R,SCUOLA PRIMARIA,1,33,32,1,0,1
202223,VI1E007006,SCUOLA PRIMARIA,4,16,16,0,0,0
202223,VA1E010008,SCUOLA PRIMARIA,5,28,27,1,0,1
202223,BORC10500R,SCUOLA SECONDARIA II GRADO,5,26,24,2,0,2
202223,RM1M01100X,SCUOLA SECONDARIA I GRADO,2,23,23,0,0,0
202223,NARH105008,SCUOLA SECONDARIA II GRADO,4,16,16,0,0,0
202223,SSPL015003,SCUOLA SECONDARIA II GRADO,2,1,1,0,0,0
202223,NA1E01900A,SCUOLA PRIMARIA,5,30,30,0,0,0
202223,TVPMVC5000,SCUOLA SECONDARIA II GRADO,2,25,24,1,0,1
202223,COPSCP5007,SCUOLA SECONDARIA II GRADO,1,19,18,1,0,1
202223,NA1E25200Q,SCUOLA PRIMARIA,2,12,12,0,0,0
202223,FEPLUM500O,SCUOLA SECONDARIA II GRADO,1,7,6,1,1,0
202223,MBTD35500C,SCUOLA SECONDARIA II GRADO,5,16,15,1,0,1
202223,MS1E00500P,SCUOLA PRIMARIA,1,14,14,0,0,0
202223,MITNUQ500H,SCUOLA SECONDARIA II GRADO,1,25,19,6,1,5
202223,RMPMQB5004,SCUOLA SECONDARIA II GRADO,5,50,50,0,0,0
202223,CL1E002008,SCUOLA PRIMARIA,4,9,9,0,0,0
202223,APPMOI500F,SCUOLA SECONDARIA II GRADO,4,2,2,0,0,0
202223,MI1M04000B,SCUOLA SECONDARIA I GRADO,2,47,47,0,0,0
202223,TO1E05200C,SCUOLA PRIMARIA,2,11,9,2,0,2
202223,PDTD1N5003,SCUOLA SECONDARIA II GRADO,1,12,11,1,0,1
202223,NAPMRM500O,SCUOLA SECONDARIA II GRADO,1,14,14,0,0,0
202223,RMPL035007,SCUOLA SECONDARIA II GRADO,4,4,3,1,0,1
202223,BGPSAF500M,SCUOLA SECONDARIA II GRADO,3,7,7,0,0,0
202223,VA1E9G500A,SCUOLA PRIMARIA,5,11,10,1,1,0
202223,RMPC545008,SCUOLA SECONDARIA II GRADO,4,8,8,0,0,0
202223,SATFEP500M,SCUOLA SECONDARIA II GRADO,3,5,5,0,0,0
202223,MOTD02500A,SCUOLA SECONDARIA II GRADO,1,20,18,2,1,1
202223,MIPSQV500F,SCUOLA SECONDARIA II GRADO,2,26,26,0,0,0
202223,NA1E18100V,SCUOLA PRIMARIA,3,26,11,15,8,7
202223,VTPSP5500E,SCUOLA SECONDARIA II GRADO,3,5,4,1,0,1
202223,VR1E004003,SCUOLA PRIMARIA,1,26,23,3,0,3
202223,TS1M003003,SCUOLA SECONDARIA I GRADO,1,19,19,0,0,0
202223,BGPS0D500U,SCUOLA SECONDARIA II GRADO,5,30,28,2,0,2
202223,VAPS5H500H,SCUOLA SECONDARIA II GRADO,5,15,15,0,0,0
202223,TO1M00900B,SCUOLA SECONDARIA I GRADO,3,80,80,0,0,0
202223,NARH9B500E,SCUOLA SECONDARIA II GRADO,4,11,11,0,0,0
202223,FGTDO25007,SCUOLA SECONDARIA II GRADO,3,4,4,0,0,0
202223,NA1EM9500T,SCUOLA PRIMARIA,5,11,11,0,0,0
202223,BSPS2M500I,SCUOLA SECONDARIA II GRADO,4,19,19,0,0,0
202223,BSPS6Z5004,SCUOLA SECONDARIA II GRADO,4,12,12,0,0,0
202223,CTPSPS5003,SCUOLA SECONDARIA II GRADO,5,13,13,0,0,0
202223,GE1E034005,SCUOLA PRIMARIA,1,10,10,0,0,0
202223,AR1E002001,SCUOLA PRIMARIA,1,17,17,0,0,0
202223,MIPS175007,SCUOLA SECONDARIA II GRADO,3,27,27,0,0,0
202223,RMTB04500X,SCUOLA SECONDARIA II GRADO,3,23,18,5,4,1
202223,MBPL20500D,SCUOLA SECONDARIA II GRADO,1,33,33,0,0,0
202223,VI1E002003,SCUOLA PRIMARIA,3,22,21,1,0,1
202223,RMPS97500P,SCUOLA SECONDARIA II GRADO,3,11,11,0,0,0
202223,VEPC02500E,SCUOLA SECONDARIA II GRADO,4,15,15,0,0,0
202223,SR1E3H5006,SCUOLA PRIMARIA,2,9,9,0,0,0
202223,SR1E005001,SCUOLA PRIMARIA,3,21,17,4,0,4
202223,NA1MU75009,SCUOLA SECONDARIA I GRADO,3,6,2,4,0,4
202223,MI1E020001,SCUOLA PRIMARIA,2,48,45,3,1,2
202223,RE1EE9500Z,SCUOLA PRIMARIA,5,19,19,0,0,0
202223,FR1E00500L,SCUOLA PRIMARIA,5,8,8,0,0,0
202223,MIPMRI500E,SCUOLA SECONDARIA II GRADO,5,83,83,0,0,0
202223,NA1E1M500R,SCUOLA PRIMARIA,4,11,1,10,0,10
202223,SA1E00700E,SCUOLA PRIMARIA,4,4,4,0,0,0
202223,RM1E00500B,SCUOLA PRIMARIA,2,22,22,0,0,0
202223,VE1M007004,SCUOLA SECONDARIA I GRADO,1,65,54,11,0,11
202223,RM1E212008,SCUOLA PRIMARIA,4,92,87,5,0,5
202223,NA1M003002,SCUOLA SECONDARIA I GRADO,3,80,80,0,0,0
202223,NARHSC500S,SCUOLA SECONDARIA II GRADO,5,22,21,1,0,1
202223,FI1E001001,SCUOLA PRIMARIA,2,27,27,0,0,0
202223,SATFUB5003,SCUOLA SECONDARIA II GRADO,5,62,61,1,0,1
202223,TOPLRN500U,SCUOLA SECONDARIA II GRADO,4,3,2,1,0,1
202223,CE1E00600A,SCUOLA PRIMARIA,1,14,13,1,0,1
202223,TO1M7Q5005,SCUOLA SECONDARIA I GRADO,2,9,9,0,0,0
202223,APRFSQ500B,SCUOLA SECONDARIA II GRADO,2,2,2,0,0,0
202223,VARFS2500Z,SCUOLA SECONDARIA II GRADO,3,12,12,0,0,0
202223,CS1E00600D,SCUOLA PRIMARIA,3,18,18,0,0,0
202223,LO1E00400P,SCUOLA PRIMARIA,4,39,39,0,0,0
202223,CA1E01500P,SCUOLA PRIMARIA,2,15,15,0,0,0
202223,RMPSBI5001,SCUOLA SECONDARIA II GRADO,3,28,26,2,0,2
202223,VI1M01500A,SCUOLA SECONDARIA I GRADO,2,18,17,1,0,1
202223,VA1E9G500A,SCUOLA PRIMARIA,1,11,10,1,1,0
202223,BOPM8F500M,SCUOLA SECONDARIA II GRADO,3,24,24,0,0,0
202223,CTTE01500X,SCUOLA SECONDARIA II GRADO,3,26,26,0,0,0
202223,NA1E205006,SCUOLA PRIMARIA,4,21,11,10,0,10
202223,TOPS105001,SCUOLA SECONDARIA II GRADO,2,108,105,3,2,1
202223,RM1EZR5005,SCUOLA PRIMARIA,1,15,15,0,0,0
202223,GRPC64500E,SCUOLA SECONDARIA II GRADO,1,3,3,0,0,0
202223,RM1E5U5009,SCUOLA PRIMARIA,5,10,9,1,1,0
202223,PA1E04500Q,SCUOLA PRIMARIA,2,41,41,0,0,0
202223,AG1E006007,SCUOLA PRIMARIA,3,23,23,0,0,0
202223,LC1E00500R,SCUOLA PRIMARIA,4,37,36,1,0,1
202223,COPSUC5004,SCUOLA SECONDARIA II GRADO,1,37,36,1,0,1
202223,AVPM03500Q,SCUOLA SECONDARIA II GRADO,4,14,13,1,1,0
202223,AVTF005001,SCUOLA SECONDARIA II GRADO,1,7,7,0,0,0
202223,TOPC075007,SCUOLA SECONDARIA II GRADO,2,37,36,1,0,1
202223,NATDFO5000,SCUOLA SECONDARIA II GRADO,4,10,10,0,0,0
202223,RC1E00700X,SCUOLA PRIMARIA,4,24,24,0,0,0
202223,RMRF00500V,SCUOLA SECONDARIA II GRADO,4,6,5,1,0,1
202223,MIPL15500R,SCUOLA SECONDARIA II GRADO,5,40,37,3,2,1
202223,NA1E11100L,SCUOLA PRIMARIA,3,10,10,0,0,0
202223,MBPS8T500R,SCUOLA SECONDARIA II GRADO,5,26,26,0,0,0
202223,MI1E038006,SCUOLA PRIMARIA,2,24,23,1,1,0
202223,NATL16500C,SCUOLA SECONDARIA II GRADO,5,64,62,2,0,2
202223,PVPLHO500H,SCUOLA SECONDARIA II GRADO,4,8,7,1,1,0
202223,TP1E003005,SCUOLA PRIMARIA,1,1,1,0,0,0
202223,LCRC4F500Q,SCUOLA SECONDARIA II GRADO,2,22,16,6,0,6
202223,BO1E020008,SCUOLA PRIMARIA,2,56,55,1,0,1
202223,TV1E00200Q,SCUOLA PRIMARIA,2,47,44,3,0,3
202223,CE1E06400A,SCUOLA PRIMARIA,4,13,13,0,0,0
202223,BS1E02100P,SCUOLA PRIMARIA,1,24,23,1,0,1
202223,FI1E013007,SCUOLA PRIMARIA,1,17,14,3,0,3
202223,NATFFL500P,SCUOLA SECONDARIA II GRADO,4,8,8,0,0,0
202223,VRTF005006,SCUOLA SECONDARIA II GRADO,5,217,215,2,0,2
202223,BO1E00800N,SCUOLA PRIMARIA,4,18,16,2,0,2
202223,NA1E10900L,SCUOLA PRIMARIA,2,18,15,3,1,2
202223,NAPS555009,SCUOLA SECONDARIA II GRADO,2,1,1,0,0,0
202223,RM1M05100A,SCUOLA SECONDARIA I GRADO,1,21,21,0,0,0
202223,NA1E22300Q,SCUOLA PRIMARIA,2,49,49,0,0,0
202223,RM1E180002,SCUOLA PRIMARIA,2,33,25,8,0,8
202223,CLSD00500B,SCUOLA SECONDARIA II GRADO,1,40,40,0,0,0
202223,NA1E15500A,SCUOLA PRIMARIA,4,22,20,2,0,2
202223,MI1E132004,SCUOLA PRIMARIA,1,12,11,1,0,1
202223,LCPM3P500N,SCUOLA SECONDARIA II GRADO,2,24,24,0,0,0
202223,NA1E06700Q,SCUOLA PRIMARIA,3,43,42,1,0,1
202223,SARH13500E,SCUOLA SECONDARIA II GRADO,1,4,4,0,0,0
202223,TV1E019005,SCUOLA PRIMARIA,2,10,8,2,0,2
202223,GE1E02300P,SCUOLA PRIMARIA,1,24,18,6,0,6
202223,PAPS02500Q,SCUOLA SECONDARIA II GRADO,5,64,64,0,0,0
202223,FRPM9G500T,SCUOLA SECONDARIA II GRADO,5,64,57,7,2,5
202223,FO1E002002,SCUOLA PRIMARIA,5,13,10,3,1,2
202223,TO1M04600A,SCUOLA SECONDARIA I GRADO,3,45,44,1,0,1
202223,LUPS025006,SCUOLA SECONDARIA II GRADO,4,2,1,1,0,1
202223,FI1E01800A,SCUOLA PRIMARIA,5,24,24,0,0,0
202223,RM1E105008,SCUOLA PRIMARIA,5,20,20,0,0,0
202223,SATFHU5008,SCUOLA SECONDARIA II GRADO,4,7,7,0,0,0
202223,RMPM17500R,SCUOLA SECONDARIA II GRADO,4,22,22,0,0,0
202223,RMPL48500Q,SCUOLA SECONDARIA II GRADO,3,4,4,0,0,0
202223,OR1E00100R,SCUOLA PRIMARIA,4,14,14,0,0,0
202223,AV1E010005,SCUOLA PRIMARIA,4,16,16,0,0,0
202223,SARHE75006,SCUOLA SECONDARIA II GRADO,5,105,97,8,1,7
202223,NO1M01100X,SCUOLA SECONDARIA I GRADO,2,129,117,12,0,12
202223,TV1E01700D,SCUOLA PRIMARIA,1,47,47,0,0,0
202223,TO1E020001,SCUOLA PRIMARIA,2,29,29,0,0,0
202223,FI1M008001,SCUOLA SECONDARIA I GRADO,2,18,18,0,0,0
202223,PAPMRG500C,SCUOLA SECONDARIA II GRADO,1,6,6,0,0,0
202223,VR1M013003,SCUOLA SECONDARIA I GRADO,3,79,77,2,0,2
202223,NA1E05000A,SCUOLA PRIMARIA,3,3,3,0,0,0
202223,RMPM55500G,SCUOLA SECONDARIA II GRADO,1,17,14,3,0,3
202223,RMPM17500R,SCUOLA SECONDARIA II GRADO,1,25,23,2,2,0
202223,VATD05500V,SCUOLA SECONDARIA II GRADO,3,9,9,0,0,0
202223,TO1M050002,SCUOLA SECONDARIA I GRADO,3,50,43,7,3,4
202223,CE1M00600G,SCUOLA SECONDARIA I GRADO,1,38,38,0,0,0
202223,NA1E094004,SCUOLA PRIMARIA,5,10,10,0,0,0
202223,CR1E00200P,SCUOLA PRIMARIA,5,41,40,1,1,0
202223,LI1M00300V,SCUOLA SECONDARIA I GRADO,1,25,24,1,0,1
202223,BG1E001001,SCUOLA PRIMARIA,3,59,56,3,1,2
202223,TO1E033003,SCUOLA PRIMARIA,2,44,38,6,4,2
202223,GE1E00800L,SCUOLA PRIMARIA,1,18,15,3,1,2
202223,PEPC025003,SCUOLA SECONDARIA II GRADO,1,1,1,0,0,0
202223,PT1M00100X,SCUOLA SECONDARIA I GRADO,3,25,20,5,2,3
202223,SATDD75001,SCUOLA SECONDARIA II GRADO,4,7,7,0,0,0
202223,PAPC695004,SCUOLA SECONDARIA II GRADO,1,3,3,0,0,0
202223,FIPL07500E,SCUOLA SECONDARIA II GRADO,4,12,10,2,0,2
202223,FIPLV0500F,SCUOLA SECONDARIA II GRADO,2,13,11,2,0,2
202223,NA1E149003,SCUOLA PRIMARIA,3,2,2,0,0,0
202223,CT1E03900X,SCUOLA PRIMARIA,5,9,9,0,0,0
202223,RM1M079006,SCUOLA SECONDARIA I GRADO,1,40,40,0,0,0
202223,NAPS39500Q,SCUOLA SECONDARIA II GRADO,5,11,11,0,0,0
202223,GO1E002006,SCUOLA PRIMARIA,5,5,5,0,0,0
202223,TVTD02500D,SCUOLA SECONDARIA II GRADO,3,27,26,1,1,0
202223,MB1E07100P,SCUOLA PRIMARIA,4,20,20,0,0,0
202223,CE1E05000C,SCUOLA PRIMARIA,4,12,9,3,2,1
202223,VAPM04500D,SCUOLA SECONDARIA II GRADO,4,27,27,0,0,0
202223,VATFGA500N,SCUOLA SECONDARIA II GRADO,5,10,10,0,0,0
202223,TVPM4Q500B,SCUOLA SECONDARIA II GRADO,5,8,8,0,0,0
202223,RM1E11600P,SCUOLA PRIMARIA,4,20,12,8,0,8
202223,NA1E14500Q,SCUOLA PRIMARIA,4,37,37,0,0,0
202223,CT1E031009,SCUOLA PRIMARIA,1,14,14,0,0,0
202223,VRPLHM500A,SCUOLA SECONDARIA II GRADO,4,21,21,0,0,0
202223,MIPSRF5008,SCUOLA SECONDARIA II GRADO,4,3,3,0,0,0
202223,UD1E00300X,SCUOLA PRIMARIA,1,20,19,1,0,1
202223,TO1E00600P,SCUOLA PRIMARIA,2,18,18,0,0,0
202223,SASD00500E,SCUOLA SECONDARIA II GRADO,4,3,3,0,0,0
202223,MI1E14100V,SCUOLA PRIMARIA,3,59,53,6,0,6
202223,BGPS135006,SCUOLA SECONDARIA II GRADO,1,6,6,0,0,0
202223,SAPSL4500R,SCUOLA SECONDARIA II GRADO,4,21,21,0,0,0
202223,RE1M00600E,SCUOLA SECONDARIA I GRADO,1,48,46,2,0,2
202223,RG1E00600X,SCUOLA PRIMARIA,4,12,11,1,0,1
202223,LE1E00600T,SCUOLA PRIMARIA,3,16,16,0,0,0
202223,PE1E009003,SCUOLA PRIMARIA,4,30,29,1,1,0
202223,MCTFL85000,SCUOLA SECONDARIA II GRADO,3,5,5,0,0,0
202223,TO1M01600E,SCUOLA SECONDARIA I GRADO,2,68,67,1,0,1
202223,PR1E00500B,SCUOLA PRIMARIA,3,39,38,1,0,1
202223,BGPL04500P,SCUOLA SECONDARIA II GRADO,3,31,29,2,1,1
202223,SATL00500A,SCUOLA SECONDARIA II GRADO,3,4,4,0,0,0
202223,UDPC00500N,SCUOLA SECONDARIA II GRADO,1,8,8,0,0,0
202223,CE1E02100C,SCUOLA PRIMARIA,4,13,13,0,0,0
202223,RMPL325007,SCUOLA SECONDARIA II GRADO,5,14,13,1,1,0
202223,CT1E008008,SCUOLA PRIMARIA,4,39,39,0,0,0
202223,SAPL025004,SCUOLA SECONDARIA II GRADO,4,2,2,0,0,0
202223,NA1E058001,SCUOLA PRIMARIA,2,10,10,0,0,0
202223,SATD01500E,SCUOLA SECONDARIA II GRADO,2,3,2,1,0,1
202223,RE1E008001,SCUOLA PRIMARIA,1,24,23,1,0,1
202223,TO1E047001,SCUOLA PRIMARIA,2,30,13,17,4,13
202223,RM1E09500V,SCUOLA PRIMARIA,2,25,25,0,0,0
202223,RM1E2U500H,SCUOLA PRIMARIA,2,49,48,1,0,1
202223,LTTD035005,SCUOLA SECONDARIA II GRADO,4,3,3,0,0,0
202223,CETF01500C,SCUOLA SECONDARIA II GRADO,1,25,25,0,0,0
202223,CT1M00700N,SCUOLA SECONDARIA I GRADO,2,13,13,0,0,0
202223,BG1M00300T,SCUOLA SECONDARIA I GRADO,3,24,24,0,0,0
202223,GE1M014005,SCUOLA SECONDARIA I GRADO,2,40,40,0,0,0
202223,MBRFZ6500C,SCUOLA SECONDARIA II GRADO,5,25,24,1,0,1
202223,BA1E02500C,SCUOLA PRIMARIA,2,23,23,0,0,0
202223,MO1E013003,SCUOLA PRIMARIA,1,19,19,0,0,0
202223,SAPLLV500D,SCUOLA SECONDARIA II GRADO,2,8,8,0,0,0
202223,RA1M00300L,SCUOLA SECONDARIA I GRADO,2,11,11,0,0,0
202223,RMPS72500B,SCUOLA SECONDARIA II GRADO,5,26,25,1,1,0
202223,GE1E02500A,SCUOLA PRIMARIA,5,14,12,2,0,2
202223,VA1E02200E,SCUOLA PRIMARIA,3,36,35,1,0,1
202223,MEPM12500X,SCUOLA SECONDARIA II GRADO,1,1,1,0,0,0
202223,SRTDRP500U,SCUOLA SECONDARIA II GRADO,2,1,0,1,0,1
202223,PA1E04000L,SCUOLA PRIMARIA,1,12,11,1,1,0
202223,BSPLLZ5006,SCUOLA SECONDARIA II GRADO,2,29,29,0,0,0
202223,VR1M01700A,SCUOLA SECONDARIA I GRADO,2,46,46,0,0,0
202223,PD1M006006,SCUOLA SECONDARIA I GRADO,1,20,19,1,0,1
202223,MI1MA05006,SCUOLA SECONDARIA I GRADO,1,21,20,1,0,1
202223,NATD4G500H,SCUOLA SECONDARIA II GRADO,5,135,131,4,1,3
202223,NA1E26100E,SCUOLA PRIMARIA,1,21,21,0,0,0
202223,FG1E01400A,SCUOLA PRIMARIA,2,14,13,1,0,1
202223,BI1M01000N,SCUOLA SECONDARIA I GRADO,2,19,19,0,0,0
202223,MBSL05500V,SCUOLA SECONDARIA II GRADO,1,103,99,4,2,2
202223,BG1EL2500G,SCUOLA PRIMARIA,5,5,5,0,0,0
202223,SAPS09500G,SCUOLA SECONDARIA II GRADO,3,7,4,3,0,3
202223,NA1E17400Q,SCUOLA PRIMARIA,3,19,19,0,0,0
202223,CTTD315003,SCUOLA SECONDARIA II GRADO,4,6,6,0,0,0
202223,VI1E01200N,SCUOLA PRIMARIA,3,39,33,6,2,4
202223,VI1E010002,SCUOLA PRIMARIA,1,9,9,0,0,0
202223,BS1E02000V,SCUOLA PRIMARIA,1,48,46,2,0,2
202223,RM1E15400D,SCUOLA PRIMARIA,3,14,13,1,1,0
202223,MIPL335009,SCUOLA SECONDARIA II GRADO,1,18,14,4,1,3
202223,MBRC6C500E,SCUOLA SECONDARIA II GRADO,2,16,15,1,0,1
202223,PD1E004009,SCUOLA PRIMARIA,3,21,21,0,0,0
202223,MIPSIG500R,SCUOLA SECONDARIA II GRADO,5,47,47,0,0,0
202223,RMSLR1500M,SCUOLA SECONDARIA II GRADO,1,7,6,1,1,0
202223,RM1E19400X,SCUOLA PRIMARIA,2,19,18,1,0,1
202223,RM1E171007,SCUOLA PRIMARIA,2,40,35,5,4,1
202223,RA1E00600V,SCUOLA PRIMARIA,5,37,36,1,0,1
202223,MI1M01400V,SCUOLA SECONDARIA I GRADO,1,55,52,3,2,1
202223,TV1EDQ500C,SCUOLA PRIMARIA,4,23,22,1,1,0
202223,NAPMEF500M,SCUOLA SECONDARIA II GRADO,1,2,2,0,0,0
202223,FITF265001,SCUOLA SECONDARIA II GRADO,2,13,11,2,0,2
202223,NA1MSZ5005,SCUOLA SECONDARIA I GRADO,3,21,21,0,0,0
202223,VB1E001004,SCUOLA PRIMARIA,5,22,22,0,0,0
202223,CO1EMI5009,SCUOLA PRIMARIA,3,19,16,3,0,3
202223,PATD33500R,SCUOLA SECONDARIA II GRADO,1,5,5,0,0,0
202223,TVTF015005,SCUOLA SECONDARIA II GRADO,4,25,25,0,0,0
202223,NA1E214001,SCUOLA PRIMARIA,5,11,4,7,2,5
202223,RMSLZ35008,SCUOLA SECONDARIA II GRADO,2,3,3,0,0,0
202223,PI1E00100Q,SCUOLA PRIMARIA,5,18,18,0,0,0
202223,MI1E003007,SCUOLA PRIMARIA,1,56,56,0,0,0
202223,RE1E001006,SCUOLA PRIMARIA,5,24,24,0,0,0
202223,SA1E01400N,SCUOLA PRIMARIA,5,15,15,0,0,0
202223,RM1M01100X,SCUOLA SECONDARIA I GRADO,1,31,31,0,0,0
202223,MIPS055005,SCUOLA SECONDARIA II GRADO,4,45,45,0,0,0
202223,CERHU1500P,SCUOLA SECONDARIA II GRADO,5,113,112,1,0,1
202223,LT1E00900G,SCUOLA PRIMARIA,1,40,40,0,0,0
202223,MIPSVC500V,SCUOLA SECONDARIA II GRADO,2,26,25,1,0,1
202223,LC1E00100D,SCUOLA PRIMARIA,4,19,18,1,0,1
202223,MB1E032004,SCUOLA PRIMARIA,1,20,19,1,0,1
202223,PAPC00500B,SCUOLA SECONDARIA II GRADO,1,5,5,0,0,0
202223,BGPC02500G,SCUOLA SECONDARIA II GRADO,4,9,9,0,0,0
202223,CTPS09500D,SCUOLA SECONDARIA II GRADO,5,11,11,0,0,0
202223,GE1E03000T,SCUOLA PRIMARIA,4,23,23,0,0,0
202223,BNPS3O5006,SCUOLA SECONDARIA II GRADO,4,8,8,0,0,0
202223,CEPS875001,SCUOLA SECONDARIA II GRADO,2,26,26,0,0,0
202223,RMTD355004,SCUOLA SECONDARIA II GRADO,3,15,15,0,0,0
202223,MI1E074009,SCUOLA PRIMARIA,1,46,38,8,0,8
202223,TR1E00100P,SCUOLA PRIMARIA,1,14,12,2,0,2
202223,NA1E186002,SCUOLA PRIMARIA,3,14,14,0,0,0
202223,VEPS015003,SCUOLA SECONDARIA II GRADO,2,12,12,0,0,0
202223,AGSL015004,SCUOLA SECONDARIA II GRADO,2,3,2,1,1,0
202223,SRPM475001,SCUOLA SECONDARIA II GRADO,3,9,9,0,0,0
202223,FI1E035004,SCUOLA PRIMARIA,5,37,31,6,0,6
202223,BOPSHR500B,SCUOLA SECONDARIA II GRADO,4,31,31,0,0,0
202223,NA1E198008,SCUOLA PRIMARIA,3,16,16,0,0,0
202223,SA1E01000A,SCUOLA PRIMARIA,5,15,15,0,0,0
202223,KR1E002001,SCUOLA PRIMARIA,1,30,28,2,1,1
202223,CTPM21500B,SCUOLA SECONDARIA II GRADO,5,16,16,0,0,0
202223,BO1E00400A,SCUOLA PRIMARIA,3,27,25,2,0,2
202223,NA1E119007,SCUOLA PRIMARIA,3,15,15,0,0,0
202223,RMPSIZ500B,SCUOLA SECONDARIA II GRADO,3,23,22,1,0,1
202223,BN1M002007,SCUOLA SECONDARIA I GRADO,3,13,13,0,0,0
202223,MI1E024008,SCUOLA PRIMARIA,3,20,20,0,0,0
202223,RM1MMF500S,SCUOLA SECONDARIA I GRADO,2,55,53,2,0,2
202223,MI1E067006,SCUOLA PRIMARIA,5,19,16,3,0,3
202223,CHTD035004,SCUOLA SECONDARIA II GRADO,2,3,3,0,0,0
202223,NA1E18100V,SCUOLA PRIMARIA,4,26,17,9,4,5
202223,MI1M00600X,SCUOLA SECONDARIA I GRADO,3,58,56,2,0,2
202223,TV1E00800P,SCUOLA PRIMARIA,3,29,27,2,0,2
202223,CE1E065006,SCUOLA PRIMARIA,4,21,21,0,0,0
202223,PS1E00200B,SCUOLA PRIMARIA,1,34,33,1,1,0
202223,RA1M005008,SCUOLA SECONDARIA I GRADO,3,17,15,2,1,1
202223,RMPSVA5006,SCUOLA SECONDARIA II GRADO,3,24,20,4,0,4
202223,RM1E11800A,SCUOLA PRIMARIA,5,27,26,1,0,1
202223,MI1E11800T,SCUOLA PRIMARIA,5,20,18,2,0,2
202223,BS1E009004,SCUOLA PRIMARIA,3,27,26,1,0,1
202223,NATHA4500E,SCUOLA SECONDARIA II GRADO,1,1,1,0,0,0
202223,MOTD02500A,SCUOLA SECONDARIA II GRADO,3,16,14,2,0,2
202223,BSTD01500C,SCUOLA SECONDARIA II GRADO,3,15,14,1,0,1
202223,NAPLIA500F,SCUOLA SECONDARIA II GRADO,3,5,5,0,0,0
202223,LE1M00300G,SCUOLA SECONDARIA I GRADO,2,20,20,0,0,0
202223,TV1E00400B,SCUOLA PRIMARIA,3,46,44,2,0,2
202223,CE1E06100V,SCUOLA PRIMARIA,5,14,14,0,0,0
202223,CTTD34500V,SCUOLA SECONDARIA II GRADO,4,2,2,0,0,0
202223,FRTD5O500I,SCUOLA SECONDARIA II GRADO,4,8,8,0,0,0
202223,RM1E00500B,SCUOLA PRIMARIA,3,21,19,2,0,2
202223,CETD4C500S,SCUOLA SECONDARIA II GRADO,1,8,6,2,0,2
202223,MITD25500P,SCUOLA SECONDARIA II GRADO,2,10,10,0,0,0
202223,NA1M00600D,SCUOLA SECONDARIA I GRADO,1,32,32,0,0,0
202223,TO1M02300N,SCUOLA SECONDARIA I GRADO,2,71,71,0,0,0
202223,PR1E00900P,SCUOLA PRIMARIA,2,27,27,0,0,0
202223,FI1E001001,SCUOLA PRIMARIA,3,18,18,0,0,0
202223,UDPS01500B,SCUOLA SECONDARIA II GRADO,2,15,15,0,0,0
202223,MIPS20500T,SCUOLA SECONDARIA II GRADO,3,18,18,0,0,0
202223,RMTD51500B,SCUOLA SECONDARIA II GRADO,1,6,6,0,0,0
202223,MB1M02400A,SCUOLA SECONDARIA I GRADO,2,55,53,2,1,1
202223,LO1M03000C,SCUOLA SECONDARIA I GRADO,2,23,23,0,0,0
202223,RM1E02900X,SCUOLA PRIMARIA,3,20,18,2,1,1
202223,LCPMEE500S,SCUOLA SECONDARIA II GRADO,3,22,22,0,0,0
202223,PV1E007008,SCUOLA PRIMARIA,5,15,15,0,0,0
202223,NARH25500E,SCUOLA SECONDARIA II GRADO,1,8,8,0,0,0
202223,RC1E00700X,SCUOLA PRIMARIA,5,21,20,1,0,1
202223,NA1E28100Q,SCUOLA PRIMARIA,4,41,41,0,0,0
202223,NATDBQ500Q,SCUOLA SECONDARIA II GRADO,2,8,8,0,0,0
202223,NA1E128002,SCUOLA PRIMARIA,2,10,10,0,0,0
202223,NA1E212009,SCUOLA PRIMARIA,2,10,10,0,0,0
202223,CR1E00900D,SCUOLA PRIMARIA,3,38,38,0,0,0
202223,BSTL01500V,SCUOLA SECONDARIA II GRADO,3,7,6,1,0,1
202223,MO1M001002,SCUOLA SECONDARIA I GRADO,3,20,17,3,1,2
202223,RM1E01700N,SCUOLA PRIMARIA,4,10,9,1,1,0
202223,PGRF8G5009,SCUOLA SECONDARIA II GRADO,2,1,1,0,0,0
202223,TOPS955001,SCUOLA SECONDARIA II GRADO,3,6,6,0,0,0
202223,AL1E00600T,SCUOLA PRIMARIA,5,45,40,5,1,4
202223,BO1E020008,SCUOLA PRIMARIA,3,60,57,3,2,1
202223,FI1M015004,SCUOLA SECONDARIA I GRADO,2,14,14,0,0,0
202223,PV1E00500L,SCUOLA PRIMARIA,4,43,42,1,0,1
202223,VR1M02400D,SCUOLA SECONDARIA I GRADO,1,69,65,4,2,2
202223,CORA025003,SCUOLA SECONDARIA II GRADO,2,17,17,0,0,0
202223,NA1E03400C,SCUOLA PRIMARIA,4,64,63,1,0,1
202223,TV1MRF500I,SCUOLA SECONDARIA I GRADO,2,24,24,0,0,0
202223,RM1E15200T,SCUOLA PRIMARIA,3,27,27,0,0,0
202223,CO1M01100G,SCUOLA SECONDARIA I GRADO,1,29,27,2,0,2
202223,NA1E27300R,SCUOLA PRIMARIA,5,17,16,1,0,1
202223,NA1E10900L,SCUOLA PRIMARIA,3,12,12,0,0,0
202223,BNPC015006,SCUOLA SECONDARIA II GRADO,2,10,10,0,0,0
202223,RM1M14800B,SCUOLA SECONDARIA I GRADO,3,16,16,0,0,0
202223,MI1E04200T,SCUOLA PRIMARIA,4,50,49,1,0,1
202223,MI1E132004,SCUOLA PRIMARIA,2,18,17,1,0,1
202223,RMPS95500D,SCUOLA SECONDARIA II GRADO,2,14,14,0,0,0
202223,RMTND1500F,SCUOLA SECONDARIA II GRADO,4,9,9,0,0,0
202223,LCTL02500D,SCUOLA SECONDARIA II GRADO,3,1,1,0,0,0
202223,PE1E00400X,SCUOLA PRIMARIA,3,24,23,1,1,0
202223,PSTF005006,SCUOLA SECONDARIA II GRADO,4,29,28,1,0,1
202223,BS1E02200E,SCUOLA PRIMARIA,4,41,39,2,0,2
202223,BSPSS1500O,SCUOLA SECONDARIA II GRADO,5,55,54,1,0,1
202223,TVPC035005,SCUOLA SECONDARIA II GRADO,5,5,5,0,0,0
202223,RM1E156005,SCUOLA PRIMARIA,5,16,15,1,0,1
202223,BSPMN8500Q,SCUOLA SECONDARIA II GRADO,1,31,30,1,0,1
202223,NATF6G5004,SCUOLA SECONDARIA II GRADO,4,7,7,0,0,0
202223,VT1E00300T,SCUOLA PRIMARIA,1,9,9,0,0,0
202223,CSTN015007,SCUOLA SECONDARIA II GRADO,4,4,4,0,0,0
202223,VR1MN2500I,SCUOLA SECONDARIA I GRADO,1,21,21,0,0,0
202223,NAPS355009,SCUOLA SECONDARIA II GRADO,1,14,14,0,0,0
202223,MBPS1Q500V,SCUOLA SECONDARIA II GRADO,2,21,21,0,0,0
202223,NATNHS5003,SCUOLA SECONDARIA II GRADO,3,16,16,0,0,0
202223,TE1EDS5004,SCUOLA PRIMARIA,1,12,12,0,0,0
202223,AP1M001005,SCUOLA SECONDARIA I GRADO,1,12,12,0,0,0
202223,MI1E12600R,SCUOLA PRIMARIA,1,75,73,2,0,2
202223,SARHGU5003,SCUOLA SECONDARIA II GRADO,2,4,4,0,0,0
202223,NA1E07500P,SCUOLA PRIMARIA,5,21,18,3,0,3
202223,BGRF2Q5004,SCUOLA SECONDARIA II GRADO,2,22,21,1,0,1
202223,SVPM02500N,SCUOLA SECONDARIA II GRADO,1,22,21,1,1,0
202223,PO1E01700E,SCUOLA PRIMARIA,3,20,12,8,0,8
202223,SATFRP500A,SCUOLA SECONDARIA II GRADO,3,8,7,1,0,1
202223,MI1MB1500E,SCUOLA SECONDARIA I GRADO,3,23,22,1,0,1
202223,RMPM4G5004,SCUOLA SECONDARIA II GRADO,5,13,13,0,0,0
202223,NOPL6T5005,SCUOLA SECONDARIA II GRADO,4,17,14,3,0,3
202223,FITB015001,SCUOLA SECONDARIA II GRADO,4,10,9,1,1,0
202223,ATPS715002,SCUOLA SECONDARIA II GRADO,3,11,10,1,1,0
202223,NA1E06600X,SCUOLA PRIMARIA,5,23,20,3,0,3
202223,MI1E01500D,SCUOLA PRIMARIA,2,29,29,0,0,0
202223,PT1M00200Q,SCUOLA SECONDARIA I GRADO,1,21,17,4,1,3
202223,VA1E01300Q,SCUOLA PRIMARIA,2,28,27,1,0,1
202223,NARH065003,SCUOLA SECONDARIA II GRADO,3,221,221,0,0,0
202223,VE1E006003,SCUOLA PRIMARIA,5,49,43,6,1,5
202223,CO1E01000E,SCUOLA PRIMARIA,2,31,31,0,0,0
202223,UDPS0G500U,SCUOLA SECONDARIA II GRADO,5,14,10,4,2,2
202223,CE1E01200N,SCUOLA PRIMARIA,5,21,18,3,0,3
202223,CE1E01700R,SCUOLA PRIMARIA,2,25,25,0,0,0
202223,CN1M001008,SCUOLA SECONDARIA I GRADO,2,36,35,1,0,1
202223,FG1E024001,SCUOLA PRIMARIA,2,18,18,0,0,0
202223,SAPM53500M,SCUOLA SECONDARIA II GRADO,1,3,3,0,0,0
202223,BAPSV85002,SCUOLA SECONDARIA II GRADO,2,23,23,0,0,0
202223,MO1E00300C,SCUOLA PRIMARIA,3,56,54,2,0,2
202223,MO1E005004,SCUOLA PRIMARIA,5,39,37,2,1,1
202223,RMPS555002,SCUOLA SECONDARIA II GRADO,5,9,9,0,0,0
202223,RM1E09800A,SCUOLA PRIMARIA,1,13,13,0,0,0
202223,FI1E03300C,SCUOLA PRIMARIA,1,19,19,0,0,0
202223,NA1E20200P,SCUOLA PRIMARIA,5,14,14,0,0,0
202223,SATDBD5007,SCUOLA SECONDARIA II GRADO,1,1,1,0,0,0
202223,SATD4U500A,SCUOLA SECONDARIA II GRADO,2,9,9,0,0,0
202223,BS1M013001,SCUOLA SECONDARIA I GRADO,1,75,70,5,1,4
202223,PA1EC8500U,SCUOLA PRIMARIA,1,17,16,1,0,1
202223,AVTDMI500Z,SCUOLA SECONDARIA II GRADO,2,3,3,0,0,0
202223,MIPC005001,SCUOLA SECONDARIA II GRADO,4,26,26,0,0,0
202223,RM1E13100R,SCUOLA PRIMARIA,2,16,16,0,0,0
202223,BA1E00900E,SCUOLA PRIMARIA,5,82,79,3,0,3
202223,SAPMFG500M,SCUOLA SECONDARIA II GRADO,4,13,11,2,0,2
202223,BAPSV85002,SCUOLA SECONDARIA II GRADO,5,68,68,0,0,0
202223,NA1E194001,SCUOLA PRIMARIA,2,11,10,1,0,1
202223,TO1E05600Q,SCUOLA PRIMARIA,1,8,8,0,0,0
202223,CE1E05400Q,SCUOLA PRIMARIA,2,15,15,0,0,0
202223,VA1M01600C,SCUOLA SECONDARIA I GRADO,1,58,57,1,1,0
202223,SATF02500B,SCUOLA SECONDARIA II GRADO,2,5,5,0,0,0
202223,VB1E00300Q,SCUOLA PRIMARIA,4,17,14,3,1,2
202223,BS1M02200Q,SCUOLA SECONDARIA I GRADO,2,30,30,0,0,0
202223,TVPS035008,SCUOLA SECONDARIA II GRADO,1,43,41,2,0,2
202223,TOPS07500A,SCUOLA SECONDARIA II GRADO,5,12,12,0,0,0
202223,RM1E135004,SCUOLA PRIMARIA,4,15,13,2,1,1
202223,MIPC16500D,SCUOLA SECONDARIA II GRADO,1,15,14,1,1,0
202223,PATF02500T,SCUOLA SECONDARIA II GRADO,5,33,33,0,0,0
202223,CT1E008008,SCUOLA PRIMARIA,5,46,45,1,0,1
202223,BG1E01800A,SCUOLA PRIMARIA,2,19,19,0,0,0
202223,BG1E027005,SCUOLA PRIMARIA,2,21,21,0,0,0
202223,RM1M082002,SCUOLA SECONDARIA I GRADO,1,29,28,1,1,0
202223,GEPS70500C,SCUOLA SECONDARIA II GRADO,2,36,36,0,0,0
202223,RMPS165005,SCUOLA SECONDARIA II GRADO,5,17,17,0,0,0
202223,RMPMT1500R,SCUOLA SECONDARIA II GRADO,1,17,16,1,0,1
202223,PVPS775003,SCUOLA SECONDARIA II GRADO,1,4,4,0,0,0
202223,PVTL025009,SCUOLA SECONDARIA II GRADO,4,10,9,1,0,1
202223,NA1E058001,SCUOLA PRIMARIA,3,13,13,0,0,0
202223,SAPS9B500T,SCUOLA SECONDARIA II GRADO,1,9,9,0,0,0
202223,RE1M00600E,SCUOLA SECONDARIA I GRADO,2,28,24,4,0,4
202223,LCTF66500Z,SCUOLA SECONDARIA II GRADO,1,22,20,2,0,2
202223,REPSQE5008,SCUOLA SECONDARIA II GRADO,1,14,13,1,0,1
202223,PAPS8N500C,SCUOLA SECONDARIA II GRADO,2,16,15,1,0,1
202223,PASD01500G,SCUOLA SECONDARIA II GRADO,4,25,25,0,0,0
202223,LTTD035005,SCUOLA SECONDARIA II GRADO,5,21,21,0,0,0
202223,TO1M03200C,SCUOLA SECONDARIA I GRADO,3,42,41,1,0,1
202223,BS1EHN5000,SCUOLA PRIMARIA,1,4,4,0,0,0
202223,SATLO6500Z,SCUOLA SECONDARIA II GRADO,4,3,3,0,0,0
202223,RMPL50500Q,SCUOLA SECONDARIA II GRADO,4,19,19,0,0,0
202223,BG1E01600P,SCUOLA PRIMARIA,1,63,60,3,1,2
202223,PA1E02000B,SCUOLA PRIMARIA,3,13,13,0,0,0
202223,BS1E016007,SCUOLA PRIMARIA,2,27,27,0,0,0
202223,MI1M09500G,SCUOLA SECONDARIA I GRADO,2,104,103,1,0,1
202223,TO1E01500D,SCUOLA PRIMARIA,4,20,20,0,0,0
202223,BG1E01000Q,SCUOLA PRIMARIA,4,21,20,1,0,1
202223,NATD305004,SCUOLA SECONDARIA II GRADO,3,5,5,0,0,0
202223,RM1E18100T,SCUOLA PRIMARIA,3,21,13,8,1,7
202223,VE1M002001,SCUOLA SECONDARIA I GRADO,1,20,20,0,0,0
202223,RO1E00100P,SCUOLA PRIMARIA,4,34,34,0,0,0
202223,RM1E05300R,SCUOLA PRIMARIA,2,28,25,3,1,2
202223,PARH8S500B,SCUOLA SECONDARIA II GRADO,3,4,4,0,0,0
202223,CTTD06500D,SCUOLA SECONDARIA II GRADO,5,12,12,0,0,0
202223,TO1M042003,SCUOLA SECONDARIA I GRADO,2,25,24,1,0,1
202223,CT1E82801D,SCUOLA PRIMARIA,4,10,10,0,0,0
202223,PD1EZU500F,SCUOLA PRIMARIA,4,20,18,2,0,2
202223,LC1E008008,SCUOLA PRIMARIA,4,22,19,3,1,2
202223,NA1E03800Q,SCUOLA PRIMARIA,4,21,21,0,0,0
202223,RMPM5R5008,SCUOLA SECONDARIA II GRADO,5,25,24,1,1,0
202223,GE1E039008,SCUOLA PRIMARIA,1,22,21,1,0,1
202223,VARFIU5007,SCUOLA SECONDARIA II GRADO,1,12,6,6,2,4
202223,RCPC02500G,SCUOLA SECONDARIA II GRADO,1,16,16,0,0,0
202223,RM1M09100R,SCUOLA SECONDARIA I GRADO,1,43,43,0,0,0
202223,SP1M00200D,SCUOLA SECONDARIA I GRADO,1,22,22,0,0,0
202223,GE1E01100C,SCUOLA PRIMARIA,5,44,44,0,0,0
202223,MIPM06500R,SCUOLA SECONDARIA II GRADO,1,11,11,0,0,0
202223,CE1E031003,SCUOLA PRIMARIA,5,10,10,0,0,0
202223,CT1EG5500S,SCUOLA PRIMARIA,3,18,17,1,1,0
202223,PAPM25500A,SCUOLA SECONDARIA II GRADO,3,5,5,0,0,0
202223,RM1E122002,SCUOLA PRIMARIA,2,8,6,2,0,2
202223,RM1E10900G,SCUOLA PRIMARIA,1,17,17,0,0,0
202223,MIPL335009,SCUOLA SECONDARIA II GRADO,2,21,18,3,0,3
202223,VRPL01500D,SCUOLA SECONDARIA II GRADO,4,30,29,1,1,0
202223,NA1E09800B,SCUOLA PRIMARIA,2,14,14,0,0,0
202223,RM1M13300N,SCUOLA SECONDARIA I GRADO,2,33,33,0,0,0
202223,BSSLVV500P,SCUOLA SECONDARIA II GRADO,1,18,17,1,1,0
202223,CL1E00400X,SCUOLA PRIMARIA,2,22,21,1,1,0
202223,NA1E178003,SCUOLA PRIMARIA,5,24,21,3,3,0
202223,CA1M01200C,SCUOLA SECONDARIA I GRADO,1,76,74,2,0,2
202223,MB1E04900D,SCUOLA PRIMARIA,3,55,54,1,0,1
202223,NAPM5I5007,SCUOLA SECONDARIA II GRADO,1,23,23,0,0,0
202223,FI1E03200L,SCUOLA PRIMARIA,1,14,10,4,0,4
202223,VI1M00600G,SCUOLA SECONDARIA I GRADO,1,14,13,1,1,0
202223,SSPM9L500Q,SCUOLA SECONDARIA II GRADO,4,1,1,0,0,0
202223,IM1E00400R,SCUOLA PRIMARIA,5,24,23,1,0,1
202223,PR1E00400G,SCUOLA PRIMARIA,2,33,31,2,1,1
202223,RMPC285004,SCUOLA SECONDARIA II GRADO,3,25,25,0,0,0
202223,NA1E13800L,SCUOLA PRIMARIA,4,17,17,0,0,0
202223,RMPSPN500P,SCUOLA SECONDARIA II GRADO,2,27,26,1,1,0
202223,PD1E00800L,SCUOLA PRIMARIA,4,21,21,0,0,0
202223,GEPS04500R,SCUOLA SECONDARIA II GRADO,4,25,25,0,0,0
202223,RM1M02700D,SCUOLA SECONDARIA I GRADO,3,14,11,3,1,2
202223,MIPSQ55000,SCUOLA SECONDARIA II GRADO,4,21,20,1,0,1
202223,NA1E23000V,SCUOLA PRIMARIA,5,12,12,0,0,0
202223,RM1E19400X,SCUOLA PRIMARIA,1,13,13,0,0,0
202223,NO1E00200X,SCUOLA PRIMARIA,5,41,38,3,0,3
202223,NATD27500D,SCUOLA SECONDARIA II GRADO,1,11,11,0,0,0
202223,SARHTF500G,SCUOLA SECONDARIA II GRADO,5,47,45,2,2,0
202223,NAPSP25001,SCUOLA SECONDARIA II GRADO,1,3,3,0,0,0
202223,NAPM115006,SCUOLA SECONDARIA II GRADO,4,13,12,1,1,0
202223,BGPS00500D,SCUOLA SECONDARIA II GRADO,2,27,27,0,0,0
202223,BNTDOO5001,SCUOLA SECONDARIA II GRADO,3,5,1,4,0,4
202223,NA1E136001,SCUOLA PRIMARIA,3,20,15,5,0,5
202223,UD1M003005,SCUOLA SECONDARIA I GRADO,2,27,27,0,0,0
202223,VRTN025003,SCUOLA SECONDARIA II GRADO,1,27,26,1,1,0
202223,NA1E21700C,SCUOLA PRIMARIA,2,23,23,0,0,0
202223,MBPL315001,SCUOLA SECONDARIA II GRADO,1,25,25,0,0,0
202223,RM1E19600G,SCUOLA PRIMARIA,2,13,11,2,2,0
202223,PGPMCG500I,SCUOLA SECONDARIA II GRADO,3,9,7,2,0,2
202223,VEPS015003,SCUOLA SECONDARIA II GRADO,1,20,19,1,0,1
202223,PNPS03500L,SCUOLA SECONDARIA II GRADO,2,11,11,0,0,0
202223,VA1E008008,SCUOLA PRIMARIA,5,38,38,0,0,0
202223,TO1E016009,SCUOLA PRIMARIA,3,14,13,1,0,1
202223,AGSL015004,SCUOLA SECONDARIA II GRADO,3,9,9,0,0,0
202223,CSPSDO500P,SCUOLA SECONDARIA II GRADO,4,11,10,1,0,1
202223,CSTD03500E,SCUOLA SECONDARIA II GRADO,3,3,3,0,0,0
202223,GE1E019003,SCUOLA PRIMARIA,5,11,11,0,0,0
202223,FR1E002005,SCUOLA PRIMARIA,1,4,4,0,0,0
202223,AN1E002005,SCUOLA PRIMARIA,5,27,26,1,1,0
202223,RM1E06200G,SCUOLA PRIMARIA,5,17,16,1,0,1
202223,SA1E012002,SCUOLA PRIMARIA,2,11,11,0,0,0
202223,RN1M02000L,SCUOLA SECONDARIA I GRADO,1,105,98,7,1,6
202223,RM1E21100C,SCUOLA PRIMARIA,4,20,20,0,0,0
202223,LU1M7F5008,SCUOLA SECONDARIA I GRADO,2,9,8,1,1,0
202223,RM1E199003,SCUOLA PRIMARIA,1,12,11,1,0,1
202223,MI1E08000L,SCUOLA PRIMARIA,3,17,17,0,0,0
202223,CTPM315008,SCUOLA SECONDARIA II GRADO,1,12,12,0,0,0
202223,NATD5N500Q,SCUOLA SECONDARIA II GRADO,2,7,7,0,0,0
202223,BN1ES9500O,SCUOLA PRIMARIA,1,14,14,0,0,0
202223,MI1E06400P,SCUOLA PRIMARIA,5,24,24,0,0,0
202223,SAPME1500D,SCUOLA SECONDARIA II GRADO,1,9,9,0,0,0
202223,FI1E030001,SCUOLA PRIMARIA,4,18,18,0,0,0
202223,ALPMQR5008,SCUOLA SECONDARIA II GRADO,3,7,4,3,0,3
202223,NA1E01900A,SCUOLA PRIMARIA,2,14,14,0,0,0
202223,CE1E065006,SCUOLA PRIMARIA,5,14,14,0,0,0
202223,VR1M02900L,SCUOLA SECONDARIA I GRADO,1,58,58,0,0,0
202223,METD045003,SCUOLA SECONDARIA II GRADO,3,1,1,0,0,0
202223,SV1E00300E,SCUOLA PRIMARIA,3,27,27,0,0,0
202223,VA1E003005,SCUOLA PRIMARIA,1,16,16,0,0,0
202223,TVPL08500G,SCUOLA SECONDARIA II GRADO,5,24,24,0,0,0
202223,NA1E022006,SCUOLA PRIMARIA,3,56,56,0,0,0
202223,BG1M022007,SCUOLA SECONDARIA I GRADO,1,44,43,1,0,1
202223,RM1E13300C,SCUOLA PRIMARIA,4,10,9,1,0,1
202223,NA1E044003,SCUOLA PRIMARIA,4,53,52,1,0,1
202223,CO1MCB500P,SCUOLA SECONDARIA I GRADO,1,14,14,0,0,0
202223,AVTFVM500N,SCUOLA SECONDARIA II GRADO,2,8,8,0,0,0
202223,NA1E25400B,SCUOLA PRIMARIA,1,12,12,0,0,0
202223,ENTDID500H,SCUOLA SECONDARIA II GRADO,3,2,1,1,0,1
202223,BGTFF0500O,SCUOLA SECONDARIA II GRADO,2,14,14,0,0,0
202223,MI1E062003,SCUOLA PRIMARIA,4,77,73,4,1,3
202223,BSTF4M5001,SCUOLA SECONDARIA II GRADO,2,8,6,2,0,2
202223,RM1E01800D,SCUOLA PRIMARIA,4,12,9,3,0,3
202223,TO1E07500P,SCUOLA PRIMARIA,2,38,36,2,1,1
202223,RMTF18500C,SCUOLA SECONDARIA II GRADO,3,13,13,0,0,0
202223,PE1E00600G,SCUOLA PRIMARIA,3,20,18,2,0,2
202223,VITB15500E,SCUOLA SECONDARIA II GRADO,2,11,9,2,0,2
202223,RMPCAM500U,SCUOLA SECONDARIA II GRADO,2,7,7,0,0,0
202223,ME1E01300E,SCUOLA PRIMARIA,2,12,12,0,0,0
202223,TA1E00700G,SCUOLA PRIMARIA,1,18,18,0,0,0
202223,MESD01500T,SCUOLA SECONDARIA II GRADO,4,21,21,0,0,0
202223,TVPMVC5000,SCUOLA SECONDARIA II GRADO,3,22,22,0,0,0
202223,PS1E003007,SCUOLA PRIMARIA,1,18,18,0,0,0
202223,NATFGP5005,SCUOLA SECONDARIA II GRADO,4,4,4,0,0,0
202223,NA1E235002,SCUOLA PRIMARIA,2,26,25,1,1,0
202223,NA1E25100X,SCUOLA PRIMARIA,5,10,10,0,0,0
202223,PATDCH5009,SCUOLA SECONDARIA II GRADO,4,1,1,0,0,0
202223,BGTF015006,SCUOLA SECONDARIA II GRADO,5,21,21,0,0,0
202223,UD1E00400Q,SCUOLA PRIMARIA,4,14,13,1,0,1
202223,NATD575004,SCUOLA SECONDARIA II GRADO,4,6,6,0,0,0
202223,MIPS415006,SCUOLA SECONDARIA II GRADO,2,5,5,0,0,0
202223,NAPS5M500T,SCUOLA SECONDARIA II GRADO,5,3,3,0,0,0
202223,TVPSIL5006,SCUOLA SECONDARIA II GRADO,4,21,21,0,0,0
202223,NATHCU5009,SCUOLA SECONDARIA II GRADO,3,10,10,0,0,0
202223,BSRF3E5000,SCUOLA SECONDARIA II GRADO,4,3,2,1,0,1
202223,RN1E006005,SCUOLA PRIMARIA,3,30,24,6,0,6
202223,VTPMI8500B,SCUOLA SECONDARIA II GRADO,4,5,5,0,0,0
202223,VA1M00300A,SCUOLA SECONDARIA I GRADO,1,8,7,1,0,1
202223,TV1E00200Q,SCUOLA PRIMARIA,5,52,50,2,0,2
202223,PEPC8E500U,SCUOLA SECONDARIA II GRADO,2,11,11,0,0,0
202223,TARI00500A,SCUOLA SECONDARIA II GRADO,1,1,1,0,0,0
202223,RI1E00100D,SCUOLA PRIMARIA,3,8,7,1,0,1
202223,ME1MU5500F,SCUOLA SECONDARIA I GRADO,2,11,10,1,0,1
202223,MISL075007,SCUOLA SECONDARIA II GRADO,1,46,46,0,0,0
202223,NA1EAN500C,SCUOLA PRIMARIA,4,31,30,1,0,1
202223,BSPMVC500O,SCUOLA SECONDARIA II GRADO,2,12,11,1,1,0
202223,VE1E00100X,SCUOLA PRIMARIA,3,13,12,1,1,0
202223,FI1E006004,SCUOLA PRIMARIA,1,21,19,2,1,1
202223,VAPMV0500Q,SCUOLA SECONDARIA II GRADO,3,22,22,0,0,0
202223,VATD12500X,SCUOLA SECONDARIA II GRADO,4,18,17,1,0,1
202223,MIPS16500L,SCUOLA SECONDARIA II GRADO,2,87,87,0,0,0
202223,RMTD67500X,SCUOLA SECONDARIA II GRADO,1,11,9,2,0,2
202223,RMTB00500D,SCUOLA SECONDARIA II GRADO,3,16,12,4,3,1
202223,MIPSQB5007,SCUOLA SECONDARIA II GRADO,5,25,24,1,0,1
202223,PO1E00200R,SCUOLA PRIMARIA,2,15,15,0,0,0
202223,BOTB02500D,SCUOLA SECONDARIA II GRADO,5,14,12,2,1,1
202223,RGTD11500L,SCUOLA SECONDARIA II GRADO,2,2,2,0,0,0
202223,NARH9B500E,SCUOLA SECONDARIA II GRADO,3,14,14,0,0,0
202223,BSPS2M500I,SCUOLA SECONDARIA II GRADO,2,21,21,0,0,0
202223,VE1E013006,SCUOLA PRIMARIA,1,18,17,1,0,1
202223,PD1E076018,SCUOLA PRIMARIA,1,21,20,1,0,1
202223,GE1E03600R,SCUOLA PRIMARIA,3,25,23,2,0,2
202223,CE1E00300V,SCUOLA PRIMARIA,4,11,10,1,0,1
202223,NA1E27400L,SCUOLA PRIMARIA,5,69,67,2,1,1
202223,FG1E01300E,SCUOLA PRIMARIA,1,13,13,0,0,0
202223,VI1E002003,SCUOLA PRIMARIA,4,16,16,0,0,0
202223,LO1E002003,SCUOLA PRIMARIA,5,19,17,2,0,2
202223,TO1E038006,SCUOLA PRIMARIA,3,15,15,0,0,0
202223,TO1E02200L,SCUOLA PRIMARIA,1,32,31,1,0,1
202223,NA1E199004,SCUOLA PRIMARIA,4,11,11,0,0,0
202223,RMPS485001,SCUOLA SECONDARIA II GRADO,3,12,12,0,0,0
202223,RM1E08900G,SCUOLA PRIMARIA,1,13,12,1,0,1
202223,PTPM02500D,SCUOLA SECONDARIA II GRADO,3,32,29,3,0,3
202223,AGTL4P500L,SCUOLA SECONDARIA II GRADO,4,4,4,0,0,0
202223,BO1M001004,SCUOLA SECONDARIA I GRADO,1,41,41,0,0,0
202223,BO1M00800V,SCUOLA SECONDARIA I GRADO,1,41,37,4,0,4
202223,MIPMRI500E,SCUOLA SECONDARIA II GRADO,3,75,70,5,0,5
202223,FI1M02100B,SCUOLA SECONDARIA I GRADO,2,38,37,1,0,1
202223,VA1E004001,SCUOLA PRIMARIA,5,20,20,0,0,0
202223,NARFGU5004,SCUOLA SECONDARIA II GRADO,5,69,64,5,1,4
202223,RM1ES9500O,SCUOLA PRIMARIA,1,7,6,1,0,1
202223,RM1ERP500L,SCUOLA PRIMARIA,4,13,13,0,0,0
202223,RM1E156005,SCUOLA PRIMARIA,4,12,12,0,0,0
202223,CORA025003,SCUOLA SECONDARIA II GRADO,3,18,17,1,0,1
202223,CO1E005003,SCUOLA PRIMARIA,3,32,30,2,1,1
202223,TOPS20500T,SCUOLA SECONDARIA II GRADO,1,25,22,3,1,2
202223,RC1E01100G,SCUOLA PRIMARIA,2,10,9,1,0,1
202223,RMRH00500A,SCUOLA SECONDARIA II GRADO,1,11,11,0,0,0
202223,PD1E00200N,SCUOLA PRIMARIA,1,9,8,1,0,1
202223,BN1E001006,SCUOLA PRIMARIA,3,34,32,2,0,2
202223,FG1E016002,SCUOLA PRIMARIA,5,9,6,3,3,0
202223,MI1E03100B,SCUOLA PRIMARIA,3,51,51,0,0,0
202223,NA1E00300R,SCUOLA PRIMARIA,1,10,9,1,0,1
202223,CLTD9T500A,SCUOLA SECONDARIA II GRADO,1,3,2,1,0,1
202223,RMPS59500C,SCUOLA SECONDARIA II GRADO,5,27,25,2,0,2
202223,NAPL00500C,SCUOLA SECONDARIA II GRADO,3,5,5,0,0,0
202223,BO1E018008,SCUOLA PRIMARIA,5,20,18,2,0,2
202223,RM1E01200E,SCUOLA PRIMARIA,5,39,36,3,1,2
202223,SATDG0500E,SCUOLA SECONDARIA II GRADO,5,65,57,8,1,7
202223,GRPS005002,SCUOLA SECONDARIA II GRADO,4,10,9,1,0,1
202223,NA1M059002,SCUOLA SECONDARIA I GRADO,2,12,11,1,0,1
202223,BSPSB05000,SCUOLA SECONDARIA II GRADO,5,20,19,1,0,1
202223,PA1E048007,SCUOLA PRIMARIA,5,24,24,0,0,0
202223,NATF37500L,SCUOLA SECONDARIA II GRADO,1,8,8,0,0,0
202223,COPSTL500E,SCUOLA SECONDARIA II GRADO,3,5,5,0,0,0
202223,TOPS105001,SCUOLA SECONDARIA II GRADO,4,86,83,3,0,3
202223,FG1E01100V,SCUOLA PRIMARIA,3,10,8,2,0,2
202223,BS1E01400G,SCUOLA PRIMARIA,1,27,27,0,0,0
202223,MITF11500N,SCUOLA SECONDARIA II GRADO,3,158,158,0,0,0
202223,MS1EO3500D,SCUOLA PRIMARIA,1,12,11,1,0,1
202223,PV1M00600N,SCUOLA SECONDARIA I GRADO,2,32,30,2,0,2
202223,APPC0Q500G,SCUOLA SECONDARIA II GRADO,3,10,9,1,0,1
202223,MI1E13000C,SCUOLA PRIMARIA,4,23,23,0,0,0
202223,NA1E17000C,SCUOLA PRIMARIA,3,11,11,0,0,0
202223,LCPSU45004,SCUOLA SECONDARIA II GRADO,5,20,20,0,0,0
202223,MI1M05100T,SCUOLA SECONDARIA I GRADO,3,27,22,5,0,5
202223,FRPSII500H,SCUOLA SECONDARIA II GRADO,2,13,13,0,0,0
202223,FRTD00500N,SCUOLA SECONDARIA II GRADO,3,6,6,0,0,0
202223,CETD115003,SCUOLA SECONDARIA II GRADO,1,5,4,1,0,1
202223,VA1M02100X,SCUOLA SECONDARIA I GRADO,1,20,20,0,0,0
202223,TO1E6R5003,SCUOLA PRIMARIA,2,43,43,0,0,0
202223,BSRF06500X,SCUOLA SECONDARIA II GRADO,4,27,27,0,0,0
202223,SATFH5500B,SCUOLA SECONDARIA II GRADO,2,2,2,0,0,0
202223,RMPS0V500L,SCUOLA SECONDARIA II GRADO,2,1,1,0,0,0
202223,MI1M098003,SCUOLA SECONDARIA I GRADO,3,118,116,2,1,1
202223,NA1E06700Q,SCUOLA PRIMARIA,2,53,53,0,0,0
202223,TV1M006008,SCUOLA SECONDARIA I GRADO,1,31,30,1,1,0
202223,SO1E00100E,SCUOLA PRIMARIA,4,12,11,1,0,1
202223,TV1E019005,SCUOLA PRIMARIA,3,19,17,2,0,2
202223,RM1E07000E,SCUOLA PRIMARIA,2,35,35,0,0,0
202223,MIPS09500G,SCUOLA SECONDARIA II GRADO,2,67,62,5,0,5
202223,PAPS10500B,SCUOLA SECONDARIA II GRADO,4,2,2,0,0,0
202223,CERVEN500Q,SCUOLA SECONDARIA II GRADO,4,8,7,1,0,1
202223,LUPS025006,SCUOLA SECONDARIA II GRADO,3,9,6,3,0,3
202223,FI1E00700X,SCUOLA PRIMARIA,3,10,8,2,1,1
202223,VAPSE5500O,SCUOLA SECONDARIA II GRADO,2,17,16,1,1,0
202223,BR1E00200T,SCUOLA PRIMARIA,3,9,9,0,0,0
202223,RMPS695009,SCUOLA SECONDARIA II GRADO,3,19,18,1,0,1
202223,RMPS46500Q,SCUOLA SECONDARIA II GRADO,3,16,14,2,0,2
202223,RM1E10300L,SCUOLA PRIMARIA,5,63,61,2,1,1
202223,FI1E026009,SCUOLA PRIMARIA,4,23,22,1,0,1
202223,MB1EF5500A,SCUOLA PRIMARIA,1,10,10,0,0,0
202223,BOPSR2500M,SCUOLA SECONDARIA II GRADO,2,48,48,0,0,0
202223,LTPST2500E,SCUOLA SECONDARIA II GRADO,4,22,22,0,0,0
202223,PA1EZG500F,SCUOLA PRIMARIA,3,1,1,0,0,0
202223,AVTFTA500S,SCUOLA SECONDARIA II GRADO,2,6,6,0,0,0
202223,NATDPG500E,SCUOLA SECONDARIA II GRADO,3,1,1,0,0,0
202223,TOPL66500H,SCUOLA SECONDARIA II GRADO,3,26,25,1,0,1
202223,RMPSRP5006,SCUOLA SECONDARIA II GRADO,3,16,12,4,1,3
202223,VARCD7500V,SCUOLA SECONDARIA II GRADO,1,47,47,0,0,0
202223,NAPS39500Q,SCUOLA SECONDARIA II GRADO,4,6,6,0,0,0
202223,RC1E01100G,SCUOLA PRIMARIA,4,12,12,0,0,0
202223,MI1E06000B,SCUOLA PRIMARIA,1,38,31,7,1,6
202223,RM1E01600T,SCUOLA PRIMARIA,3,12,11,1,0,1
202223,MI1M03100L,SCUOLA SECONDARIA I GRADO,1,56,56,0,0,0
202223,SAPS975006,SCUOLA SECONDARIA II GRADO,5,19,18,1,0,1
202223,PT1E00600T,SCUOLA PRIMARIA,2,26,25,1,1,0
202223,CE1E02500Q,SCUOLA PRIMARIA,2,10,9,1,0,1
202223,CTTN01500A,SCUOLA SECONDARIA II GRADO,4,5,4,1,0,1
202223,SVPS015002,SCUOLA SECONDARIA II GRADO,2,32,30,2,0,2
202223,BS1EU3500Q,SCUOLA PRIMARIA,1,32,26,6,0,6
202223,BO1E013005,SCUOLA PRIMARIA,2,22,21,1,1,0
202223,AVRH2Q500U,SCUOLA SECONDARIA II GRADO,3,70,69,1,1,0
202223,TOPL11500A,SCUOLA SECONDARIA II GRADO,2,15,14,1,1,0
202223,VRPSEM5005,SCUOLA SECONDARIA II GRADO,2,11,11,0,0,0
202223,NA1E11700G,SCUOLA PRIMARIA,2,23,22,1,0,1
202223,GO1E002006,SCUOLA PRIMARIA,4,12,12,0,0,0
202223,PVPS025003,SCUOLA SECONDARIA II GRADO,5,10,10,0,0,0
202223,PVSLMT5003,SCUOLA SECONDARIA II GRADO,3,4,4,0,0,0
202223,MI1E445002,SCUOLA PRIMARIA,4,62,55,7,3,4
202223,SARF17500D,SCUOLA SECONDARIA II GRADO,4,10,10,0,0,0
202223,PAPSVD500Q,SCUOLA SECONDARIA II GRADO,1,5,5,0,0,0
202223,LU1E00600G,SCUOLA PRIMARIA,2,19,17,2,2,0
202223,VRPSN9500T,SCUOLA SECONDARIA II GRADO,3,30,30,0,0,0
202223,MI1E12100N,SCUOLA PRIMARIA,2,29,27,2,0,2
202223,PA1E01000R,SCUOLA PRIMARIA,1,17,17,0,0,0
202223,NATD1E500I,SCUOLA SECONDARIA II GRADO,5,58,55,3,0,3
202223,NA1E06100R,SCUOLA PRIMARIA,5,20,20,0,0,0
202223,BGPS12500G,SCUOLA SECONDARIA II GRADO,4,9,9,0,0,0
202223,SARIF2500L,SCUOLA SECONDARIA II GRADO,1,3,2,1,0,1
202223,AL1M006003,SCUOLA SECONDARIA I GRADO,2,27,22,5,3,2
202223,GE1E027002,SCUOLA PRIMARIA,5,13,13,0,0,0
202223,SA1E004003,SCUOLA PRIMARIA,2,25,25,0,0,0
202223,VT1M00600E,SCUOLA SECONDARIA I GRADO,3,23,22,1,0,1
202223,VR1EEF5000,SCUOLA PRIMARIA,4,35,35,0,0,0
202223,NA1E051006,SCUOLA PRIMARIA,3,21,20,1,0,1
202223,BO1E01100D,SCUOLA PRIMARIA,4,40,37,3,0,3
202223,COPL08500X,SCUOLA SECONDARIA II GRADO,2,23,22,1,1,0
202223,NA1E128002,SCUOLA PRIMARIA,5,10,9,1,0,1
202223,FIPM69500H,SCUOLA SECONDARIA II GRADO,3,8,8,0,0,0
202223,FIPS065005,SCUOLA SECONDARIA II GRADO,2,5,3,2,0,2
202223,RMPL355003,SCUOLA SECONDARIA II GRADO,1,3,3,0,0,0
202223,MIPS42500R,SCUOLA SECONDARIA II GRADO,2,57,54,3,0,3
202223,MI1E05700G,SCUOLA PRIMARIA,4,33,31,2,0,2
202223,LO1E001007,SCUOLA PRIMARIA,5,23,23,0,0,0
202223,MBPC215006,SCUOLA SECONDARIA II GRADO,5,16,16,0,0,0
202223,BG1E00900G,SCUOLA PRIMARIA,3,12,12,0,0,0
202223,CA1E01100B,SCUOLA PRIMARIA,1,21,20,1,0,1
202223,RM1E03400B,SCUOLA PRIMARIA,2,10,10,0,0,0
202223,RM1E049005,SCUOLA PRIMARIA,2,27,26,1,0,1
202223,RMTD7E500U,SCUOLA SECONDARIA II GRADO,4,2,1,1,0,1
202223,TO1E024008,SCUOLA PRIMARIA,1,42,36,6,2,4
202223,PERF71500A,SCUOLA SECONDARIA II GRADO,1,17,17,0,0,0
202223,SA1E02600X,SCUOLA PRIMARIA,3,4,4,0,0,0
202223,BSPM4P500U,SCUOLA SECONDARIA II GRADO,1,23,23,0,0,0
202223,VR1M00300C,SCUOLA SECONDARIA I GRADO,2,57,57,0,0,0
202223,NATDNH500U,SCUOLA SECONDARIA II GRADO,3,5,5,0,0,0
202223,RMPM3G5002,SCUOLA SECONDARIA II GRADO,5,33,26,7,1,6
202223,MIPLGB500O,SCUOLA SECONDARIA II GRADO,3,25,25,0,0,0
202223,NATD475007,SCUOLA SECONDARIA II GRADO,5,70,68,2,1,1
202223,FIPS00500D,SCUOLA SECONDARIA II GRADO,3,17,17,0,0,0
202223,VRPL01500D,SCUOLA SECONDARIA II GRADO,3,30,29,1,0,1
202223,CEPS16500H,SCUOLA SECONDARIA II GRADO,4,15,14,1,0,1
202223,NA1E09100L,SCUOLA PRIMARIA,1,26,26,0,0,0
202223,CR1E00700T,SCUOLA PRIMARIA,1,14,11,3,0,3
202223,NA1E006008,SCUOLA PRIMARIA,2,19,14,5,0,5
202223,BSTD355007,SCUOLA SECONDARIA II GRADO,3,6,5,1,0,1
202223,AP1E00400B,SCUOLA PRIMARIA,4,11,10,1,0,1
202223,CA1EN7500O,SCUOLA PRIMARIA,3,26,26,0,0,0
202223,RMTFNG5000,SCUOLA SECONDARIA II GRADO,2,6,5,1,0,1
202223,MB1E05000N,SCUOLA PRIMARIA,3,69,68,1,1,0
202223,PEPS005001,SCUOLA SECONDARIA II GRADO,1,18,16,2,0,2
202223,BGTB015001,SCUOLA SECONDARIA II GRADO,1,56,44,12,2,10
202223,CETFOD5002,SCUOLA SECONDARIA II GRADO,5,70,68,2,1,1
202223,RMPC26500V,SCUOLA SECONDARIA II GRADO,3,18,17,1,0,1
202223,CORF8L5003,SCUOLA SECONDARIA II GRADO,3,1,1,0,0,0
202223,RM1E11000Q,SCUOLA PRIMARIA,3,44,42,2,0,2
202223,MIPLMC5009,SCUOLA SECONDARIA II GRADO,2,5,4,1,0,1
202223,MIPS54500V,SCUOLA SECONDARIA II GRADO,4,26,26,0,0,0
202223,RM1M06300L,SCUOLA SECONDARIA I GRADO,3,26,26,0,0,0
202223,MIPSO8500I,SCUOLA SECONDARIA II GRADO,4,22,22,0,0,0
202223,SAPS09500G,SCUOLA SECONDARIA II GRADO,4,7,7,0,0,0
202223,PVPLHO500H,SCUOLA SECONDARIA II GRADO,2,7,7,0,0,0
202223,PDTD01500R,SCUOLA SECONDARIA II GRADO,5,13,12,1,0,1
202223,VI1E01200N,SCUOLA PRIMARIA,5,43,36,7,3,4
202223,TA1E003008,SCUOLA PRIMARIA,5,13,13,0,0,0
202223,RM1E014006,SCUOLA PRIMARIA,2,26,26,0,0,0
202223,BS1E01900P,SCUOLA PRIMARIA,5,28,24,4,0,4
202223,BGPMDF500L,SCUOLA SECONDARIA II GRADO,5,7,7,0,0,0
202223,NATFDD500F,SCUOLA SECONDARIA II GRADO,3,7,7,0,0,0
202223,GE1M02300X,SCUOLA SECONDARIA I GRADO,3,19,14,5,0,5
202223,VT1E006009,SCUOLA PRIMARIA,2,21,21,0,0,0
202223,CO1E00100Q,SCUOLA PRIMARIA,2,31,26,5,1,4
202223,CSTDIB500Z,SCUOLA SECONDARIA II GRADO,4,5,5,0,0,0
202223,SATFEP500M,SCUOLA SECONDARIA II GRADO,4,5,4,1,0,1
202223,MIPSEA5006,SCUOLA SECONDARIA II GRADO,1,30,30,0,0,0
202223,MOTD01500Q,SCUOLA SECONDARIA II GRADO,5,25,23,2,0,2
202223,RM1E19400X,SCUOLA PRIMARIA,4,16,16,0,0,0
202223,TO1E00100G,SCUOLA PRIMARIA,3,56,54,2,0,2
202223,LE1M00400B,SCUOLA SECONDARIA I GRADO,3,25,24,1,0,1
202223,VEPL01500T,SCUOLA SECONDARIA II GRADO,4,9,9,0,0,0
202223,CS1E003002,SCUOLA PRIMARIA,2,21,21,0,0,0
202223,RMPL22500A,SCUOLA SECONDARIA II GRADO,2,11,10,1,0,1
202223,RM1E072006,SCUOLA PRIMARIA,1,23,23,0,0,0
202223,REPS00500P,SCUOLA SECONDARIA II GRADO,1,5,5,0,0,0
202223,GE1E02200V,SCUOLA PRIMARIA,3,22,20,2,0,2
202223,RGPM00500A,SCUOLA SECONDARIA II GRADO,3,3,3,0,0,0
202223,VAPS6M5003,SCUOLA SECONDARIA II GRADO,1,52,51,1,0,1
202223,RM1E20200N,SCUOLA PRIMARIA,5,26,26,0,0,0
202223,CTPC605004,SCUOLA SECONDARIA II GRADO,2,1,1,0,0,0
202223,PD1M01000T,SCUOLA SECONDARIA I GRADO,2,74,73,1,1,0
202223,PDPS035006,SCUOLA SECONDARIA II GRADO,3,28,28,0,0,0
202223,PATD27500A,SCUOLA SECONDARIA II GRADO,4,2,2,0,0,0
202223,MC1E001003,SCUOLA PRIMARIA,5,21,21,0,0,0
202223,RMTD72500Q,SCUOLA SECONDARIA II GRADO,5,61,59,2,0,2
202223,MB1M009008,SCUOLA SECONDARIA I GRADO,3,74,74,0,0,0
202223,MI1E020001,SCUOLA PRIMARIA,1,36,33,3,0,3
202223,RE1EE9500Z,SCUOLA PRIMARIA,4,21,21,0,0,0
202223,VI1E007006,SCUOLA PRIMARIA,5,37,37,0,0,0
202223,NA1E1M500R,SCUOLA PRIMARIA,3,8,2,6,0,6
202223,VA1E011004,SCUOLA PRIMARIA,1,15,15,0,0,0
202223,BORC10500R,SCUOLA SECONDARIA II GRADO,4,27,25,2,0,2
202223,RM1M01100X,SCUOLA SECONDARIA I GRADO,3,29,29,0,0,0
202223,NARH105008,SCUOLA SECONDARIA II GRADO,3,9,9,0,0,0
202223,LC1E00100D,SCUOLA PRIMARIA,3,17,17,0,0,0
202223,NA1E01900A,SCUOLA PRIMARIA,4,21,21,0,0,0
202223,BG1M01200L,SCUOLA SECONDARIA I GRADO,1,62,62,0,0,0
202223,CTPM415005,SCUOLA SECONDARIA II GRADO,1,6,6,0,0,0
202223,NA1E25200Q,SCUOLA PRIMARIA,1,21,21,0,0,0
202223,TOPM035001,SCUOLA SECONDARIA II GRADO,1,38,36,2,1,1
202223,APRFSQ500B,SCUOLA SECONDARIA II GRADO,1,2,2,0,0,0
202223,MCPL0P500L,SCUOLA SECONDARIA II GRADO,4,3,3,0,0,0
202223,MBTD35500C,SCUOLA SECONDARIA II GRADO,4,15,15,0,0,0
202223,RM1MMF500S,SCUOLA SECONDARIA I GRADO,3,50,48,2,1,1
202223,MI1E05600Q,SCUOLA PRIMARIA,4,24,24,0,0,0
202223,MS1E00400V,SCUOLA PRIMARIA,5,19,18,1,1,0
202223,RMPMR25005,SCUOLA SECONDARIA II GRADO,1,9,9,0,0,0
202223,CL1E002008,SCUOLA PRIMARIA,3,13,13,0,0,0
202223,CA1E01500P,SCUOLA PRIMARIA,1,20,20,0,0,0
202223,RMPSBI5001,SCUOLA SECONDARIA II GRADO,4,28,27,1,1,0
202223,TO1E05200C,SCUOLA PRIMARIA,3,14,14,0,0,0
202223,RM1E100005,SCUOLA PRIMARIA,3,26,26,0,0,0
202223,VI1M01500A,SCUOLA SECONDARIA I GRADO,3,11,11,0,0,0
202223,CTTE01500X,SCUOLA SECONDARIA II GRADO,2,13,13,0,0,0
202223,ME1E00300X,SCUOLA PRIMARIA,1,12,12,0,0,0
202223,VA1EZH500L,SCUOLA PRIMARIA,1,32,29,3,1,2
202223,SATD4D500E,SCUOLA SECONDARIA II GRADO,2,7,7,0,0,0
202223,PA1E04500Q,SCUOLA PRIMARIA,1,32,32,0,0,0
202223,ISPL5F5001,SCUOLA SECONDARIA II GRADO,5,12,12,0,0,0
202223,NATDFO5000,SCUOLA SECONDARIA II GRADO,3,9,9,0,0,0
202223,NA1E243001,SCUOLA PRIMARIA,2,11,11,0,0,0
202223,CZPL925000,SCUOLA SECONDARIA II GRADO,4,9,9,0,0,0
202223,MBPS8T500R,SCUOLA SECONDARIA II GRADO,4,28,28,0,0,0
202223,PD1E013004,SCUOLA PRIMARIA,3,35,35,0,0,0
202223,MIPSQV500F,SCUOLA SECONDARIA II GRADO,1,27,27,0,0,0
202223,CHRI00500N,SCUOLA SECONDARIA II GRADO,5,3,3,0,0,0
202223,NA1E18100V,SCUOLA PRIMARIA,2,23,12,11,1,10
202223,VR1E004003,SCUOLA PRIMARIA,2,18,16,2,0,2
202223,CE1E06400A,SCUOLA PRIMARIA,3,11,11,0,0,0
202223,NAPMSV500U,SCUOLA SECONDARIA II GRADO,5,104,100,4,2,2
202223,MCRF3O5008,SCUOLA SECONDARIA II GRADO,5,33,31,2,0,2
202223,MITB025006,SCUOLA SECONDARIA II GRADO,4,42,36,6,0,6
202223,VA1M00800D,SCUOLA SECONDARIA I GRADO,3,103,103,0,0,0
202223,BSPS2M500I,SCUOLA SECONDARIA II GRADO,3,17,15,2,0,2
202223,TO1M01000G,SCUOLA SECONDARIA I GRADO,1,25,24,1,1,0
202223,FI1E01200B,SCUOLA PRIMARIA,5,24,24,0,0,0
202223,CTPSPS5003,SCUOLA SECONDARIA II GRADO,4,12,12,0,0,0
202223,RM1E119006,SCUOLA PRIMARIA,2,11,11,0,0,0
202223,AR1E001005,SCUOLA PRIMARIA,5,13,12,1,1,0
202223,MIPS175007,SCUOLA SECONDARIA II GRADO,2,34,33,1,0,1
202223,NA1E22300Q,SCUOLA PRIMARIA,1,42,41,1,0,1
202223,BS1E01800V,SCUOLA PRIMARIA,5,52,52,0,0,0
202223,RMPMSC500I,SCUOLA SECONDARIA II GRADO,4,8,8,0,0,0
202223,CH1E005007,SCUOLA PRIMARIA,5,26,26,0,0,0
202223,NA1E15500A,SCUOLA PRIMARIA,3,15,12,3,0,3
202223,MI1M06000L,SCUOLA SECONDARIA I GRADO,1,82,80,2,0,2
202223,SASLFZ5001,SCUOLA SECONDARIA II GRADO,5,63,61,2,0,2
202223,NA1MU75009,SCUOLA SECONDARIA I GRADO,2,6,2,4,0,4
202223,MIPMRI500E,SCUOLA SECONDARIA II GRADO,4,70,66,4,1,3
202223,FR1E00500L,SCUOLA PRIMARIA,4,10,10,0,0,0
202223,FRPM9G500T,SCUOLA SECONDARIA II GRADO,4,3,1,2,0,2
202223,SA1E00700E,SCUOLA PRIMARIA,5,8,8,0,0,0
202223,RM1E00500B,SCUOLA PRIMARIA,1,20,19,1,0,1
202223,NA1M003002,SCUOLA SECONDARIA I GRADO,2,86,86,0,0,0
202223,FI1E001001,SCUOLA PRIMARIA,1,5,4,1,1,0
202223,SATFHU5008,SCUOLA SECONDARIA II GRADO,5,70,70,0,0,0
202223,VARFS2500Z,SCUOLA SECONDARIA II GRADO,4,12,12,0,0,0
202223,NA1E094004,SCUOLA PRIMARIA,1,15,15,0,0,0
202223,BS1E00500R,SCUOLA PRIMARIA,2,31,30,1,1,0
202223,NA1E218008,SCUOLA PRIMARIA,4,19,19,0,0,0
202223,BA1E01100E,SCUOLA PRIMARIA,1,12,9,3,1,2
202223,CS1E00600D,SCUOLA PRIMARIA,2,18,18,0,0,0
202223,TOTF01500R,SCUOLA SECONDARIA II GRADO,1,81,77,4,0,4
202223,VI1E001007,SCUOLA PRIMARIA,4,22,18,4,1,3
202223,AGTD4U500B,SCUOLA SECONDARIA II GRADO,1,3,3,0,0,0
202223,TO1E020001,SCUOLA PRIMARIA,3,23,23,0,0,0
202223,FI1M008001,SCUOLA SECONDARIA I GRADO,1,10,10,0,0,0
202223,VA1E9G500A,SCUOLA PRIMARIA,2,17,16,1,1,0
202223,PV1E007008,SCUOLA PRIMARIA,4,21,16,5,0,5
202223,NA1E205006,SCUOLA PRIMARIA,3,12,7,5,0,5
202223,RM1EZR5005,SCUOLA PRIMARIA,2,13,12,1,0,1
202223,LC1E00500R,SCUOLA PRIMARIA,3,51,49,2,0,2
202223,BGPL055009,SCUOLA SECONDARIA II GRADO,4,23,23,0,0,0
202223,TOPS105001,SCUOLA SECONDARIA II GRADO,3,87,81,6,2,4
202223,RC1E00700X,SCUOLA PRIMARIA,3,17,16,1,0,1
202223,TOPC075007,SCUOLA SECONDARIA II GRADO,3,40,40,0,0,0
202223,NA1E11100L,SCUOLA PRIMARIA,2,10,10,0,0,0
202223,FG1E01100V,SCUOLA PRIMARIA,4,15,15,0,0,0
202223,TO1M05100T,SCUOLA SECONDARIA I GRADO,1,49,31,18,7,11
202223,CERH325008,SCUOLA SECONDARIA II GRADO,2,7,7,0,0,0
202223,MI1E038006,SCUOLA PRIMARIA,1,23,22,1,0,1
202223,NATL16500C,SCUOLA SECONDARIA II GRADO,4,6,6,0,0,0
202223,LI1E00900L,SCUOLA PRIMARIA,5,28,28,0,0,0
202223,MI1E06600A,SCUOLA PRIMARIA,1,46,45,1,1,0
202223,RM1E014006,SCUOLA PRIMARIA,3,19,19,0,0,0
202223,TP1E003005,SCUOLA PRIMARIA,3,4,3,1,0,1
202223,RMTL395001,SCUOLA SECONDARIA II GRADO,4,6,5,1,1,0
202223,TV1E00200Q,SCUOLA PRIMARIA,3,45,43,2,1,1
202223,SR1E009008,SCUOLA PRIMARIA,2,19,18,1,0,1
202223,BO1E020008,SCUOLA PRIMARIA,1,60,59,1,0,1
202223,MIPM07500B,SCUOLA SECONDARIA II GRADO,4,29,29,0,0,0
202223,PG1E00400E,SCUOLA PRIMARIA,2,13,10,3,1,2
202223,MERH015005,SCUOLA SECONDARIA II GRADO,5,31,31,0,0,0
202223,SATDD75001,SCUOLA SECONDARIA II GRADO,5,43,42,1,0,1
202223,BO1E00800N,SCUOLA PRIMARIA,3,16,14,2,0,2
202223,BL1M00200L,SCUOLA SECONDARIA I GRADO,1,50,49,1,0,1
202223,RM1M05100A,SCUOLA SECONDARIA I GRADO,2,19,19,0,0,0
202223,RM1E180002,SCUOLA PRIMARIA,3,35,31,4,0,4
202223,CLPC025003,SCUOLA SECONDARIA II GRADO,5,4,4,0,0,0
202223,MI1E13000C,SCUOLA PRIMARIA,5,27,26,1,1,0
202223,LCPM3P500N,SCUOLA SECONDARIA II GRADO,1,23,23,0,0,0
202223,MI1M03600Q,SCUOLA SECONDARIA I GRADO,1,23,20,3,0,3
202223,CE1E03400E,SCUOLA PRIMARIA,5,25,25,0,0,0
202223,CE1E05000C,SCUOLA PRIMARIA,3,21,21,0,0,0
202223,VA1M017008,SCUOLA SECONDARIA I GRADO,1,118,116,2,1,1
202223,TA1E009007,SCUOLA PRIMARIA,1,13,13,0,0,0
202223,FO1E002002,SCUOLA PRIMARIA,4,8,6,2,1,1
202223,PR1E001004,SCUOLA PRIMARIA,3,49,49,0,0,0
202223,VE1E00200Q,SCUOLA PRIMARIA,3,24,24,0,0,0
202223,VATFME500R,SCUOLA SECONDARIA II GRADO,1,12,11,1,0,1
202223,RM1E106004,SCUOLA PRIMARIA,1,22,22,0,0,0
202223,AV1E010005,SCUOLA PRIMARIA,3,21,21,0,0,0
202223,NATD355005,SCUOLA SECONDARIA II GRADO,1,18,18,0,0,0
202223,SARHGL500M,SCUOLA SECONDARIA II GRADO,1,5,5,0,0,0
202223,NO1M01100X,SCUOLA SECONDARIA I GRADO,1,132,127,5,0,5
202223,TV1E01700D,SCUOLA PRIMARIA,2,54,54,0,0,0
202223,PAPMO7500Q,SCUOLA SECONDARIA II GRADO,5,53,46,7,2,5
202223,FIPL005008,SCUOLA SECONDARIA II GRADO,4,11,10,1,0,1
202223,CETB015007,SCUOLA SECONDARIA II GRADO,3,16,16,0,0,0
202223,PR1E00500B,SCUOLA PRIMARIA,2,31,30,1,1,0
202223,BGPL04500P,SCUOLA SECONDARIA II GRADO,2,35,35,0,0,0
202223,RMPM55500G,SCUOLA SECONDARIA II GRADO,2,13,13,0,0,0
202223,UD1M009004,SCUOLA SECONDARIA I GRADO,1,21,19,2,0,2
202223,FITB015001,SCUOLA SECONDARIA II GRADO,3,19,18,1,0,1
202223,BG1E001001,SCUOLA PRIMARIA,2,47,46,1,1,0
202223,RMPS53500R,SCUOLA SECONDARIA II GRADO,3,19,16,3,0,3
202223,TO1E047001,SCUOLA PRIMARIA,3,36,21,15,3,12
202223,RM1E09500V,SCUOLA PRIMARIA,3,27,26,1,0,1
202223,FIPC035006,SCUOLA SECONDARIA II GRADO,5,13,13,0,0,0
202223,NATDZR500T,SCUOLA SECONDARIA II GRADO,5,175,162,13,0,13
202223,CE1E01200N,SCUOLA PRIMARIA,3,16,13,3,0,3
202223,FIPLV0500F,SCUOLA SECONDARIA II GRADO,1,6,5,1,0,1
202223,SAPLLV500D,SCUOLA SECONDARIA II GRADO,3,8,8,0,0,0
202223,MOPS01500X,SCUOLA SECONDARIA II GRADO,2,4,4,0,0,0
202223,BO1E014001,SCUOLA PRIMARIA,5,38,37,1,0,1
202223,TO1E04900L,SCUOLA PRIMARIA,4,49,49,0,0,0
202223,MB1E07100P,SCUOLA PRIMARIA,3,29,29,0,0,0
202223,NA1E01200G,SCUOLA PRIMARIA,3,11,11,0,0,0
202223,VAPM04500D,SCUOLA SECONDARIA II GRADO,5,15,15,0,0,0
202223,BS1M005002,SCUOLA SECONDARIA I GRADO,1,81,80,1,1,0
202223,SRTDRP500U,SCUOLA SECONDARIA II GRADO,4,2,2,0,0,0
202223,BSPLLZ5006,SCUOLA SECONDARIA II GRADO,1,24,24,0,0,0
202223,VR1M01700A,SCUOLA SECONDARIA I GRADO,3,40,40,0,0,0
202223,RM1E14600E,SCUOLA PRIMARIA,4,25,25,0,0,0
202223,RM1E13100R,SCUOLA PRIMARIA,3,20,17,3,2,1
202223,PC1E00300V,SCUOLA PRIMARIA,4,16,16,0,0,0
202223,CT1E016007,SCUOLA PRIMARIA,4,74,74,0,0,0
202223,GEPS70500C,SCUOLA SECONDARIA II GRADO,1,30,30,0,0,0
202223,RMPS24500R,SCUOLA SECONDARIA II GRADO,2,39,31,8,0,8
202223,PVPS345009,SCUOLA SECONDARIA II GRADO,4,4,4,0,0,0
202223,MI1E14100V,SCUOLA PRIMARIA,2,39,36,3,0,3
202223,BGPS12500G,SCUOLA SECONDARIA II GRADO,5,14,13,1,0,1
202223,SAPSM3500V,SCUOLA SECONDARIA II GRADO,1,7,7,0,0,0
202223,LE1E00600T,SCUOLA PRIMARIA,2,2,2,0,0,0
202223,PE1E009003,SCUOLA PRIMARIA,3,41,40,1,1,0
202223,RMPL035007,SCUOLA SECONDARIA II GRADO,5,8,8,0,0,0
202223,MCTFL85000,SCUOLA SECONDARIA II GRADO,2,7,7,0,0,0
202223,VAPS92500G,SCUOLA SECONDARIA II GRADO,3,15,15,0,0,0
202223,BS1EAP500V,SCUOLA PRIMARIA,4,20,20,0,0,0
202223,CE1E02100C,SCUOLA PRIMARIA,3,12,12,0,0,0
202223,PATL00500R,SCUOLA SECONDARIA II GRADO,5,6,5,1,0,1
202223,CT1E008008,SCUOLA PRIMARIA,3,38,36,2,0,2
202223,MB1M02900D,SCUOLA SECONDARIA I GRADO,2,47,46,1,0,1
202223,TATD06500L,SCUOLA SECONDARIA II GRADO,2,2,2,0,0,0
202223,NA1E057005,SCUOLA PRIMARIA,5,28,28,0,0,0
202223,SATD01500E,SCUOLA SECONDARIA II GRADO,3,5,5,0,0,0
202223,RE1E007005,SCUOLA PRIMARIA,5,21,20,1,1,0
202223,RM1E08200R,SCUOLA PRIMARIA,2,16,12,4,0,4
202223,VTPSP5500E,SCUOLA SECONDARIA II GRADO,4,8,7,1,1,0
202223,TO1M03500X,SCUOLA SECONDARIA I GRADO,1,11,10,1,0,1
202223,LTTD035005,SCUOLA SECONDARIA II GRADO,3,3,3,0,0,0
202223,RM1E2U500H,SCUOLA PRIMARIA,3,39,38,1,0,1
202223,NA1EM9500T,SCUOLA PRIMARIA,4,13,13,0,0,0
202223,FGTDO25007,SCUOLA SECONDARIA II GRADO,2,1,1,0,0,0
202223,CO1EMI5009,SCUOLA PRIMARIA,2,24,22,2,0,2
202223,GE1M014005,SCUOLA SECONDARIA I GRADO,1,28,28,0,0,0
202223,RMPL50500Q,SCUOLA SECONDARIA II GRADO,5,36,36,0,0,0
202223,APRF3R500G,SCUOLA SECONDARIA II GRADO,2,2,2,0,0,0
202223,AV1E008005,SCUOLA PRIMARIA,3,16,16,0,0,0
202223,RMSLZ35008,SCUOLA SECONDARIA II GRADO,3,3,3,0,0,0
202223,MO1E012007,SCUOLA PRIMARIA,5,24,24,0,0,0
202223,PI1E00100Q,SCUOLA PRIMARIA,4,35,35,0,0,0
202223,MI1E00200B,SCUOLA PRIMARIA,5,14,13,1,0,1
202223,LT1E00800Q,SCUOLA PRIMARIA,5,12,12,0,0,0
202223,SATD22500V,SCUOLA SECONDARIA II GRADO,4,9,8,1,0,1
202223,PA1E03900C,SCUOLA PRIMARIA,5,17,16,1,1,0
202223,PD1M00500A,SCUOLA SECONDARIA I GRADO,3,24,24,0,0,0
202223,CO1E01400T,SCUOLA PRIMARIA,1,44,44,0,0,0
202223,COTN025007,SCUOLA SECONDARIA II GRADO,3,13,12,1,0,1
202223,MO1E00700Q,SCUOLA PRIMARIA,2,44,44,0,0,0
202223,MB1E06800V,SCUOLA PRIMARIA,5,20,20,0,0,0
202223,RM1E094003,SCUOLA PRIMARIA,2,78,74,4,1,3
202223,VI1E01200N,SCUOLA PRIMARIA,4,35,26,9,2,7
202223,BSPM57500D,SCUOLA SECONDARIA II GRADO,3,28,28,0,0,0
202223,MIPC09500C,SCUOLA SECONDARIA II GRADO,3,48,45,3,3,0
202223,BO1E00400A,SCUOLA PRIMARIA,1,11,9,2,0,2
202223,MIPL30500D,SCUOLA SECONDARIA II GRADO,5,20,19,1,0,1
202223,RMPSVP500H,SCUOLA SECONDARIA II GRADO,2,9,6,3,1,2
202223,MBRC6C500E,SCUOLA SECONDARIA II GRADO,1,17,16,1,0,1
202223,PD1E004009,SCUOLA PRIMARIA,2,26,26,0,0,0
202223,RM1M058005,SCUOLA SECONDARIA I GRADO,1,14,12,2,1,1
202223,RMPMTS5005,SCUOLA SECONDARIA II GRADO,4,10,10,0,0,0
202223,NATD255008,SCUOLA SECONDARIA II GRADO,5,225,211,14,2,12
202223,RA1E00600V,SCUOLA PRIMARIA,4,45,44,1,0,1
202223,MI1M00800G,SCUOLA SECONDARIA I GRADO,3,78,78,0,0,0
202223,TV1EDQ500C,SCUOLA PRIMARIA,5,14,13,1,0,1
202223,NAPL975007,SCUOLA SECONDARIA II GRADO,4,11,11,0,0,0
202223,NAPMDC5007,SCUOLA SECONDARIA II GRADO,5,39,35,4,0,4
202223,BS1E02000V,SCUOLA PRIMARIA,5,54,53,1,0,1
202223,NA1MSZ5005,SCUOLA SECONDARIA I GRADO,2,24,24,0,0,0
202223,VAPL08500N,SCUOLA SECONDARIA II GRADO,2,10,9,1,1,0
202223,MI1M103009,SCUOLA SECONDARIA I GRADO,1,20,19,1,0,1
202223,NA1E13100T,SCUOLA PRIMARIA,5,15,15,0,0,0
202223,PATD27500A,SCUOLA SECONDARIA II GRADO,5,12,12,0,0,0
202223,VRTF265002,SCUOLA SECONDARIA II GRADO,1,34,33,1,0,1
202223,BS1E009004,SCUOLA PRIMARIA,2,37,36,1,0,1
202223,MBPS365007,SCUOLA SECONDARIA II GRADO,3,17,17,0,0,0
202223,TO1E00700E,SCUOLA PRIMARIA,4,45,45,0,0,0
202223,LI1E00400D,SCUOLA PRIMARIA,1,16,12,4,1,3
202223,CS1E010005,SCUOLA PRIMARIA,2,6,6,0,0,0
202223,RG1E004008,SCUOLA PRIMARIA,5,18,18,0,0,0
202223,REPM3F5001,SCUOLA SECONDARIA II GRADO,2,39,38,1,0,1
202223,GE1E02200V,SCUOLA PRIMARIA,5,21,20,1,1,0
202223,CERHU1500P,SCUOLA SECONDARIA II GRADO,4,29,27,2,1,1
202223,FRTD5O500I,SCUOLA SECONDARIA II GRADO,3,16,15,1,1,0
202223,MIPSVC500V,SCUOLA SECONDARIA II GRADO,1,25,25,0,0,0
202223,RNPL01500X,SCUOLA SECONDARIA II GRADO,3,14,11,3,0,3
202223,MB1E029008,SCUOLA PRIMARIA,5,47,47,0,0,0
202223,TO1M020006,SCUOLA SECONDARIA I GRADO,2,58,57,1,0,1
202223,PDPL02500A,SCUOLA SECONDARIA II GRADO,1,14,13,1,1,0
202223,RMPM17500R,SCUOLA SECONDARIA II GRADO,5,11,10,1,1,0
202223,VT1E001006,SCUOLA PRIMARIA,5,23,22,1,0,1
202223,CEPS875001,SCUOLA SECONDARIA II GRADO,1,23,23,0,0,0
202223,RMTD51500B,SCUOLA SECONDARIA II GRADO,2,12,12,0,0,0
202223,MI1E05600Q,SCUOLA PRIMARIA,5,26,26,0,0,0
202223,MI1E07300D,SCUOLA PRIMARIA,5,38,37,1,0,1
202223,CA1M01000R,SCUOLA SECONDARIA I GRADO,3,48,46,2,0,2
202223,RM1E02900X,SCUOLA PRIMARIA,2,18,17,1,0,1
202223,VEPS015003,SCUOLA SECONDARIA II GRADO,3,13,13,0,0,0
202223,SRPM475001,SCUOLA SECONDARIA II GRADO,4,12,12,0,0,0
202223,AGSL015004,SCUOLA SECONDARIA II GRADO,1,2,1,1,1,0
202223,CSPSDO500P,SCUOLA SECONDARIA II GRADO,3,3,3,0,0,0
202223,SI1E002005,SCUOLA PRIMARIA,3,14,14,0,0,0
202223,BOPSHR500B,SCUOLA SECONDARIA II GRADO,3,28,28,0,0,0
202223,SA1E011006,SCUOLA PRIMARIA,1,16,16,0,0,0
202223,BG1M014008,SCUOLA SECONDARIA I GRADO,3,108,107,1,1,0
202223,CTPM21500B,SCUOLA SECONDARIA II GRADO,4,3,3,0,0,0
202223,NA1E05000A,SCUOLA PRIMARIA,2,1,1,0,0,0
202223,BGPMNC5002,SCUOLA SECONDARIA II GRADO,1,10,10,0,0,0
202223,NA1E128002,SCUOLA PRIMARIA,1,10,9,1,0,1
202223,RMPSIZ500B,SCUOLA SECONDARIA II GRADO,4,13,13,0,0,0
202223,CE1ERT500Q,SCUOLA PRIMARIA,5,13,12,1,0,1
202223,NA1E212009,SCUOLA PRIMARIA,1,17,17,0,0,0
202223,BA1E00400B,SCUOLA PRIMARIA,2,36,36,0,0,0
202223,CHTD035004,SCUOLA SECONDARIA II GRADO,1,5,5,0,0,0
202223,BSTL01500V,SCUOLA SECONDARIA II GRADO,2,4,4,0,0,0
202223,RM1E02600C,SCUOLA PRIMARIA,1,65,65,0,0,0
202223,MI1M00600X,SCUOLA SECONDARIA I GRADO,2,42,41,1,1,0
202223,CE1E04800C,SCUOLA PRIMARIA,1,21,21,0,0,0
202223,PV1E00500L,SCUOLA PRIMARIA,3,31,30,1,0,1
202223,METD045003,SCUOLA SECONDARIA II GRADO,2,2,2,0,0,0
202223,SRTHA6500C,SCUOLA SECONDARIA II GRADO,4,8,8,0,0,0
202223,PR1M002005,SCUOLA SECONDARIA I GRADO,2,37,35,2,0,2
202223,NA1E23700N,SCUOLA PRIMARIA,1,7,5,2,0,2
202223,RA1M005008,SCUOLA SECONDARIA I GRADO,2,28,28,0,0,0
202223,RC1E00300L,SCUOLA PRIMARIA,3,21,20,1,1,0
202223,BGTF9O500Q,SCUOLA SECONDARIA II GRADO,5,7,7,0,0,0
202223,RM1E119006,SCUOLA PRIMARIA,1,20,20,0,0,0
202223,RM1M149007,SCUOLA SECONDARIA I GRADO,1,28,28,0,0,0
202223,MIPSR85009,SCUOLA SECONDARIA II GRADO,4,22,22,0,0,0
202223,NATFZM500T,SCUOLA SECONDARIA II GRADO,5,65,65,0,0,0
202223,BSTF4M5001,SCUOLA SECONDARIA II GRADO,1,6,6,0,0,0
202223,RMTND1500F,SCUOLA SECONDARIA II GRADO,5,21,21,0,0,0
202223,VITB15500E,SCUOLA SECONDARIA II GRADO,3,5,4,1,0,1
202223,LE1M00300G,SCUOLA SECONDARIA I GRADO,1,23,19,4,1,3
202223,RMPCAM500U,SCUOLA SECONDARIA II GRADO,3,13,13,0,0,0
202223,CE1E06100V,SCUOLA PRIMARIA,3,10,10,0,0,0
202223,TV1E00400B,SCUOLA PRIMARIA,4,44,44,0,0,0
202223,CTTFOR5002,SCUOLA SECONDARIA II GRADO,5,31,31,0,0,0
202223,TO1M02300N,SCUOLA SECONDARIA I GRADO,3,62,62,0,0,0
202223,PR1E00900P,SCUOLA PRIMARIA,1,28,28,0,0,0
202223,NATF6G5004,SCUOLA SECONDARIA II GRADO,3,3,3,0,0,0
202223,RM1E11600P,SCUOLA PRIMARIA,5,18,13,5,0,5
202223,MI1E08700B,SCUOLA PRIMARIA,2,69,66,3,0,3
202223,NA1E14500Q,SCUOLA PRIMARIA,3,24,24,0,0,0
202223,CT1E02300A,SCUOLA PRIMARIA,5,18,18,0,0,0
202223,MIPS415006,SCUOLA SECONDARIA II GRADO,1,5,3,2,0,2
202223,MB1M02400A,SCUOLA SECONDARIA I GRADO,1,70,62,8,2,6
202223,MIPSRF5008,SCUOLA SECONDARIA II GRADO,3,5,5,0,0,0
202223,AP1E00100X,SCUOLA PRIMARIA,5,16,16,0,0,0
202223,RM1E186001,SCUOLA PRIMARIA,2,22,22,0,0,0
202223,MI1M077002,SCUOLA SECONDARIA I GRADO,1,38,35,3,0,3
202223,RN1E006005,SCUOLA PRIMARIA,4,21,20,1,1,0
202223,RE1M00400V,SCUOLA SECONDARIA I GRADO,3,56,55,1,0,1
202223,SAPS9B500T,SCUOLA SECONDARIA II GRADO,3,5,4,1,1,0
202223,VA1M00300A,SCUOLA SECONDARIA I GRADO,3,27,24,3,0,3
202223,PO1E01700E,SCUOLA PRIMARIA,2,9,4,5,0,5
202223,VATFE2500M,SCUOLA SECONDARIA II GRADO,3,16,16,0,0,0
202223,SATFRP500A,SCUOLA SECONDARIA II GRADO,4,7,7,0,0,0
202223,UD1E00900V,SCUOLA PRIMARIA,4,15,15,0,0,0
202223,NOPL6T5005,SCUOLA SECONDARIA II GRADO,3,15,15,0,0,0
202223,NATDBQ500Q,SCUOLA SECONDARIA II GRADO,1,9,9,0,0,0
202223,PA1E01800B,SCUOLA PRIMARIA,2,22,22,0,0,0
202223,BS1E00100D,SCUOLA PRIMARIA,1,25,22,3,0,3
202223,CR1E00900D,SCUOLA PRIMARIA,2,39,39,0,0,0
202223,MO1M001002,SCUOLA SECONDARIA I GRADO,2,25,23,2,0,2
202223,NA1E06600X,SCUOLA PRIMARIA,4,20,19,1,0,1
202223,AGTD07500P,SCUOLA SECONDARIA II GRADO,5,62,62,0,0,0
202223,FI1M015004,SCUOLA SECONDARIA I GRADO,1,33,31,2,0,2
202223,CT1M00700N,SCUOLA SECONDARIA I GRADO,1,16,16,0,0,0
202223,LC1E008008,SCUOLA PRIMARIA,1,14,14,0,0,0
202223,NA1E01700P,SCUOLA PRIMARIA,5,50,49,1,1,0
202223,BG1MV3500S,SCUOLA SECONDARIA I GRADO,3,21,16,5,2,3
202223,NA1E03400C,SCUOLA PRIMARIA,3,39,38,1,0,1
202223,VR1M02400D,SCUOLA SECONDARIA I GRADO,2,54,52,2,0,2
202223,CO1M00200R,SCUOLA SECONDARIA I GRADO,3,72,72,0,0,0
202223,RM1E12400N,SCUOLA PRIMARIA,5,45,45,0,0,0
202223,UDPSBD500N,SCUOLA SECONDARIA II GRADO,1,22,22,0,0,0
202223,RMPS56500L,SCUOLA SECONDARIA II GRADO,1,3,3,0,0,0
202223,FI1M02000G,SCUOLA SECONDARIA I GRADO,3,17,11,6,0,6
202223,MEPLZL500L,SCUOLA SECONDARIA II GRADO,5,18,17,1,0,1
202223,PA1E043004,SCUOLA PRIMARIA,2,11,10,1,0,1
202223,BSPSS1500O,SCUOLA SECONDARIA II GRADO,4,72,69,3,0,3
202223,TVPC48500H,SCUOLA SECONDARIA II GRADO,1,15,15,0,0,0
202223,BSPME1500B,SCUOLA SECONDARIA II GRADO,5,35,34,1,0,1
202223,RM1E157001,SCUOLA PRIMARIA,1,13,13,0,0,0
202223,NATDPA500D,SCUOLA SECONDARIA II GRADO,5,67,60,7,0,7
202223,NA1E25900E,SCUOLA PRIMARIA,5,12,12,0,0,0
202223,BI1M01000N,SCUOLA SECONDARIA I GRADO,1,22,22,0,0,0
202223,FG1E01400A,SCUOLA PRIMARIA,1,13,12,1,1,0
202223,VR1MN2500I,SCUOLA SECONDARIA I GRADO,2,24,24,0,0,0
202223,RM1M03900Q,SCUOLA SECONDARIA I GRADO,3,47,46,1,0,1
202223,BA1E00900E,SCUOLA PRIMARIA,4,65,64,1,1,0
202223,NATNHS5003,SCUOLA SECONDARIA II GRADO,2,9,9,0,0,0
202223,NA1E17400Q,SCUOLA PRIMARIA,2,20,19,1,0,1
202223,SARHGU5003,SCUOLA SECONDARIA II GRADO,3,6,6,0,0,0
202223,NA1E07500P,SCUOLA PRIMARIA,4,18,17,1,0,1
202223,TO1E05600Q,SCUOLA PRIMARIA,2,13,13,0,0,0
202223,VR1E011006,SCUOLA PRIMARIA,1,23,21,2,1,1
202223,CE1E05400Q,SCUOLA PRIMARIA,1,10,10,0,0,0
202223,FR1E007008,SCUOLA PRIMARIA,4,29,29,0,0,0
202223,VI1E010002,SCUOLA PRIMARIA,2,11,10,1,0,1
202223,BGRF2Q5004,SCUOLA SECONDARIA II GRADO,1,30,25,5,0,5
202223,VA1M01600C,SCUOLA SECONDARIA I GRADO,2,58,58,0,0,0
202223,SVPM02500N,SCUOLA SECONDARIA II GRADO,2,22,21,1,0,1
202223,VB1E00300Q,SCUOLA PRIMARIA,5,20,17,3,0,3
202223,FI1E01200B,SCUOLA PRIMARIA,1,20,20,0,0,0
202223,MI1MB1500E,SCUOLA SECONDARIA I GRADO,2,25,24,1,1,0
202223,PATF02500T,SCUOLA SECONDARIA II GRADO,4,1,1,0,0,0
202223,RM1M082002,SCUOLA SECONDARIA I GRADO,2,19,19,0,0,0
202223,ATPS715002,SCUOLA SECONDARIA II GRADO,2,5,5,0,0,0
202223,RMPS18500A,SCUOLA SECONDARIA II GRADO,1,8,6,2,0,2
202223,MI1E00200B,SCUOLA PRIMARIA,1,22,21,1,0,1
202223,MI1E01500D,SCUOLA PRIMARIA,1,29,28,1,1,0
202223,CERHP55001,SCUOLA SECONDARIA II GRADO,2,4,4,0,0,0
202223,RM1E00400G,SCUOLA PRIMARIA,2,20,20,0,0,0
202223,VA1M02100X,SCUOLA SECONDARIA I GRADO,2,16,15,1,0,1
202223,NA1ESQ5001,SCUOLA PRIMARIA,1,1,1,0,0,0
202223,VE1E00700V,SCUOLA PRIMARIA,1,20,8,12,3,9
202223,SATLO6500Z,SCUOLA SECONDARIA II GRADO,5,64,64,0,0,0
202223,SATFIF5007,SCUOLA SECONDARIA II GRADO,5,70,68,2,0,2
202223,CE1E01200N,SCUOLA PRIMARIA,4,17,14,3,0,3
202223,FG1E024001,SCUOLA PRIMARIA,1,12,10,2,2,0
202223,PA1E02000B,SCUOLA PRIMARIA,2,13,13,0,0,0
202223,AT1ENP5001,SCUOLA PRIMARIA,5,18,17,1,0,1
202223,MO1E00300C,SCUOLA PRIMARIA,2,43,37,6,0,6
202223,BAPSV85002,SCUOLA SECONDARIA II GRADO,1,31,29,2,1,1
202223,RM1E09800A,SCUOLA PRIMARIA,2,6,5,1,0,1
202223,RM1E08800Q,SCUOLA PRIMARIA,1,10,9,1,0,1
202223,MIPM58500Q,SCUOLA SECONDARIA II GRADO,1,20,19,1,0,1
202223,SA1E01300T,SCUOLA PRIMARIA,3,42,41,1,0,1
202223,RM1E05300R,SCUOLA PRIMARIA,1,26,26,0,0,0
202223,METD08500D,SCUOLA SECONDARIA II GRADO,5,31,31,0,0,0
202223,SATD4U500A,SCUOLA SECONDARIA II GRADO,3,7,7,0,0,0
202223,VE1M002001,SCUOLA SECONDARIA I GRADO,2,30,30,0,0,0
202223,TO1M042003,SCUOLA SECONDARIA I GRADO,3,34,31,3,0,3
202223,PA1MS3500I,SCUOLA SECONDARIA I GRADO,2,3,2,1,0,1
202223,TOPS01500P,SCUOLA SECONDARIA II GRADO,5,49,48,1,1,0
202223,MNPS00500L,SCUOLA SECONDARIA II GRADO,1,12,11,1,0,1
202223,LI1E00900L,SCUOLA PRIMARIA,1,34,33,1,1,0
202223,TR1E00100P,SCUOLA PRIMARIA,2,6,4,2,0,2
202223,NA1E194001,SCUOLA PRIMARIA,1,16,16,0,0,0
202223,RM1E10400C,SCUOLA PRIMARIA,1,18,18,0,0,0
202223,MIPM04500G,SCUOLA SECONDARIA II GRADO,5,20,19,1,0,1
202223,BOPSPI500D,SCUOLA SECONDARIA II GRADO,5,33,33,0,0,0
202223,CE1E031003,SCUOLA PRIMARIA,4,10,8,2,1,1
202223,NARH02500L,SCUOLA SECONDARIA II GRADO,4,37,37,0,0,0
202223,TVPS035008,SCUOLA SECONDARIA II GRADO,2,35,34,1,0,1
202223,TOPS09500G,SCUOLA SECONDARIA II GRADO,1,44,42,2,0,2
202223,TOPQ475003,SCUOLA SECONDARIA II GRADO,4,15,13,2,2,0
202223,COSL02500A,SCUOLA SECONDARIA II GRADO,1,3,2,1,0,1
202223,AVTFTA500S,SCUOLA SECONDARIA II GRADO,1,3,3,0,0,0
202223,RM1E15200T,SCUOLA PRIMARIA,5,22,20,2,0,2
202223,RM1E135004,SCUOLA PRIMARIA,5,18,18,0,0,0
202223,RM1E122002,SCUOLA PRIMARIA,3,18,18,0,0,0
202223,FE1M00200P,SCUOLA SECONDARIA I GRADO,2,37,36,1,0,1
202223,VRPL01500D,SCUOLA SECONDARIA II GRADO,5,28,28,0,0,0
202223,BN1M002007,SCUOLA SECONDARIA I GRADO,2,15,15,0,0,0
202223,RMPS27500L,SCUOLA SECONDARIA II GRADO,1,41,36,5,0,5
202223,NAPSAT500N,SCUOLA SECONDARIA II GRADO,3,11,11,0,0,0
202223,NA1E09800B,SCUOLA PRIMARIA,1,20,19,1,0,1
202223,RM1M13300N,SCUOLA SECONDARIA I GRADO,3,47,46,1,0,1
202223,PVPM025004,SCUOLA SECONDARIA II GRADO,5,14,14,0,0,0
202223,PVPS5H500G,SCUOLA SECONDARIA II GRADO,5,16,16,0,0,0
202223,MI1E14200P,SCUOLA PRIMARIA,5,59,59,0,0,0
202223,MB1E04900D,SCUOLA PRIMARIA,2,47,44,3,0,3
202223,NAPL7N500U,SCUOLA SECONDARIA II GRADO,2,4,4,0,0,0
202223,LCTDVP5000,SCUOLA SECONDARIA II GRADO,5,15,15,0,0,0
202223,CE1E02500Q,SCUOLA PRIMARIA,1,3,0,3,0,3
202223,SATD9L5009,SCUOLA SECONDARIA II GRADO,1,5,5,0,0,0
202223,BS1EAP500V,SCUOLA PRIMARIA,5,14,13,1,1,0
202223,PS1E00100G,SCUOLA PRIMARIA,5,22,22,0,0,0
202223,MI1E08500Q,SCUOLA PRIMARIA,1,24,24,0,0,0
202223,PD1E00800L,SCUOLA PRIMARIA,3,13,11,2,1,1
202223,BG1E01500V,SCUOLA PRIMARIA,5,48,44,4,1,3
202223,BS1E016007,SCUOLA PRIMARIA,1,25,23,2,0,2
202223,NA1E23000V,SCUOLA PRIMARIA,4,11,11,0,0,0
202223,TO1E01500D,SCUOLA PRIMARIA,5,16,15,1,1,0
202223,NATD305004,SCUOLA SECONDARIA II GRADO,2,5,5,0,0,0
202223,RM1E18100T,SCUOLA PRIMARIA,4,24,13,11,0,11
202223,VTPS015009,SCUOLA SECONDARIA II GRADO,1,5,5,0,0,0
202223,RO1E00100P,SCUOLA PRIMARIA,5,23,23,0,0,0
202223,PARH74500O,SCUOLA SECONDARIA II GRADO,5,24,24,0,0,0
202223,LTPSO3500F,SCUOLA SECONDARIA II GRADO,5,10,9,1,0,1
202223,CETD43500Q,SCUOLA SECONDARIA II GRADO,5,65,61,4,1,3
202223,LU1E00600G,SCUOLA PRIMARIA,1,23,17,6,2,4
202223,PD1EZU500F,SCUOLA PRIMARIA,3,17,16,1,0,1
202223,NA1E03800Q,SCUOLA PRIMARIA,3,17,17,0,0,0
202223,BGPL01500V,SCUOLA SECONDARIA II GRADO,3,7,7,0,0,0
202223,BGPS00500D,SCUOLA SECONDARIA II GRADO,1,37,36,1,0,1
202223,GE1E03800C,SCUOLA PRIMARIA,5,17,16,1,0,1
202223,RM1M09100R,SCUOLA SECONDARIA I GRADO,2,44,42,2,1,1
202223,RMTB035009,SCUOLA SECONDARIA II GRADO,5,39,34,5,1,4
202223,RM1E19600G,SCUOLA PRIMARIA,3,12,11,1,1,0
202223,NATD1E500I,SCUOLA SECONDARIA II GRADO,4,2,2,0,0,0
202223,LO1M03000C,SCUOLA SECONDARIA I GRADO,1,44,42,2,1,1
202223,PGPMCG500I,SCUOLA SECONDARIA II GRADO,2,10,10,0,0,0
202223,RM1E03800P,SCUOLA PRIMARIA,1,10,3,7,3,4
202223,GE1E019003,SCUOLA PRIMARIA,4,17,17,0,0,0
202223,SA1E00200B,SCUOLA PRIMARIA,1,10,10,0,0,0
202223,CT1EG5500S,SCUOLA PRIMARIA,2,11,11,0,0,0
202223,NA1E031001,SCUOLA PRIMARIA,1,20,20,0,0,0
202223,PD1E020007,SCUOLA PRIMARIA,4,16,14,2,1,1
202223,VR1ESU500Z,SCUOLA PRIMARIA,1,12,12,0,0,0
202223,CO1E01500N,SCUOLA PRIMARIA,4,6,6,0,0,0
202223,PAPM25500A,SCUOLA SECONDARIA II GRADO,2,10,10,0,0,0
202223,RMPMIO5006,SCUOLA SECONDARIA II GRADO,3,7,7,0,0,0
202223,BN1E82500A,SCUOLA PRIMARIA,5,26,25,1,0,1
202223,VARH01500A,SCUOLA SECONDARIA II GRADO,5,33,32,1,0,1
202223,RM1M665000,SCUOLA SECONDARIA I GRADO,1,18,17,1,0,1
202223,CS1E002006,SCUOLA PRIMARIA,5,9,8,1,1,0
202223,FI1E03100R,SCUOLA PRIMARIA,5,18,18,0,0,0
202223,PEPS995008,SCUOLA SECONDARIA II GRADO,5,10,10,0,0,0
202223,BGPSBT5004,SCUOLA SECONDARIA II GRADO,5,27,27,0,0,0
202223,BGSLAE500Q,SCUOLA SECONDARIA II GRADO,3,11,10,1,0,1
202223,SV1E00300E,SCUOLA PRIMARIA,4,40,40,0,0,0
202223,SSPM9L500Q,SCUOLA SECONDARIA II GRADO,5,7,7,0,0,0
202223,RMPC285004,SCUOLA SECONDARIA II GRADO,4,9,9,0,0,0
202223,MIPC18500P,SCUOLA SECONDARIA II GRADO,2,19,19,0,0,0
202223,NA1E13800L,SCUOLA PRIMARIA,3,11,11,0,0,0
202223,RMPSPN500P,SCUOLA SECONDARIA II GRADO,3,29,29,0,0,0
202223,RM1E01800D,SCUOLA PRIMARIA,3,13,9,4,1,3
202223,NAPSNL500R,SCUOLA SECONDARIA II GRADO,5,16,16,0,0,0
202223,RMTF18500C,SCUOLA SECONDARIA II GRADO,4,19,18,1,1,0
202223,NAPM115006,SCUOLA SECONDARIA II GRADO,3,13,13,0,0,0
202223,BGPSL2500D,SCUOLA SECONDARIA II GRADO,4,7,6,1,0,1
202223,TS1E007005,SCUOLA PRIMARIA,2,8,7,1,1,0
202223,BS1E02200E,SCUOLA PRIMARIA,3,38,32,6,0,6
202223,MESD01500T,SCUOLA SECONDARIA II GRADO,3,25,23,2,1,1
202223,SV1E005006,SCUOLA PRIMARIA,5,18,17,1,0,1
202223,NATFGP5005,SCUOLA SECONDARIA II GRADO,3,4,4,0,0,0
202223,UD1M003005,SCUOLA SECONDARIA I GRADO,3,19,19,0,0,0
202223,UD1E00400Q,SCUOLA PRIMARIA,5,16,16,0,0,0
202223,CSTN015007,SCUOLA SECONDARIA II GRADO,3,8,8,0,0,0
202223,MBPS1Q500V,SCUOLA SECONDARIA II GRADO,1,21,20,1,1,0
202223,BSRF3E5000,SCUOLA SECONDARIA II GRADO,3,5,5,0,0,0
202223,VA1E009004,SCUOLA PRIMARIA,1,66,66,0,0,0
202223,TO1E016009,SCUOLA PRIMARIA,4,21,21,0,0,0
202223,RM1E06300B,SCUOLA PRIMARIA,1,28,28,0,0,0
202223,SA1E012002,SCUOLA PRIMARIA,3,11,11,0,0,0
202223,RN1M02000L,SCUOLA SECONDARIA I GRADO,2,97,90,7,1,6
202223,RM1E199003,SCUOLA PRIMARIA,2,9,9,0,0,0
202223,NARHV2500V,SCUOLA SECONDARIA II GRADO,1,7,7,0,0,0
202223,LU1M7F5008,SCUOLA SECONDARIA I GRADO,1,16,14,2,0,2
202223,PR1E00200X,SCUOLA PRIMARIA,3,25,25,0,0,0
202223,FIPS035009,SCUOLA SECONDARIA II GRADO,3,7,7,0,0,0
202223,MIPS16500L,SCUOLA SECONDARIA II GRADO,1,88,83,5,2,3
202223,RMTD67500X,SCUOLA SECONDARIA II GRADO,2,4,3,1,0,1
202223,CA1E019002,SCUOLA PRIMARIA,2,15,15,0,0,0
202223,PO1E00200R,SCUOLA PRIMARIA,1,17,16,1,0,1
202223,FI1E030001,SCUOLA PRIMARIA,3,8,8,0,0,0
202223,VA1E4D500Q,SCUOLA PRIMARIA,2,39,36,3,0,3
202223,ALPMQR5008,SCUOLA SECONDARIA II GRADO,2,8,7,1,0,1
202223,BOPMNL500M,SCUOLA SECONDARIA II GRADO,3,26,26,0,0,0
202223,VA1E01300Q,SCUOLA PRIMARIA,3,21,20,1,0,1
202223,SA1E016009,SCUOLA PRIMARIA,3,33,33,0,0,0
202223,RGTD11500L,SCUOLA SECONDARIA II GRADO,1,2,2,0,0,0
202223,BG1M02100B,SCUOLA SECONDARIA I GRADO,3,23,23,0,0,0
202223,NA1E044003,SCUOLA PRIMARIA,3,48,48,0,0,0
202223,NA1E057005,SCUOLA PRIMARIA,2,22,22,0,0,0
202223,NA1E23700N,SCUOLA PRIMARIA,2,18,18,0,0,0
202223,VR1E017005,SCUOLA PRIMARIA,5,26,26,0,0,0
202223,RM1E13300C,SCUOLA PRIMARIA,5,15,13,2,0,2
202223,BGTFF0500O,SCUOLA SECONDARIA II GRADO,1,17,14,3,2,1
202223,CE1E01700R,SCUOLA PRIMARIA,1,23,21,2,0,2
202223,MC1E001003,SCUOLA PRIMARIA,4,22,22,0,0,0
202223,RM1M09700Q,SCUOLA SECONDARIA I GRADO,1,49,48,1,1,0
202223,MI1E062003,SCUOLA PRIMARIA,3,57,45,12,1,11
202223,LO1E002003,SCUOLA PRIMARIA,4,30,29,1,0,1
202223,NA1E199004,SCUOLA PRIMARIA,3,17,17,0,0,0
202223,RMPS485001,SCUOLA SECONDARIA II GRADO,4,18,18,0,0,0
202223,AGPSFG5009,SCUOLA SECONDARIA II GRADO,1,1,1,0,0,0
202223,PTPM02500D,SCUOLA SECONDARIA II GRADO,2,30,27,3,1,2
202223,PETD06500C,SCUOLA SECONDARIA II GRADO,5,6,6,0,0,0
202223,RM1ERP500L,SCUOLA PRIMARIA,5,13,13,0,0,0
202223,NARH105008,SCUOLA SECONDARIA II GRADO,2,17,17,0,0,0
202223,NA1E235002,SCUOLA PRIMARIA,1,25,23,2,1,1
202223,MIPC005001,SCUOLA SECONDARIA II GRADO,3,44,44,0,0,0
202223,PATDCH5009,SCUOLA SECONDARIA II GRADO,3,2,2,0,0,0
202223,NATD575004,SCUOLA SECONDARIA II GRADO,3,5,5,0,0,0
202223,MI1E03100B,SCUOLA PRIMARIA,2,49,47,2,0,2
202223,NATHA4500E,SCUOLA SECONDARIA II GRADO,5,86,84,2,0,2
202223,TVPSIL5006,SCUOLA SECONDARIA II GRADO,5,15,15,0,0,0
202223,AP1MUQ500M,SCUOLA SECONDARIA I GRADO,2,2,2,0,0,0
202223,NAPL00500C,SCUOLA SECONDARIA II GRADO,2,2,2,0,0,0
202223,VR1E00500V,SCUOLA PRIMARIA,1,42,42,0,0,0
202223,BO1E018008,SCUOLA PRIMARIA,4,13,10,3,1,2
202223,TV1E00300G,SCUOLA PRIMARIA,1,25,24,1,0,1
202223,PEPC8E500U,SCUOLA SECONDARIA II GRADO,1,22,21,1,0,1
202223,CTTDHQ5002,SCUOLA SECONDARIA II GRADO,5,21,21,0,0,0
202223,ME1MU5500F,SCUOLA SECONDARIA I GRADO,1,14,14,0,0,0
202223,TARI00500A,SCUOLA SECONDARIA II GRADO,2,1,1,0,0,0
202223,MISL04500B,SCUOLA SECONDARIA II GRADO,5,56,54,2,0,2
202223,VA1M00300A,SCUOLA SECONDARIA I GRADO,2,19,16,3,1,2
202223,BSPSB05000,SCUOLA SECONDARIA II GRADO,4,10,10,0,0,0
202223,FI1E005008,SCUOLA PRIMARIA,5,13,10,3,0,3
202223,VATFE2500M,SCUOLA SECONDARIA II GRADO,2,29,24,5,0,5
202223,NATF365002,SCUOLA SECONDARIA II GRADO,5,66,64,2,0,2
202223,COPSNU500Z,SCUOLA SECONDARIA II GRADO,5,10,7,3,1,2
202223,RM1E15900L,SCUOLA PRIMARIA,2,24,24,0,0,0
202223,NA1E14700B,SCUOLA PRIMARIA,1,9,9,0,0,0
202223,BG1E027005,SCUOLA PRIMARIA,1,18,18,0,0,0
202223,AV1E01200R,SCUOLA PRIMARIA,4,1,1,0,0,0
202223,BS1E01300Q,SCUOLA PRIMARIA,5,9,9,0,0,0
202223,MIPSQB5007,SCUOLA SECONDARIA II GRADO,4,33,32,1,0,1
202223,MS1E00500P,SCUOLA PRIMARIA,5,19,19,0,0,0
202223,PV1M00600N,SCUOLA SECONDARIA I GRADO,1,52,48,4,1,3
202223,MI1E13000C,SCUOLA PRIMARIA,3,26,24,2,1,1
202223,VEPS04500V,SCUOLA SECONDARIA II GRADO,5,17,17,0,0,0
202223,FR1E003001,SCUOLA PRIMARIA,2,14,14,0,0,0
202223,RMPL00500B,SCUOLA SECONDARIA II GRADO,2,7,6,1,0,1
202223,MCRF3O5008,SCUOLA SECONDARIA II GRADO,2,1,1,0,0,0
202223,NARH9B500E,SCUOLA SECONDARIA II GRADO,2,14,14,0,0,0
202223,BSPS2M500I,SCUOLA SECONDARIA II GRADO,1,21,20,1,1,0
202223,SATFVU500C,SCUOLA SECONDARIA II GRADO,5,62,60,2,0,2
202223,MIPS295009,SCUOLA SECONDARIA II GRADO,3,39,39,0,0,0
202223,NA1E21600L,SCUOLA PRIMARIA,1,14,14,0,0,0
202223,VI1E002003,SCUOLA PRIMARIA,5,23,22,1,0,1
202223,TV1M006008,SCUOLA SECONDARIA I GRADO,2,22,22,0,0,0
202223,AGTL4P500L,SCUOLA SECONDARIA II GRADO,3,1,1,0,0,0
202223,BO1M007003,SCUOLA SECONDARIA I GRADO,3,130,119,11,0,11
202223,FOPSNV5004,SCUOLA SECONDARIA II GRADO,5,8,8,0,0,0
202223,FI1M02100B,SCUOLA SECONDARIA I GRADO,1,39,38,1,1,0
202223,RM1E07000E,SCUOLA PRIMARIA,3,31,28,3,3,0
202223,VA1E00500R,SCUOLA PRIMARIA,1,48,47,1,0,1
202223,NARFGU5004,SCUOLA SECONDARIA II GRADO,4,2,2,0,0,0
202223,RM1ES9500O,SCUOLA PRIMARIA,2,4,4,0,0,0
202223,CT1E82801D,SCUOLA PRIMARIA,3,5,5,0,0,0
202223,NARHP4500A,SCUOLA SECONDARIA II GRADO,2,4,4,0,0,0
202223,LC1E008008,SCUOLA PRIMARIA,3,11,11,0,0,0
202223,PAPL595005,SCUOLA SECONDARIA II GRADO,2,7,7,0,0,0
202223,CO1E005003,SCUOLA PRIMARIA,2,24,23,1,0,1
202223,RC1E01100G,SCUOLA PRIMARIA,1,10,8,2,0,2
202223,RMRH00500A,SCUOLA SECONDARIA II GRADO,2,12,12,0,0,0
202223,BN1E001006,SCUOLA PRIMARIA,2,23,21,2,0,2
202223,AQ1E003006,SCUOLA PRIMARIA,3,15,15,0,0,0
202223,MCPM0L500Q,SCUOLA SECONDARIA II GRADO,5,33,29,4,2,2
202223,RM1M13400D,SCUOLA SECONDARIA I GRADO,3,53,52,1,0,1
202223,NA1E002001,SCUOLA PRIMARIA,5,12,11,1,0,1
202223,CLTD095008,SCUOLA SECONDARIA II GRADO,5,24,21,3,1,2
202223,TOTF01500R,SCUOLA SECONDARIA II GRADO,2,72,67,5,2,3
202223,RMPS695009,SCUOLA SECONDARIA II GRADO,4,12,11,1,0,1
202223,RMPS5G5003,SCUOLA SECONDARIA II GRADO,1,3,2,1,0,1
202223,SP1M00200D,SCUOLA SECONDARIA I GRADO,2,38,37,1,1,0
202223,NA1E205006,SCUOLA PRIMARIA,2,20,14,6,0,6
202223,SATDGN500Z,SCUOLA SECONDARIA II GRADO,1,6,6,0,0,0
202223,GRPS005002,SCUOLA SECONDARIA II GRADO,3,10,10,0,0,0
202223,PA1EZG500F,SCUOLA PRIMARIA,2,4,4,0,0,0
202223,PA1E048007,SCUOLA PRIMARIA,4,43,42,1,0,1
202223,BSPLMR500P,SCUOLA SECONDARIA II GRADO,3,26,25,1,0,1
202223,TOPS105001,SCUOLA SECONDARIA II GRADO,5,93,90,3,2,1
202223,BL1E00200B,SCUOLA PRIMARIA,1,40,37,3,0,3
202223,FG1E01100V,SCUOLA PRIMARIA,2,15,14,1,0,1
202223,NA1E12600A,SCUOLA PRIMARIA,5,11,11,0,0,0
202223,NAPS39500Q,SCUOLA SECONDARIA II GRADO,3,4,4,0,0,0
202223,MITF11500N,SCUOLA SECONDARIA II GRADO,2,180,172,8,1,7
202223,MI1E059007,SCUOLA PRIMARIA,5,43,39,4,0,4
202223,MSPSI35008,SCUOLA SECONDARIA II GRADO,4,6,4,2,1,1
202223,CL1E00400X,SCUOLA PRIMARIA,1,20,20,0,0,0
202223,MI1M05100T,SCUOLA SECONDARIA I GRADO,2,25,22,3,0,3
202223,CE1E03800T,SCUOLA PRIMARIA,4,36,36,0,0,0
202223,FRPSII500H,SCUOLA SECONDARIA II GRADO,1,6,6,0,0,0
202223,VI1M00600G,SCUOLA SECONDARIA I GRADO,2,19,19,0,0,0
202223,CETB015007,SCUOLA SECONDARIA II GRADO,5,11,11,0,0,0
202223,IM1E00400R,SCUOLA PRIMARIA,4,21,21,0,0,0
202223,PR1E00400G,SCUOLA PRIMARIA,1,40,38,2,1,1
202223,TO1E6R5003,SCUOLA PRIMARIA,3,50,48,2,1,1
202223,PA1EAT500P,SCUOLA PRIMARIA,5,47,46,1,0,1
202223,AVTF765001,SCUOLA SECONDARIA II GRADO,1,5,5,0,0,0
202223,ARPM015009,SCUOLA SECONDARIA II GRADO,5,26,26,0,0,0
202223,RMPS0V500L,SCUOLA SECONDARIA II GRADO,5,8,8,0,0,0
202223,PVPS025003,SCUOLA SECONDARIA II GRADO,4,7,6,1,0,1
202223,CE1E03400E,SCUOLA PRIMARIA,4,25,25,0,0,0
202223,SO1E00100E,SCUOLA PRIMARIA,5,10,8,2,1,1
202223,VA1M017008,SCUOLA SECONDARIA I GRADO,2,120,118,2,1,1
202223,LUPS025006,SCUOLA SECONDARIA II GRADO,2,10,9,1,0,1
202223,VE1E00200Q,SCUOLA PRIMARIA,4,24,23,1,0,1
202223,FI1E01800A,SCUOLA PRIMARIA,4,12,11,1,0,1
202223,VRPSN9500T,SCUOLA SECONDARIA II GRADO,4,18,17,1,1,0
202223,PA1E00900L,SCUOLA PRIMARIA,5,17,17,0,0,0
202223,AR1E00500C,SCUOLA PRIMARIA,4,16,15,1,0,1
202223,BR1E00200T,SCUOLA PRIMARIA,2,15,15,0,0,0
202223,NA1E226007,SCUOLA PRIMARIA,5,17,17,0,0,0
202223,NO1M00900X,SCUOLA SECONDARIA I GRADO,3,63,62,1,0,1
202223,GE1E027002,SCUOLA PRIMARIA,4,13,11,2,0,2
202223,MIPS01500P,SCUOLA SECONDARIA II GRADO,3,33,30,3,1,2
202223,BOPSR2500M,SCUOLA SECONDARIA II GRADO,1,47,47,0,0,0
202223,LTPST2500E,SCUOLA SECONDARIA II GRADO,3,9,8,1,0,1
202223,FIPM69500H,SCUOLA SECONDARIA II GRADO,2,5,4,1,0,1
202223,VARCD7500V,SCUOLA SECONDARIA II GRADO,2,44,41,3,1,2
202223,MI1E053008,SCUOLA PRIMARIA,1,61,61,0,0,0
202223,NATLGU500N,SCUOLA SECONDARIA II GRADO,5,70,69,1,0,1
202223,LO1E001007,SCUOLA PRIMARIA,4,26,26,0,0,0
202223,CA1E01000G,SCUOLA PRIMARIA,5,20,17,3,0,3
202223,RM1E01600T,SCUOLA PRIMARIA,1,9,9,0,0,0
202223,NO1E00400G,SCUOLA PRIMARIA,4,74,71,3,1,2
202223,FI1M01800G,SCUOLA SECONDARIA I GRADO,2,21,20,1,0,1
202223,COTD06500Q,SCUOLA SECONDARIA II GRADO,2,6,5,1,1,0
202223,AVRH2Q500U,SCUOLA SECONDARIA II GRADO,2,4,4,0,0,0
202223,ENTDID500H,SCUOLA SECONDARIA II GRADO,2,3,3,0,0,0
202223,NA1E11700G,SCUOLA PRIMARIA,1,23,23,0,0,0
202223,CEPL015005,SCUOLA SECONDARIA II GRADO,2,12,12,0,0,0
202223,GO1E002006,SCUOLA PRIMARIA,3,6,6,0,0,0
202223,NA1E100006,SCUOLA PRIMARIA,3,27,23,4,0,4
202223,CR1E006002,SCUOLA PRIMARIA,5,12,12,0,0,0
202223,RN1E00900L,SCUOLA PRIMARIA,1,26,24,2,0,2
202223,RMTFNG5000,SCUOLA SECONDARIA II GRADO,3,8,8,0,0,0
202223,SARF17500D,SCUOLA SECONDARIA II GRADO,5,70,65,5,1,4
202223,PEPMPL500U,SCUOLA SECONDARIA II GRADO,5,19,19,0,0,0
202223,PAPSTT500B,SCUOLA SECONDARIA II GRADO,5,7,7,0,0,0
202223,VAPS1O500A,SCUOLA SECONDARIA II GRADO,1,21,21,0,0,0
202223,MI1E089003,SCUOLA PRIMARIA,5,11,10,1,0,1
202223,RM1M06900G,SCUOLA SECONDARIA I GRADO,1,30,30,0,0,0
202223,NAPS5M500T,SCUOLA SECONDARIA II GRADO,4,14,5,9,4,5
202223,GR1M00200E,SCUOLA SECONDARIA I GRADO,3,16,16,0,0,0
202223,MBPS40500C,SCUOLA SECONDARIA II GRADO,4,15,15,0,0,0
202223,RM1E171007,SCUOLA PRIMARIA,4,42,39,3,3,0
202223,BGPS12500G,SCUOLA SECONDARIA II GRADO,3,7,7,0,0,0
202223,VTPMI8500B,SCUOLA SECONDARIA II GRADO,5,62,57,5,1,4
202223,VTPLR35005,SCUOLA SECONDARIA II GRADO,2,3,2,1,0,1
202223,VR1EEF5000,SCUOLA PRIMARIA,5,38,38,0,0,0
202223,SA1E004003,SCUOLA PRIMARIA,3,27,27,0,0,0
202223,CETDA05001,SCUOLA SECONDARIA II GRADO,3,7,6,1,1,0
202223,TA1E00500X,SCUOLA PRIMARIA,1,24,24,0,0,0
202223,BSPMVC500O,SCUOLA SECONDARIA II GRADO,1,14,13,1,1,0
202223,VE1E013006,SCUOLA PRIMARIA,5,24,24,0,0,0
202223,VATD12500X,SCUOLA SECONDARIA II GRADO,5,19,19,0,0,0
202223,NA1E031001,SCUOLA PRIMARIA,2,26,25,1,0,1
202223,CTTD045008,SCUOLA SECONDARIA II GRADO,1,3,3,0,0,0
202223,BGPMDF500L,SCUOLA SECONDARIA II GRADO,4,18,18,0,0,0
202223,BO1E01100D,SCUOLA PRIMARIA,3,36,35,1,0,1
202223,GE1E03100N,SCUOLA PRIMARIA,4,25,21,4,0,4
202223,GE1M02300X,SCUOLA SECONDARIA I GRADO,2,24,19,5,1,4
202223,VT1E006009,SCUOLA PRIMARIA,3,20,20,0,0,0
202223,RMPL355003,SCUOLA SECONDARIA II GRADO,2,6,6,0,0,0
202223,MIPS42500R,SCUOLA SECONDARIA II GRADO,1,57,55,2,0,2
202223,SAPM53500M,SCUOLA SECONDARIA II GRADO,5,28,23,5,0,5
202223,CS1E003002,SCUOLA PRIMARIA,1,21,21,0,0,0
202223,MBPC215006,SCUOLA SECONDARIA II GRADO,4,19,19,0,0,0
202223,RM1E19400X,SCUOLA PRIMARIA,5,24,23,1,0,1
202223,BG1E00900G,SCUOLA PRIMARIA,2,8,7,1,1,0
202223,SATD01500E,SCUOLA SECONDARIA II GRADO,4,6,6,0,0,0
202223,TO1E024008,SCUOLA PRIMARIA,2,47,47,0,0,0
202223,GE1E02200V,SCUOLA PRIMARIA,2,22,20,2,0,2
202223,RGPM00500A,SCUOLA SECONDARIA II GRADO,2,3,3,0,0,0
202223,RM1E06100Q,SCUOLA PRIMARIA,3,29,29,0,0,0
202223,VR1M00300C,SCUOLA SECONDARIA I GRADO,3,58,58,0,0,0
202223,NATDLM500R,SCUOLA SECONDARIA II GRADO,5,133,131,2,2,0
202223,FIPS00500D,SCUOLA SECONDARIA II GRADO,2,12,12,0,0,0
202223,NA1E006008,SCUOLA PRIMARIA,1,27,25,2,0,2
202223,MO1E012007,SCUOLA PRIMARIA,4,20,20,0,0,0
202223,SA1M01100B,SCUOLA SECONDARIA I GRADO,3,7,5,2,0,2
202223,BG1E00700X,SCUOLA PRIMARIA,1,50,50,0,0,0
202223,TO1E038006,SCUOLA PRIMARIA,4,11,10,1,0,1
202223,RM1E08900G,SCUOLA PRIMARIA,2,11,9,2,1,1
202223,BGPSLZ5008,SCUOLA SECONDARIA II GRADO,2,6,5,1,0,1
202223,VI1E008002,SCUOLA PRIMARIA,1,10,10,0,0,0
202223,BS1E0E500A,SCUOLA PRIMARIA,3,17,17,0,0,0
202223,CT1MHE500T,SCUOLA SECONDARIA I GRADO,2,11,11,0,0,0
202223,RMPC26500V,SCUOLA SECONDARIA II GRADO,4,23,23,0,0,0
202223,CORF8L5003,SCUOLA SECONDARIA II GRADO,2,7,4,3,0,3
202223,TOPS20500T,SCUOLA SECONDARIA II GRADO,2,28,25,3,2,1
202223,MIPC125003,SCUOLA SECONDARIA II GRADO,2,15,15,0,0,0
202223,PD1E00100T,SCUOLA PRIMARIA,5,25,24,1,0,1
202223,MBTD35500C,SCUOLA SECONDARIA II GRADO,3,15,14,1,0,1
202223,MITF105003,SCUOLA SECONDARIA II GRADO,3,28,27,1,0,1
202223,PVPLHO500H,SCUOLA SECONDARIA II GRADO,1,5,5,0,0,0
202223,NAPLQ2500N,SCUOLA SECONDARIA II GRADO,3,9,9,0,0,0
202223,VI1E01300D,SCUOLA PRIMARIA,1,15,13,2,0,2
202223,RM1E014006,SCUOLA PRIMARIA,1,24,23,1,0,1
202223,MEPS435000,SCUOLA SECONDARIA II GRADO,1,6,6,0,0,0
202223,BS1E01900P,SCUOLA PRIMARIA,4,28,26,2,1,1
202223,BSPM57500D,SCUOLA SECONDARIA II GRADO,1,47,46,1,0,1
202223,NATF9E5003,SCUOLA SECONDARIA II GRADO,3,3,3,0,0,0
202223,NATDI75001,SCUOLA SECONDARIA II GRADO,2,8,2,6,2,4
202223,SATFEP500M,SCUOLA SECONDARIA II GRADO,5,69,63,6,3,3
202223,MIPSE7500I,SCUOLA SECONDARIA II GRADO,5,35,34,1,0,1
202223,MBPM005002,SCUOLA SECONDARIA II GRADO,4,21,20,1,0,1
202223,TO1E00100G,SCUOLA PRIMARIA,4,50,47,3,0,3
202223,NATD475007,SCUOLA SECONDARIA II GRADO,3,12,12,0,0,0
202223,NA1E18100V,SCUOLA PRIMARIA,1,23,11,12,5,7
202223,VEPL01500T,SCUOLA SECONDARIA II GRADO,5,4,4,0,0,0
202223,REPMPU500Q,SCUOLA SECONDARIA II GRADO,5,10,9,1,0,1
202223,RM1E072006,SCUOLA PRIMARIA,2,21,21,0,0,0
202223,VR1E004003,SCUOLA PRIMARIA,3,41,39,2,0,2
202223,LU1E00400X,SCUOLA PRIMARIA,1,19,19,0,0,0
202223,RM1E20800L,SCUOLA PRIMARIA,4,19,17,2,1,1
202223,CTPSPS5003,SCUOLA SECONDARIA II GRADO,3,9,9,0,0,0
202223,PDPS035006,SCUOLA SECONDARIA II GRADO,2,30,28,2,1,1
202223,MI1M10100N,SCUOLA SECONDARIA I GRADO,3,66,65,1,0,1
202223,PATD27500A,SCUOLA SECONDARIA II GRADO,3,2,2,0,0,0
202223,RMTD77500R,SCUOLA SECONDARIA II GRADO,1,3,3,0,0,0
202223,RMSL3L500Q,SCUOLA SECONDARIA II GRADO,3,6,5,1,0,1
202223,MI1M05800L,SCUOLA SECONDARIA I GRADO,3,42,41,1,0,1
202223,MI1E123009,SCUOLA PRIMARIA,4,34,30,4,0,4
202223,PN1M00100D,SCUOLA SECONDARIA I GRADO,1,70,67,3,0,3
202223,MI1E009006,SCUOLA PRIMARIA,5,126,122,4,0,4
202223,NA1MU75009,SCUOLA SECONDARIA I GRADO,1,3,3,0,0,0
202223,MI1E018001,SCUOLA PRIMARIA,5,20,20,0,0,0
202223,BG1M01100R,SCUOLA SECONDARIA I GRADO,3,19,18,1,0,1
202223,PDPL04500G,SCUOLA SECONDARIA II GRADO,3,21,21,0,0,0
202223,VAPSE5500O,SCUOLA SECONDARIA II GRADO,3,24,24,0,0,0
202223,CO1M01800A,SCUOLA SECONDARIA I GRADO,1,38,38,0,0,0
202223,TOPM035001,SCUOLA SECONDARIA II GRADO,2,28,25,3,1,2
202223,RMPSV5500M,SCUOLA SECONDARIA II GRADO,2,4,4,0,0,0
202223,CE1E06700T,SCUOLA PRIMARIA,1,10,9,1,1,0
202223,NA1E119007,SCUOLA PRIMARIA,1,16,16,0,0,0
202223,APRF3R500G,SCUOLA SECONDARIA II GRADO,5,28,28,0,0,0
202223,MCPL0P500L,SCUOLA SECONDARIA II GRADO,2,1,1,0,0,0
202223,FGRHSR500L,SCUOLA SECONDARIA II GRADO,4,5,5,0,0,0
202223,CEPS16500H,SCUOLA SECONDARIA II GRADO,5,11,10,1,0,1
202223,RM1MQH500U,SCUOLA SECONDARIA I GRADO,1,18,15,3,0,3
202223,MI1E05600Q,SCUOLA PRIMARIA,3,36,35,1,1,0
202223,MO1M006005,SCUOLA SECONDARIA I GRADO,2,145,142,3,1,2
202223,RM1E028004,SCUOLA PRIMARIA,5,28,27,1,0,1
202223,RM1E100005,SCUOLA PRIMARIA,4,19,17,2,0,2
202223,MB1E128009,SCUOLA PRIMARIA,5,35,34,1,0,1
202223,NAPM455007,SCUOLA SECONDARIA II GRADO,1,9,9,0,0,0
202223,PT1E00200E,SCUOLA PRIMARIA,4,20,20,0,0,0
202223,VI1M017002,SCUOLA SECONDARIA I GRADO,1,23,23,0,0,0
202223,CTTE01500X,SCUOLA SECONDARIA II GRADO,1,19,18,1,1,0
202223,SA1E011006,SCUOLA PRIMARIA,2,15,15,0,0,0
202223,NARF2D500G,SCUOLA SECONDARIA II GRADO,1,3,3,0,0,0
202223,RM1EZR5005,SCUOLA PRIMARIA,3,14,14,0,0,0
202223,LC1E00500R,SCUOLA PRIMARIA,2,49,49,0,0,0
202223,PAPC1H500H,SCUOLA SECONDARIA II GRADO,1,15,15,0,0,0
202223,NA1E243001,SCUOLA PRIMARIA,1,12,12,0,0,0
202223,RC1E00700X,SCUOLA PRIMARIA,2,14,13,1,0,1
202223,CZPL925000,SCUOLA SECONDARIA II GRADO,3,6,6,0,0,0
202223,NA1E113008,SCUOLA PRIMARIA,4,15,15,0,0,0
202223,PD1E013004,SCUOLA PRIMARIA,2,42,41,1,0,1
202223,NAPS68500Q,SCUOLA SECONDARIA II GRADO,4,30,30,0,0,0
202223,MI1E033003,SCUOLA PRIMARIA,5,26,26,0,0,0
202223,NATL16500C,SCUOLA SECONDARIA II GRADO,3,6,6,0,0,0
202223,BSTF8F5009,SCUOLA SECONDARIA II GRADO,5,5,4,1,0,1
202223,TP1E003005,SCUOLA PRIMARIA,4,3,3,0,0,0
202223,CTTD335008,SCUOLA SECONDARIA II GRADO,4,2,2,0,0,0
202223,NAPMSV500U,SCUOLA SECONDARIA II GRADO,4,6,6,0,0,0
202223,MCRF3O5008,SCUOLA SECONDARIA II GRADO,3,1,0,1,1,0
202223,MITB025006,SCUOLA SECONDARIA II GRADO,3,41,30,11,0,11
202223,PR1M002005,SCUOLA SECONDARIA I GRADO,1,46,44,2,0,2
202223,BO1E014001,SCUOLA PRIMARIA,3,35,35,0,0,0
202223,BGTD085006,SCUOLA SECONDARIA II GRADO,3,33,31,2,0,2
202223,MI1E11800T,SCUOLA PRIMARIA,4,46,46,0,0,0
202223,RMPC1A5001,SCUOLA SECONDARIA II GRADO,1,12,12,0,0,0
202223,NA1E221004,SCUOLA PRIMARIA,5,9,9,0,0,0
202223,BS1E01800V,SCUOLA PRIMARIA,4,29,29,0,0,0
202223,RMPMSC500I,SCUOLA SECONDARIA II GRADO,5,42,37,5,0,5
202223,CH1E005007,SCUOLA PRIMARIA,4,15,15,0,0,0
202223,NA1E15500A,SCUOLA PRIMARIA,2,25,25,0,0,0
202223,MI1M05300D,SCUOLA SECONDARIA I GRADO,3,22,20,2,0,2
202223,SATA2M500B,SCUOLA SECONDARIA II GRADO,3,1,1,0,0,0
202223,LCPL025002,SCUOLA SECONDARIA II GRADO,5,17,17,0,0,0
202223,LE1E005002,SCUOLA PRIMARIA,1,20,15,5,0,5
202223,TV1E018009,SCUOLA PRIMARIA,1,12,12,0,0,0
202223,TV1E00400B,SCUOLA PRIMARIA,5,70,69,1,1,0
202223,PATD27500A,SCUOLA SECONDARIA II GRADO,2,2,2,0,0,0
202223,CO1E00800E,SCUOLA PRIMARIA,4,36,28,8,3,5
202223,PA1E02300V,SCUOLA PRIMARIA,2,13,13,0,0,0
202223,NA1E218008,SCUOLA PRIMARIA,3,14,14,0,0,0
202223,RM1E04700D,SCUOLA PRIMARIA,2,10,10,0,0,0
202223,AGTD4Q5003,SCUOLA SECONDARIA II GRADO,5,34,34,0,0,0
202223,FI1M006009,SCUOLA SECONDARIA I GRADO,3,26,23,3,0,3
202223,PV1E007008,SCUOLA PRIMARIA,3,13,12,1,0,1
202223,PO1E013007,SCUOLA PRIMARIA,5,23,18,5,0,5
202223,NA1E02000E,SCUOLA PRIMARIA,4,2,2,0,0,0
202223,TVPC01500X,SCUOLA SECONDARIA II GRADO,1,14,14,0,0,0
202223,BGPL055009,SCUOLA SECONDARIA II GRADO,3,14,14,0,0,0
202223,RMPM55500G,SCUOLA SECONDARIA II GRADO,3,23,23,0,0,0
202223,TO1M05100T,SCUOLA SECONDARIA I GRADO,2,44,35,9,6,3
202223,CERH325008,SCUOLA SECONDARIA II GRADO,1,11,11,0,0,0
202223,LO1MOF5006,SCUOLA SECONDARIA I GRADO,3,17,17,0,0,0
202223,RMPSAD500D,SCUOLA SECONDARIA II GRADO,4,9,8,1,0,1
202223,RM1E03400B,SCUOLA PRIMARIA,1,10,10,0,0,0
202223,RMTL395001,SCUOLA SECONDARIA II GRADO,5,60,56,4,0,4
202223,SR1E009008,SCUOLA PRIMARIA,3,15,13,2,1,1
202223,FI1E06100L,SCUOLA PRIMARIA,2,15,14,1,0,1
202223,MIPM07500B,SCUOLA SECONDARIA II GRADO,3,26,26,0,0,0
202223,SA1E02600X,SCUOLA PRIMARIA,4,11,11,0,0,0
202223,TVPL07500D,SCUOLA SECONDARIA II GRADO,3,3,3,0,0,0
202223,CORA025003,SCUOLA SECONDARIA II GRADO,1,17,17,0,0,0
202223,NATD475007,SCUOLA SECONDARIA II GRADO,4,10,10,0,0,0
202223,BL1M00100R,SCUOLA SECONDARIA I GRADO,3,35,35,0,0,0
202223,VATD05500V,SCUOLA SECONDARIA II GRADO,2,4,4,0,0,0
202223,NA1E12300V,SCUOLA PRIMARIA,1,40,40,0,0,0
202223,RM1M07600P,SCUOLA SECONDARIA I GRADO,1,52,50,2,0,2
202223,AP1E00400B,SCUOLA PRIMARIA,3,13,13,0,0,0
202223,CA1E00700Q,SCUOLA PRIMARIA,1,11,9,2,0,2
202223,CA1EN7500O,SCUOLA PRIMARIA,2,26,26,0,0,0
202223,MI1M03200C,SCUOLA SECONDARIA I GRADO,3,30,28,2,1,1
202223,MB1E07100P,SCUOLA PRIMARIA,2,27,26,1,0,1
202223,VIPL015005,SCUOLA SECONDARIA II GRADO,3,14,14,0,0,0
202223,PR1E001004,SCUOLA PRIMARIA,2,45,45,0,0,0
202223,RM1E14600E,SCUOLA PRIMARIA,5,24,22,2,2,0
202223,NATDPA500D,SCUOLA SECONDARIA II GRADO,4,6,6,0,0,0
202223,MIPS54500V,SCUOLA SECONDARIA II GRADO,3,18,18,0,0,0
202223,GEPS6L5006,SCUOLA SECONDARIA II GRADO,4,12,12,0,0,0
202223,NATL0L500Q,SCUOLA SECONDARIA II GRADO,2,8,8,0,0,0
202223,NATNHS5003,SCUOLA SECONDARIA II GRADO,1,5,5,0,0,0
202223,PVPS345009,SCUOLA SECONDARIA II GRADO,3,4,4,0,0,0
202223,MI1E14100V,SCUOLA PRIMARIA,1,59,52,7,1,6
202223,SARFD1500N,SCUOLA SECONDARIA II GRADO,2,1,1,0,0,0
202223,LE1E00600T,SCUOLA PRIMARIA,1,18,18,0,0,0
202223,CETB015007,SCUOLA SECONDARIA II GRADO,2,22,22,0,0,0
202223,VAPS92500G,SCUOLA SECONDARIA II GRADO,4,22,20,2,1,1
202223,BS1EAP500V,SCUOLA PRIMARIA,3,15,15,0,0,0
202223,NA1MLP500B,SCUOLA SECONDARIA I GRADO,3,14,14,0,0,0
202223,PR1E00500B,SCUOLA PRIMARIA,1,32,32,0,0,0
202223,FI1E01100G,SCUOLA PRIMARIA,4,35,32,3,0,3
202223,VRTN01500C,SCUOLA SECONDARIA II GRADO,3,13,13,0,0,0
202223,UD1M009004,SCUOLA SECONDARIA I GRADO,2,19,17,2,0,2
202223,NATFDD500F,SCUOLA SECONDARIA II GRADO,2,6,6,0,0,0
202223,SATFHG5004,SCUOLA SECONDARIA II GRADO,3,6,6,0,0,0
202223,PA1E00300N,SCUOLA PRIMARIA,4,11,11,0,0,0
202223,CE1E02100C,SCUOLA PRIMARIA,2,13,10,3,0,3
202223,CO1E00100Q,SCUOLA PRIMARIA,1,36,32,4,0,4
202223,FITB015001,SCUOLA SECONDARIA II GRADO,2,11,9,2,0,2
202223,AQ1M00200G,SCUOLA SECONDARIA I GRADO,2,19,19,0,0,0
202223,CT1E008008,SCUOLA PRIMARIA,2,56,54,2,0,2
202223,ATPS715002,SCUOLA SECONDARIA II GRADO,1,6,6,0,0,0
202223,MB1EP85003,SCUOLA PRIMARIA,5,10,10,0,0,0
202223,MBPS345002,SCUOLA SECONDARIA II GRADO,2,25,25,0,0,0
202223,RMPS53500R,SCUOLA SECONDARIA II GRADO,4,13,13,0,0,0
202223,NA1E07600E,SCUOLA PRIMARIA,4,36,32,4,0,4
202223,RE1E007005,SCUOLA PRIMARIA,4,23,23,0,0,0
202223,TO1E047001,SCUOLA PRIMARIA,4,24,11,13,4,9
202223,RMPL22500A,SCUOLA SECONDARIA II GRADO,3,16,14,2,2,0
202223,FIPC035006,SCUOLA SECONDARIA II GRADO,4,5,5,0,0,0
202223,CERIOH500S,SCUOLA SECONDARIA II GRADO,2,10,10,0,0,0
202223,LTTD035005,SCUOLA SECONDARIA II GRADO,1,3,3,0,0,0
202223,RM1E204009,SCUOLA PRIMARIA,1,19,19,0,0,0
202223,NATDZR500T,SCUOLA SECONDARIA II GRADO,4,18,17,1,0,1
202223,SATFIP5005,SCUOLA SECONDARIA II GRADO,1,8,8,0,0,0
202223,CE1E01200N,SCUOLA PRIMARIA,2,19,15,4,0,4
202223,APRF3R500G,SCUOLA SECONDARIA II GRADO,1,3,3,0,0,0
202223,NATDFO5000,SCUOLA SECONDARIA II GRADO,1,15,15,0,0,0
202223,MITL035006,SCUOLA SECONDARIA II GRADO,2,1,0,1,0,1
202223,CRPL01500R,SCUOLA SECONDARIA II GRADO,2,9,8,1,0,1
202223,SAPLLV500D,SCUOLA SECONDARIA II GRADO,4,6,6,0,0,0
202223,MOPS01500X,SCUOLA SECONDARIA II GRADO,1,6,5,1,1,0
202223,BOPL57500R,SCUOLA SECONDARIA II GRADO,3,41,36,5,2,3
202223,NA1E01200G,SCUOLA PRIMARIA,2,20,20,0,0,0
202223,PV1E001009,SCUOLA PRIMARIA,5,29,29,0,0,0
202223,BS1M004006,SCUOLA SECONDARIA I GRADO,3,147,143,4,2,2
202223,SRTDRP500U,SCUOLA SECONDARIA II GRADO,5,47,45,2,1,1
202223,VR1M020006,SCUOLA SECONDARIA I GRADO,1,28,27,1,0,1
202223,AVTDMI500Z,SCUOLA SECONDARIA II GRADO,1,3,3,0,0,0
202223,RM1E150006,SCUOLA PRIMARIA,1,17,16,1,1,0
202223,TOPS125006,SCUOLA SECONDARIA II GRADO,5,9,8,1,1,0
202223,CZPC00500G,SCUOLA SECONDARIA II GRADO,4,14,14,0,0,0
202223,RMPS24500R,SCUOLA SECONDARIA II GRADO,3,47,40,7,0,7
202223,RM1M024002,SCUOLA SECONDARIA I GRADO,3,50,43,7,2,5
202223,COTN025007,SCUOLA SECONDARIA II GRADO,2,4,4,0,0,0
202223,SAPL3T500R,SCUOLA SECONDARIA II GRADO,3,6,6,0,0,0
202223,MO1E01000G,SCUOLA PRIMARIA,3,23,21,2,1,1
202223,NA1E08400D,SCUOLA PRIMARIA,4,38,38,0,0,0
202223,RMPL07500N,SCUOLA SECONDARIA II GRADO,1,42,34,8,0,8
202223,SATD4D500E,SCUOLA SECONDARIA II GRADO,3,7,7,0,0,0
202223,BS1M02200Q,SCUOLA SECONDARIA I GRADO,1,35,35,0,0,0
202223,MIPC04500B,SCUOLA SECONDARIA II GRADO,3,35,35,0,0,0
202223,MIPC09500C,SCUOLA SECONDARIA II GRADO,2,42,40,2,0,2
202223,PC1M00100C,SCUOLA SECONDARIA I GRADO,3,22,22,0,0,0
202223,PATL00500R,SCUOLA SECONDARIA II GRADO,3,2,2,0,0,0
202223,VRPL06500E,SCUOLA SECONDARIA II GRADO,2,10,9,1,0,1
202223,RM1M058005,SCUOLA SECONDARIA I GRADO,2,15,8,7,0,7
202223,MB1M02900D,SCUOLA SECONDARIA I GRADO,1,53,53,0,0,0
202223,NATD255008,SCUOLA SECONDARIA II GRADO,4,20,20,0,0,0
202223,TATD06500L,SCUOLA SECONDARIA II GRADO,3,4,3,1,1,0
202223,RA1E00600V,SCUOLA PRIMARIA,3,33,33,0,0,0
202223,MI1M00800G,SCUOLA SECONDARIA I GRADO,2,72,70,2,0,2
202223,NA1E081002,SCUOLA PRIMARIA,3,11,8,3,0,3
202223,TV1E005007,SCUOLA PRIMARIA,5,22,22,0,0,0
202223,VTPSP5500E,SCUOLA SECONDARIA II GRADO,5,26,25,1,0,1
202223,VA1M009009,SCUOLA SECONDARIA I GRADO,1,46,46,0,0,0
202223,FO1E001006,SCUOLA PRIMARIA,3,16,16,0,0,0
202223,FGTDO25007,SCUOLA SECONDARIA II GRADO,1,3,1,2,2,0
202223,CTPSQC5001,SCUOLA SECONDARIA II GRADO,5,4,4,0,0,0
202223,VATFQS5007,SCUOLA SECONDARIA II GRADO,1,24,23,1,0,1
202223,CO1EMI5009,SCUOLA PRIMARIA,1,27,23,4,0,4
202223,RMPLA95002,SCUOLA SECONDARIA II GRADO,2,23,18,5,2,3
202223,PC1E001007,SCUOLA PRIMARIA,5,14,13,1,0,1
202223,AR1E001005,SCUOLA PRIMARIA,4,25,25,0,0,0
202223,RM1M07100G,SCUOLA SECONDARIA I GRADO,1,91,83,8,0,8
202223,BG1E030001,SCUOLA PRIMARIA,5,54,54,0,0,0
202223,AV1E008005,SCUOLA PRIMARIA,2,17,17,0,0,0
202223,MB1M02100V,SCUOLA SECONDARIA I GRADO,3,87,87,0,0,0
202223,RMSLZ35008,SCUOLA SECONDARIA II GRADO,4,3,3,0,0,0
202223,PI1E00100Q,SCUOLA PRIMARIA,3,34,32,2,1,1
202223,MI1E00200B,SCUOLA PRIMARIA,4,18,17,1,0,1
202223,GE1E00900C,SCUOLA PRIMARIA,2,36,35,1,0,1
202223,REPM3F5001,SCUOLA SECONDARIA II GRADO,1,14,12,2,0,2
202223,RG1E004008,SCUOLA PRIMARIA,4,21,21,0,0,0
202223,MIPS085001,SCUOLA SECONDARIA II GRADO,1,51,51,0,0,0
202223,PARH74500O,SCUOLA SECONDARIA II GRADO,4,2,2,0,0,0
202223,SATD22500V,SCUOLA SECONDARIA II GRADO,5,52,46,6,1,5
202223,TO1M020006,SCUOLA SECONDARIA I GRADO,3,62,62,0,0,0
202223,BGPC05500B,SCUOLA SECONDARIA II GRADO,5,11,11,0,0,0
202223,RMPMIO5006,SCUOLA SECONDARIA II GRADO,5,16,16,0,0,0
202223,CO1E013002,SCUOLA PRIMARIA,5,35,33,2,0,2
202223,FIPS02500P,SCUOLA SECONDARIA II GRADO,5,23,23,0,0,0
202223,RMPL39500D,SCUOLA SECONDARIA II GRADO,2,20,20,0,0,0
202223,NA1E093008,SCUOLA PRIMARIA,5,15,14,1,0,1
202223,RCTD035005,SCUOLA SECONDARIA II GRADO,4,3,3,0,0,0
202223,MO1E00700Q,SCUOLA PRIMARIA,1,48,46,2,1,1
202223,BATD105005,SCUOLA SECONDARIA II GRADO,5,44,42,2,1,1
202223,CA1M01000R,SCUOLA SECONDARIA I GRADO,2,45,44,1,0,1
202223,RM1E094003,SCUOLA PRIMARIA,3,75,73,2,0,2
202223,RM1ERB5004,SCUOLA PRIMARIA,2,9,8,1,1,0
202223,CT1ET9500Z,SCUOLA PRIMARIA,5,23,21,2,1,1
202223,CTPM075009,SCUOLA SECONDARIA II GRADO,5,10,10,0,0,0
202223,BSPM57500D,SCUOLA SECONDARIA II GRADO,2,53,53,0,0,0
202223,TOPC075007,SCUOLA SECONDARIA II GRADO,4,36,36,0,0,0
202223,RMPSVP500H,SCUOLA SECONDARIA II GRADO,3,13,12,1,0,1
202223,VAPSVA500Z,SCUOLA SECONDARIA II GRADO,1,22,22,0,0,0
202223,BA1E00400B,SCUOLA PRIMARIA,1,32,32,0,0,0
202223,NA1E178003,SCUOLA PRIMARIA,4,24,22,2,1,1
202223,MB1E06900P,SCUOLA PRIMARIA,2,42,39,3,1,2
202223,NAPLZL5002,SCUOLA SECONDARIA II GRADO,5,20,20,0,0,0
202223,CE1E04700L,SCUOLA PRIMARIA,5,10,10,0,0,0
202223,CE1E02700B,SCUOLA PRIMARIA,4,22,20,2,0,2
202223,MITDGN5002,SCUOLA SECONDARIA II GRADO,3,17,12,5,0,5
202223,VAPL08500N,SCUOLA SECONDARIA II GRADO,4,14,12,2,1,1
202223,BNTDC1500F,SCUOLA SECONDARIA II GRADO,4,3,3,0,0,0
202223,NA1E13100T,SCUOLA PRIMARIA,4,20,20,0,0,0
202223,RM1E11700E,SCUOLA PRIMARIA,4,14,12,2,0,2
202223,BO1E00800N,SCUOLA PRIMARIA,2,14,12,2,0,2
202223,BG1E021006,SCUOLA PRIMARIA,5,19,18,1,1,0
202223,TO1E00700E,SCUOLA PRIMARIA,5,36,36,0,0,0
202223,CLTD095008,SCUOLA SECONDARIA II GRADO,2,7,7,0,0,0
202223,LI1E00200T,SCUOLA PRIMARIA,5,26,26,0,0,0
202223,NA1E18300E,SCUOLA PRIMARIA,3,39,39,0,0,0
202223,CS1E010005,SCUOLA PRIMARIA,1,8,8,0,0,0
202223,ALRH01500G,SCUOLA SECONDARIA II GRADO,2,23,22,1,0,1
202223,GE1E02200V,SCUOLA PRIMARIA,4,24,20,4,2,2
202223,CTTD195006,SCUOLA SECONDARIA II GRADO,4,8,8,0,0,0
202223,FRTD5O500I,SCUOLA SECONDARIA II GRADO,2,14,12,2,1,1
202223,RNPL01500X,SCUOLA SECONDARIA II GRADO,4,17,13,4,0,4
202223,FO1E002002,SCUOLA PRIMARIA,3,14,10,4,1,3
202223,PR1E00800V,SCUOLA PRIMARIA,5,18,17,1,0,1
202223,PDPC01500T,SCUOLA SECONDARIA II GRADO,5,14,14,0,0,0
202223,RM1E106004,SCUOLA PRIMARIA,2,33,29,4,1,3
202223,RMPM195002,SCUOLA SECONDARIA II GRADO,1,12,12,0,0,0
202223,UDPLO3500Z,SCUOLA SECONDARIA II GRADO,1,14,14,0,0,0
202223,MI1E08700B,SCUOLA PRIMARIA,1,83,81,2,0,2
202223,RMTD51500B,SCUOLA SECONDARIA II GRADO,3,12,12,0,0,0
202223,MI1M092004,SCUOLA SECONDARIA I GRADO,3,47,45,2,0,2
202223,RM1E186001,SCUOLA PRIMARIA,3,22,21,1,0,1
202223,RM1E02900X,SCUOLA PRIMARIA,1,23,19,4,1,3
202223,NATD33500X,SCUOLA SECONDARIA II GRADO,5,17,17,0,0,0
202223,SARHGL500M,SCUOLA SECONDARIA II GRADO,2,6,6,0,0,0
202223,SI1E002005,SCUOLA PRIMARIA,4,24,23,1,0,1
202223,PAPMO7500Q,SCUOLA SECONDARIA II GRADO,4,11,11,0,0,0
202223,VA1E009004,SCUOLA PRIMARIA,2,60,60,0,0,0
202223,RM1E199003,SCUOLA PRIMARIA,3,17,17,0,0,0
202223,BG1M014008,SCUOLA SECONDARIA I GRADO,2,97,96,1,0,1
202223,VR1E01500D,SCUOLA PRIMARIA,1,32,31,1,0,1
202223,BGPMIZ500F,SCUOLA SECONDARIA II GRADO,5,3,3,0,0,0
202223,CE1E001007,SCUOLA PRIMARIA,5,3,3,0,0,0
202223,BNRHN2500D,SCUOLA SECONDARIA II GRADO,2,2,2,0,0,0
202223,NA1E113008,SCUOLA PRIMARIA,5,13,13,0,0,0
202223,NA1E127006,SCUOLA PRIMARIA,5,43,43,0,0,0
202223,NATDB75009,SCUOLA SECONDARIA II GRADO,5,210,190,20,2,18
202223,CE1ERT500Q,SCUOLA PRIMARIA,4,15,14,1,1,0
202223,RMPC08500A,SCUOLA SECONDARIA II GRADO,1,72,70,2,0,2
202223,BRTD04500A,SCUOLA SECONDARIA II GRADO,5,25,25,0,0,0
202223,BSTL01500V,SCUOLA SECONDARIA II GRADO,1,1,1,0,0,0
202223,PGTDEI500F,SCUOLA SECONDARIA II GRADO,3,2,2,0,0,0
202223,AGTD02500N,SCUOLA SECONDARIA II GRADO,5,25,25,0,0,0
202223,SA1E016009,SCUOLA PRIMARIA,4,18,18,0,0,0
202223,RM1ES9500O,SCUOLA PRIMARIA,5,11,11,0,0,0
202223,METAR6500G,SCUOLA SECONDARIA II GRADO,5,32,32,0,0,0
202223,SRTHA6500C,SCUOLA SECONDARIA II GRADO,5,27,27,0,0,0
202223,RM1E206001,SCUOLA PRIMARIA,2,15,15,0,0,0
202223,LC1E00700C,SCUOLA PRIMARIA,5,21,21,0,0,0
202223,NA1E01700P,SCUOLA PRIMARIA,4,42,40,2,0,2
202223,TVPMVC5000,SCUOLA SECONDARIA II GRADO,4,17,17,0,0,0
202223,VR1M02400D,SCUOLA SECONDARIA I GRADO,3,68,64,4,3,1
202223,NA1E23600T,SCUOLA PRIMARIA,5,8,8,0,0,0
202223,RC1E00300L,SCUOLA PRIMARIA,2,18,17,1,1,0
202223,NATDAR5000,SCUOLA SECONDARIA II GRADO,4,3,3,0,0,0
202223,CE1ECZ5004,SCUOLA PRIMARIA,5,10,10,0,0,0
202223,RMPC19500T,SCUOLA SECONDARIA II GRADO,5,15,15,0,0,0
202223,RM1M149007,SCUOLA SECONDARIA I GRADO,2,23,22,1,0,1
202223,BSTF01500P,SCUOLA SECONDARIA II GRADO,5,18,18,0,0,0
202223,APPCU15007,SCUOLA SECONDARIA II GRADO,5,44,42,2,0,2
202223,TS1E001006,SCUOLA PRIMARIA,1,22,22,0,0,0
202223,RM1E02600C,SCUOLA PRIMARIA,3,60,60,0,0,0
202223,PDRHMH500P,SCUOLA SECONDARIA II GRADO,1,16,16,0,0,0
202223,VITB15500E,SCUOLA SECONDARIA II GRADO,4,10,10,0,0,0
202223,MCTD00500B,SCUOLA SECONDARIA II GRADO,5,52,50,2,1,1
202223,METFU8500R,SCUOLA SECONDARIA II GRADO,4,1,1,0,0,0
202223,SSTD015004,SCUOLA SECONDARIA II GRADO,3,5,5,0,0,0
202223,TVPS05500D,SCUOLA SECONDARIA II GRADO,3,16,16,0,0,0
202223,TVPC48500H,SCUOLA SECONDARIA II GRADO,2,17,17,0,0,0
202223,RM1E157001,SCUOLA PRIMARIA,3,18,15,3,1,2
202223,FE1E8D500F,SCUOLA PRIMARIA,1,17,17,0,0,0
202223,NA1E14500Q,SCUOLA PRIMARIA,2,19,19,0,0,0
202223,CT1E02300A,SCUOLA PRIMARIA,4,14,13,1,0,1
202223,MIPSRF5008,SCUOLA SECONDARIA II GRADO,2,5,5,0,0,0
202223,RMRHZT500U,SCUOLA SECONDARIA II GRADO,1,3,3,0,0,0
202223,SATD13500L,SCUOLA SECONDARIA II GRADO,1,8,7,1,0,1
202223,SARHGU5003,SCUOLA SECONDARIA II GRADO,4,5,5,0,0,0
202223,RN1E006005,SCUOLA PRIMARIA,5,14,11,3,0,3
202223,RE1M00400V,SCUOLA SECONDARIA I GRADO,2,60,60,0,0,0
202223,MI1E01400N,SCUOLA PRIMARIA,2,32,31,1,0,1
202223,NAPCFD500P,SCUOLA SECONDARIA II GRADO,5,48,48,0,0,0
202223,SAPS9B500T,SCUOLA SECONDARIA II GRADO,4,5,5,0,0,0
202223,TV1E00300G,SCUOLA PRIMARIA,2,39,38,1,0,1
202223,RI1E00100D,SCUOLA PRIMARIA,2,5,5,0,0,0
202223,PASD005001,SCUOLA SECONDARIA II GRADO,1,87,87,0,0,0
202223,VA1M004006,SCUOLA SECONDARIA I GRADO,1,33,33,0,0,0
202223,NA1EAN500C,SCUOLA PRIMARIA,3,18,17,1,0,1
202223,SVPM02500N,SCUOLA SECONDARIA II GRADO,3,19,19,0,0,0
202223,PO1E01700E,SCUOLA PRIMARIA,1,7,2,5,0,5
202223,VATFE2500M,SCUOLA SECONDARIA II GRADO,4,25,24,1,0,1
202223,SATFRP500A,SCUOLA SECONDARIA II GRADO,5,67,67,0,0,0
202223,NATFRU500B,SCUOLA SECONDARIA II GRADO,5,69,64,5,3,2
202223,NOPL6T5005,SCUOLA SECONDARIA II GRADO,2,11,10,1,0,1
202223,UD1E00900V,SCUOLA PRIMARIA,5,13,13,0,0,0
202223,MI1E00100G,SCUOLA PRIMARIA,5,49,40,9,0,9
202223,NA1E06600X,SCUOLA PRIMARIA,3,17,16,1,0,1
202223,FI1E06100L,SCUOLA PRIMARIA,3,14,14,0,0,0
202223,ANPM3A500M,SCUOLA SECONDARIA II GRADO,3,9,7,2,1,1
202223,RM1E00400G,SCUOLA PRIMARIA,1,20,19,1,0,1
202223,VT1M00400V,SCUOLA SECONDARIA I GRADO,2,17,17,0,0,0
202223,RM1E2U500H,SCUOLA PRIMARIA,4,26,26,0,0,0
202223,NA1EPH500O,SCUOLA PRIMARIA,5,16,15,1,1,0
202223,BSPS075008,SCUOLA SECONDARIA II GRADO,5,45,45,0,0,0
202223,VE1E00700V,SCUOLA PRIMARIA,2,13,4,9,3,6
202223,FG1E023005,SCUOLA PRIMARIA,5,13,13,0,0,0
202223,MIPS295009,SCUOLA SECONDARIA II GRADO,2,47,45,2,0,2
202223,RMTD545007,SCUOLA SECONDARIA II GRADO,3,14,12,2,0,2
202223,MI1E070002,SCUOLA PRIMARIA,3,24,22,2,1,1
202223,RMPSCH500E,SCUOLA SECONDARIA II GRADO,3,13,13,0,0,0
202223,MIPM2A500Z,SCUOLA SECONDARIA II GRADO,5,27,25,2,0,2
202223,RM1EBQ5007,SCUOLA PRIMARIA,5,16,16,0,0,0
202223,NARHA8500Q,SCUOLA SECONDARIA II GRADO,2,9,9,0,0,0
202223,PA1E043004,SCUOLA PRIMARIA,1,13,10,3,0,3
202223,PD1M00500A,SCUOLA SECONDARIA I GRADO,2,38,37,1,0,1
202223,NA1E25900E,SCUOLA PRIMARIA,4,10,10,0,0,0
202223,BI1E00200D,SCUOLA PRIMARIA,5,16,16,0,0,0
202223,FG1E016002,SCUOLA PRIMARIA,4,12,8,4,4,0
202223,BA1E00900E,SCUOLA PRIMARIA,3,58,56,2,1,1
202223,MTTD01500D,SCUOLA SECONDARIA II GRADO,5,41,35,6,1,5
202223,CLTD095008,SCUOLA SECONDARIA II GRADO,4,8,7,1,1,0
202223,RA1E00300B,SCUOLA PRIMARIA,1,25,24,1,0,1
202223,MI1M00300C,SCUOLA SECONDARIA I GRADO,2,51,51,0,0,0
202223,VR1E011006,SCUOLA PRIMARIA,2,21,21,0,0,0
202223,CE1E052004,SCUOLA PRIMARIA,5,15,15,0,0,0
202223,BO1M00900P,SCUOLA SECONDARIA I GRADO,2,63,63,0,0,0
202223,TS1E001006,SCUOLA PRIMARIA,5,21,21,0,0,0
202223,CTTL005008,SCUOLA SECONDARIA II GRADO,5,35,35,0,0,0
202223,VA1M01600C,SCUOLA SECONDARIA I GRADO,3,58,58,0,0,0
202223,MITD5V500H,SCUOLA SECONDARIA II GRADO,1,39,36,3,1,2
202223,VB1M02000P,SCUOLA SECONDARIA I GRADO,1,15,15,0,0,0
202223,TVPS035008,SCUOLA SECONDARIA II GRADO,3,36,34,2,1,1
202223,FI1E01100G,SCUOLA PRIMARIA,5,24,22,2,0,2
202223,AVRH015007,SCUOLA SECONDARIA II GRADO,1,12,12,0,0,0
202223,CORH005002,SCUOLA SECONDARIA II GRADO,5,29,28,1,0,1
202223,RM1E15300N,SCUOLA PRIMARIA,1,26,26,0,0,0
202223,TOPS09500G,SCUOLA SECONDARIA II GRADO,2,43,41,2,0,2
202223,PATF02500T,SCUOLA SECONDARIA II GRADO,2,3,3,0,0,0
202223,MBRC4H500I,SCUOLA SECONDARIA II GRADO,5,7,6,1,0,1
202223,PD1E006001,SCUOLA PRIMARIA,4,20,18,2,0,2
202223,RMPS27500L,SCUOLA SECONDARIA II GRADO,2,25,22,3,0,3
202223,PVPM025004,SCUOLA SECONDARIA II GRADO,4,24,24,0,0,0
202223,MI1E14200P,SCUOLA PRIMARIA,4,48,48,0,0,0
202223,TV1M001005,SCUOLA SECONDARIA I GRADO,1,44,40,4,1,3
202223,SARHB65008,SCUOLA SECONDARIA II GRADO,4,2,2,0,0,0
202223,LCTDVP5000,SCUOLA SECONDARIA II GRADO,4,26,25,1,1,0
202223,CE1E03800T,SCUOLA PRIMARIA,2,29,29,0,0,0
202223,NAPL975007,SCUOLA SECONDARIA II GRADO,3,5,5,0,0,0
202223,PAPS00500E,SCUOLA SECONDARIA II GRADO,4,16,16,0,0,0
202223,CERHP55001,SCUOLA SECONDARIA II GRADO,1,5,5,0,0,0
202223,NARHRH500P,SCUOLA SECONDARIA II GRADO,2,7,5,2,0,2
202223,TO1E6R5003,SCUOLA PRIMARIA,4,45,43,2,1,1
202223,NA1MSZ5005,SCUOLA SECONDARIA I GRADO,1,19,19,0,0,0
202223,BSRF06500X,SCUOLA SECONDARIA II GRADO,3,26,26,0,0,0
202223,VBRH155008,SCUOLA SECONDARIA II GRADO,4,20,19,1,0,1
202223,SATLRU500B,SCUOLA SECONDARIA II GRADO,3,5,5,0,0,0
202223,NATF6F5005,SCUOLA SECONDARIA II GRADO,1,10,10,0,0,0
202223,BG1E01500V,SCUOLA PRIMARIA,4,37,32,5,0,5
202223,MI1M098003,SCUOLA SECONDARIA I GRADO,2,113,111,2,1,1
202223,BS1E017003,SCUOLA PRIMARIA,4,70,69,1,1,0
202223,VEPS04500V,SCUOLA SECONDARIA II GRADO,3,29,28,1,0,1
202223,SA1E01300T,SCUOLA PRIMARIA,4,24,23,1,1,0
202223,RM1E051005,SCUOLA PRIMARIA,5,27,24,3,0,3
202223,LCTAB3500P,SCUOLA SECONDARIA II GRADO,3,9,9,0,0,0
202223,AN1E002005,SCUOLA PRIMARIA,4,21,19,2,0,2
202223,BOPL57500R,SCUOLA SECONDARIA II GRADO,4,42,38,4,0,4
202223,CERI59500T,SCUOLA SECONDARIA II GRADO,1,10,10,0,0,0
202223,MIPS09500G,SCUOLA SECONDARIA II GRADO,1,79,70,9,0,9
202223,LTPSO3500F,SCUOLA SECONDARIA II GRADO,4,3,3,0,0,0
202223,MIPSRS500B,SCUOLA SECONDARIA II GRADO,5,26,24,2,0,2
202223,PA1MS3500I,SCUOLA SECONDARIA I GRADO,1,5,5,0,0,0
202223,LI1E00800R,SCUOLA PRIMARIA,5,17,17,0,0,0
202223,TOPSQB5003,SCUOLA SECONDARIA II GRADO,4,9,5,4,3,1
202223,RM1E10400C,SCUOLA PRIMARIA,2,23,23,0,0,0
202223,FI1E026009,SCUOLA PRIMARIA,3,21,20,1,0,1
202223,BOPSHR500B,SCUOLA SECONDARIA II GRADO,2,24,24,0,0,0
202223,CE1E031003,SCUOLA PRIMARIA,3,10,9,1,0,1
202223,NARH02500L,SCUOLA SECONDARIA II GRADO,3,58,58,0,0,0
202223,PA1M01100T,SCUOLA SECONDARIA I GRADO,3,24,23,1,0,1
202223,TOPQ475003,SCUOLA SECONDARIA II GRADO,5,10,8,2,1,1
202223,RMPM5R5008,SCUOLA SECONDARIA II GRADO,4,12,11,1,1,0
202223,RM1E122002,SCUOLA PRIMARIA,4,16,15,1,0,1
202223,VRPL06500E,SCUOLA SECONDARIA II GRADO,1,14,12,2,1,1
202223,BN1M002007,SCUOLA SECONDARIA I GRADO,1,20,20,0,0,0
202223,NA1E086005,SCUOLA PRIMARIA,2,36,36,0,0,0
202223,RM1M665000,SCUOLA SECONDARIA I GRADO,2,13,13,0,0,0
202223,NAPSAT500N,SCUOLA SECONDARIA II GRADO,2,5,5,0,0,0
202223,MN1E001004,SCUOLA PRIMARIA,2,10,5,5,0,5
202223,NA1E007004,SCUOLA PRIMARIA,2,20,20,0,0,0
202223,MI1M00600X,SCUOLA SECONDARIA I GRADO,1,41,40,1,0,1
202223,MB1E04900D,SCUOLA PRIMARIA,1,55,52,3,0,3
202223,PDTF015003,SCUOLA SECONDARIA II GRADO,4,15,14,1,1,0
202223,FI1E03100R,SCUOLA PRIMARIA,4,17,17,0,0,0
202223,CE1E022008,SCUOLA PRIMARIA,5,23,23,0,0,0
202223,ME1E01200P,SCUOLA PRIMARIA,3,12,12,0,0,0
202223,SATD9L5009,SCUOLA SECONDARIA II GRADO,2,5,5,0,0,0
202223,RMPC285004,SCUOLA SECONDARIA II GRADO,5,17,17,0,0,0
202223,PS1E00100G,SCUOLA PRIMARIA,4,22,22,0,0,0
202223,PA1M02400X,SCUOLA SECONDARIA I GRADO,2,31,30,1,0,1
202223,NA1E13900C,SCUOLA PRIMARIA,5,19,19,0,0,0
202223,MI1E08400X,SCUOLA PRIMARIA,5,21,20,1,0,1
202223,VRPSEM5005,SCUOLA SECONDARIA II GRADO,3,4,4,0,0,0
202223,CT1E016007,SCUOLA PRIMARIA,2,79,75,4,1,3
202223,NAPS065009,SCUOLA SECONDARIA II GRADO,4,5,5,0,0,0
202223,NATFZM500T,SCUOLA SECONDARIA II GRADO,4,5,4,1,0,1
202223,CE1E06100V,SCUOLA PRIMARIA,2,10,10,0,0,0
202223,VTPS015009,SCUOLA SECONDARIA II GRADO,2,6,5,1,0,1
202223,CE1E029003,SCUOLA PRIMARIA,5,12,11,1,0,1
202223,VA1M005002,SCUOLA SECONDARIA I GRADO,2,17,15,2,0,2
202223,CETD43500Q,SCUOLA SECONDARIA II GRADO,4,7,7,0,0,0
202223,TO1M02400D,SCUOLA SECONDARIA I GRADO,1,23,23,0,0,0
202223,BGPL01500V,SCUOLA SECONDARIA II GRADO,2,7,7,0,0,0
202223,RMPLO35009,SCUOLA SECONDARIA II GRADO,4,6,6,0,0,0
202223,VRPS025009,SCUOLA SECONDARIA II GRADO,4,67,67,0,0,0
202223,LO1M02000T,SCUOLA SECONDARIA I GRADO,3,13,11,2,1,1
202223,PGPMCG500I,SCUOLA SECONDARIA II GRADO,1,10,7,3,0,3
202223,REPM7R500G,SCUOLA SECONDARIA II GRADO,4,6,6,0,0,0
202223,RNPS00500E,SCUOLA SECONDARIA II GRADO,5,20,19,1,0,1
202223,RN1M02000L,SCUOLA SECONDARIA I GRADO,3,104,99,5,2,3
202223,LU1ETH500S,SCUOLA PRIMARIA,5,10,8,2,0,2
202223,NA1E030005,SCUOLA PRIMARIA,5,10,9,1,1,0
202223,VR1ESU500Z,SCUOLA PRIMARIA,2,19,19,0,0,0
202223,SATNTR5000,SCUOLA SECONDARIA II GRADO,4,1,1,0,0,0
202223,CO1E01500N,SCUOLA PRIMARIA,3,12,12,0,0,0
202223,NA1E270009,SCUOLA PRIMARIA,1,20,20,0,0,0
202223,UDTBCH500I,SCUOLA SECONDARIA II GRADO,4,17,14,3,2,1
202223,BN1E82500A,SCUOLA PRIMARIA,4,28,28,0,0,0
202223,PA1E01800B,SCUOLA PRIMARIA,1,23,23,0,0,0
202223,CR1E00900D,SCUOLA PRIMARIA,1,33,33,0,0,0
202223,MO1M001002,SCUOLA SECONDARIA I GRADO,1,26,25,1,0,1
202223,BG1E00900G,SCUOLA PRIMARIA,1,16,14,2,0,2
202223,CA1E019002,SCUOLA PRIMARIA,1,17,15,2,0,2
202223,TO1E040006,SCUOLA PRIMARIA,5,49,47,2,1,1
202223,AGTF825005,SCUOLA SECONDARIA II GRADO,3,1,1,0,0,0
202223,TO1E024008,SCUOLA PRIMARIA,3,46,44,2,0,2
202223,ALPMQR5008,SCUOLA SECONDARIA II GRADO,1,5,5,0,0,0
202223,VA1E4D500Q,SCUOLA PRIMARIA,3,40,38,2,0,2
202223,SV1E00300E,SCUOLA PRIMARIA,5,25,24,1,1,0
202223,NA1E044003,SCUOLA PRIMARIA,2,39,39,0,0,0
202223,RM1E12500D,SCUOLA PRIMARIA,1,12,11,1,0,1
202223,MIPLGB500O,SCUOLA SECONDARIA II GRADO,2,22,21,1,0,1
202223,FIPS00500D,SCUOLA SECONDARIA II GRADO,1,10,9,1,0,1
202223,MBPSFH500F,SCUOLA SECONDARIA II GRADO,4,13,12,1,0,1
202223,MBRH00500P,SCUOLA SECONDARIA II GRADO,5,43,43,0,0,0
202223,BA1E005007,SCUOLA PRIMARIA,4,13,13,0,0,0
202223,MI1E062003,SCUOLA PRIMARIA,2,51,50,1,0,1
202223,NATLT3500M,SCUOLA SECONDARIA II GRADO,5,57,57,0,0,0
202223,SA1M012007,SCUOLA SECONDARIA I GRADO,2,9,8,1,0,1
202223,RM1E01800D,SCUOLA PRIMARIA,2,14,9,5,1,4
202223,LO1E00500E,SCUOLA PRIMARIA,3,37,36,1,0,1
202223,PZ1E002007,SCUOLA PRIMARIA,5,26,26,0,0,0
202223,RMTF18500C,SCUOLA SECONDARIA II GRADO,5,23,23,0,0,0
202223,BGPSH85002,SCUOLA SECONDARIA II GRADO,5,28,27,1,1,0
202223,PETD06500C,SCUOLA SECONDARIA II GRADO,4,1,1,0,0,0
202223,BS1E02200E,SCUOLA PRIMARIA,2,41,37,4,0,4
202223,MESD01500T,SCUOLA SECONDARIA II GRADO,2,11,11,0,0,0
202223,SV1E006002,SCUOLA PRIMARIA,3,12,12,0,0,0
202223,VAPLVL5003,SCUOLA SECONDARIA II GRADO,3,14,14,0,0,0
202223,BSPME1500B,SCUOLA SECONDARIA II GRADO,4,35,34,1,0,1
202223,NA1E234006,SCUOLA PRIMARIA,5,20,20,0,0,0
202223,NATFGP5005,SCUOLA SECONDARIA II GRADO,2,2,2,0,0,0
202223,RM1E11000Q,SCUOLA PRIMARIA,4,44,44,0,0,0
202223,PATDCH5009,SCUOLA SECONDARIA II GRADO,2,2,2,0,0,0
202223,NA1E151003,SCUOLA PRIMARIA,2,31,31,0,0,0
202223,NATD575004,SCUOLA SECONDARIA II GRADO,2,6,6,0,0,0
202223,BG1E026009,SCUOLA PRIMARIA,2,23,19,4,0,4
202223,VR1MN2500I,SCUOLA SECONDARIA I GRADO,3,23,23,0,0,0
202223,MB1M02700T,SCUOLA SECONDARIA I GRADO,3,46,46,0,0,0
202223,MBPS0G5007,SCUOLA SECONDARIA II GRADO,5,12,11,1,0,1
202223,BSRF3E5000,SCUOLA SECONDARIA II GRADO,2,6,4,2,0,2
202223,TO1E01400N,SCUOLA PRIMARIA,5,28,24,4,3,1
202223,AP1MUQ500M,SCUOLA SECONDARIA I GRADO,1,3,2,1,0,1
202223,NA1E07500P,SCUOLA PRIMARIA,3,20,19,1,0,1
202223,RMTDSN500S,SCUOLA SECONDARIA II GRADO,4,4,4,0,0,0
202223,NATF9E5003,SCUOLA SECONDARIA II GRADO,2,3,3,0,0,0
202223,MI1MB1500E,SCUOLA SECONDARIA I GRADO,1,21,21,0,0,0
202223,MIPS09500G,SCUOLA SECONDARIA II GRADO,5,57,56,1,0,1
202223,RMTD67500X,SCUOLA SECONDARIA II GRADO,3,12,10,2,0,2
202223,MIPS79500P,SCUOLA SECONDARIA II GRADO,5,5,4,1,1,0
202223,MIPSQB5007,SCUOLA SECONDARIA II GRADO,3,32,31,1,0,1
202223,MBPM145009,SCUOLA SECONDARIA II GRADO,5,17,17,0,0,0
202223,RM1E18200N,SCUOLA PRIMARIA,5,19,17,2,0,2
202223,PGTDEI500F,SCUOLA SECONDARIA II GRADO,4,2,2,0,0,0
202223,PO1E001001,SCUOLA PRIMARIA,5,24,22,2,0,2
202223,VA1E01300Q,SCUOLA PRIMARIA,4,40,37,3,0,3
202223,NARFA35009,SCUOLA SECONDARIA II GRADO,5,63,58,5,1,4
202223,NARH9B500E,SCUOLA SECONDARIA II GRADO,1,24,23,1,0,1
202223,RM1E20800L,SCUOLA PRIMARIA,5,18,17,1,0,1
202223,CTPC605004,SCUOLA SECONDARIA II GRADO,1,1,1,0,0,0
202223,BGPMVO500T,SCUOLA SECONDARIA II GRADO,4,31,30,1,1,0
202223,NA1E057005,SCUOLA PRIMARIA,1,15,14,1,0,1
202223,VR1E018001,SCUOLA PRIMARIA,1,16,13,3,0,3
202223,MC1E001003,SCUOLA PRIMARIA,3,22,22,0,0,0
202223,RM1M09700Q,SCUOLA SECONDARIA I GRADO,2,50,48,2,1,1
202223,MB1M009008,SCUOLA SECONDARIA I GRADO,2,50,50,0,0,0
202223,MITN535006,SCUOLA SECONDARIA II GRADO,1,18,14,4,1,3
202223,BAPS815002,SCUOLA SECONDARIA II GRADO,5,24,23,1,0,1
202223,RM1E18900C,SCUOLA PRIMARIA,1,12,12,0,0,0
202223,BG1E013007,SCUOLA PRIMARIA,2,20,20,0,0,0
202223,VI1E00300V,SCUOLA PRIMARIA,1,18,16,2,0,2
202223,NA1E199004,SCUOLA PRIMARIA,2,8,8,0,0,0
202223,VA1E00500R,SCUOLA PRIMARIA,2,39,39,0,0,0
202223,RMPS485001,SCUOLA SECONDARIA II GRADO,5,24,22,2,1,1
202223,RM1E09800A,SCUOLA PRIMARIA,3,15,15,0,0,0
202223,AGTL4P500L,SCUOLA SECONDARIA II GRADO,2,1,1,0,0,0
202223,TO1E01900R,SCUOLA PRIMARIA,3,26,26,0,0,0
202223,GE1E01700B,SCUOLA PRIMARIA,2,13,12,1,0,1
202223,PTPM02500D,SCUOLA SECONDARIA II GRADO,1,21,17,4,2,2
202223,SA1E02300C,SCUOLA PRIMARIA,4,12,12,0,0,0
202223,RM1ES9500O,SCUOLA PRIMARIA,3,6,6,0,0,0
202223,RM1ERR500T,SCUOLA PRIMARIA,1,12,9,3,1,2
202223,METD08500D,SCUOLA SECONDARIA II GRADO,4,1,1,0,0,0
202223,NARH105008,SCUOLA SECONDARIA II GRADO,1,13,13,0,0,0
202223,TVPS065004,SCUOLA SECONDARIA II GRADO,5,21,21,0,0,0
202223,CTPM075009,SCUOLA SECONDARIA II GRADO,1,5,5,0,0,0
202223,PDPL04500G,SCUOLA SECONDARIA II GRADO,2,23,21,2,0,2
202223,MIPC005001,SCUOLA SECONDARIA II GRADO,2,31,30,1,1,0
202223,RMRH00500A,SCUOLA SECONDARIA II GRADO,3,9,9,0,0,0
202223,NA1E27800X,SCUOLA PRIMARIA,1,31,31,0,0,0
202223,BN1E002002,SCUOLA PRIMARIA,4,15,15,0,0,0
202223,MCPM00500L,SCUOLA SECONDARIA II GRADO,5,17,16,1,0,1
202223,NA1E17500G,SCUOLA PRIMARIA,5,14,12,2,0,2
202223,NA1E192009,SCUOLA PRIMARIA,5,10,10,0,0,0
202223,NAPL00500C,SCUOLA SECONDARIA II GRADO,1,5,5,0,0,0
202223,VR1E00500V,SCUOLA PRIMARIA,2,41,40,1,0,1
202223,BO1E018008,SCUOLA PRIMARIA,3,17,14,3,0,3
202223,CE1E06300E,SCUOLA PRIMARIA,3,11,5,6,3,3
202223,CTTDHQ5002,SCUOLA SECONDARIA II GRADO,4,1,1,0,0,0
202223,FRTF2T500E,SCUOLA SECONDARIA II GRADO,3,7,7,0,0,0
202223,RM1EZR5005,SCUOLA PRIMARIA,5,13,12,1,1,0
202223,IM1E003001,SCUOLA PRIMARIA,5,15,13,2,1,1
202223,NATF365002,SCUOLA SECONDARIA II GRADO,4,7,7,0,0,0
202223,NA1E14600G,SCUOLA PRIMARIA,5,21,21,0,0,0
202223,FG1E01100V,SCUOLA PRIMARIA,1,19,19,0,0,0
202223,BG1E014003,SCUOLA PRIMARIA,5,17,16,1,0,1
202223,RMPS135009,SCUOLA SECONDARIA II GRADO,4,11,11,0,0,0
202223,MS1E00500P,SCUOLA PRIMARIA,4,20,19,1,1,0
202223,MSPSI35008,SCUOLA SECONDARIA II GRADO,3,10,9,1,0,1
202223,CLPC025003,SCUOLA SECONDARIA II GRADO,3,6,6,0,0,0
202223,NA1E18800N,SCUOLA PRIMARIA,1,19,19,0,0,0
202223,TV1E01600N,SCUOLA PRIMARIA,1,25,24,1,1,0
202223,NAPL7N500U,SCUOLA SECONDARIA II GRADO,1,5,5,0,0,0
202223,RM1E00200X,SCUOLA PRIMARIA,4,18,15,3,1,2
202223,LE1E00800D,SCUOLA PRIMARIA,1,21,20,1,1,0
202223,FR1E003001,SCUOLA PRIMARIA,1,13,12,1,0,1
202223,MCPSL3500U,SCUOLA SECONDARIA II GRADO,5,17,17,0,0,0
202223,NAPMSV500U,SCUOLA SECONDARIA II GRADO,3,5,5,0,0,0
202223,PAPSIU5009,SCUOLA SECONDARIA II GRADO,3,9,9,0,0,0
202223,NATF32500G,SCUOLA SECONDARIA II GRADO,1,5,5,0,0,0
202223,SATL00500A,SCUOLA SECONDARIA II GRADO,1,5,5,0,0,0
202223,UD1E008003,SCUOLA PRIMARIA,2,24,24,0,0,0
202223,ATRI02500P,SCUOLA SECONDARIA II GRADO,4,13,9,4,0,4
202223,NA1E21500R,SCUOLA PRIMARIA,5,17,17,0,0,0
202223,BS1E01500B,SCUOLA PRIMARIA,5,24,24,0,0,0
202223,MI1M07400E,SCUOLA SECONDARIA I GRADO,1,12,12,0,0,0
202223,SRPS395007,SCUOLA SECONDARIA II GRADO,5,20,20,0,0,0
202223,NAPC24500P,SCUOLA SECONDARIA II GRADO,3,16,16,0,0,0
202223,SO1M00100Q,SCUOLA SECONDARIA I GRADO,1,14,14,0,0,0
202223,FOPS5G500N,SCUOLA SECONDARIA II GRADO,5,32,32,0,0,0
202223,CT1E82801D,SCUOLA PRIMARIA,2,5,5,0,0,0
202223,FI1E00300L,SCUOLA PRIMARIA,5,22,18,4,2,2
202223,LC1E008008,SCUOLA PRIMARIA,2,17,15,2,0,2
202223,LUPS025006,SCUOLA SECONDARIA II GRADO,1,22,13,9,2,7
202223,NARHP4500A,SCUOLA SECONDARIA II GRADO,1,3,3,0,0,0
202223,BG1M023003,SCUOLA SECONDARIA I GRADO,2,14,14,0,0,0
202223,NA1E03800Q,SCUOLA PRIMARIA,2,12,12,0,0,0
202223,TO1EDV500F,SCUOLA PRIMARIA,5,11,11,0,0,0
202223,PAPL595005,SCUOLA SECONDARIA II GRADO,1,2,2,0,0,0
202223,GE1E03800C,SCUOLA PRIMARIA,4,17,14,3,0,3
202223,TOPL03500P,SCUOLA SECONDARIA II GRADO,1,20,20,0,0,0
202223,AR1E00500C,SCUOLA PRIMARIA,3,14,10,4,2,2
202223,RM1M13900L,SCUOLA SECONDARIA I GRADO,1,55,54,1,0,1
202223,RMTD665009,SCUOLA SECONDARIA II GRADO,2,5,5,0,0,0
202223,TOTF01500R,SCUOLA SECONDARIA II GRADO,3,63,62,1,1,0
202223,RM1E036003,SCUOLA PRIMARIA,5,40,40,0,0,0
202223,RMPS695009,SCUOLA SECONDARIA II GRADO,5,27,27,0,0,0
202223,CS1E00500N,SCUOLA PRIMARIA,3,9,8,1,1,0
202223,FI1E02900R,SCUOLA PRIMARIA,1,18,18,0,0,0
202223,SP1M00200D,SCUOLA SECONDARIA I GRADO,3,31,27,4,0,4
202223,MIPS01500P,SCUOLA SECONDARIA II GRADO,2,36,34,2,0,2
202223,NA1E205006,SCUOLA PRIMARIA,1,13,9,4,0,4
202223,SA1E00200B,SCUOLA PRIMARIA,2,13,13,0,0,0
202223,PD1E020007,SCUOLA PRIMARIA,3,15,15,0,0,0
202223,TVPC01500X,SCUOLA SECONDARIA II GRADO,2,9,9,0,0,0
202223,NA1E27300R,SCUOLA PRIMARIA,3,17,13,4,1,3
202223,BL1E00100G,SCUOLA PRIMARIA,5,29,29,0,0,0
202223,TOPL20500L,SCUOLA SECONDARIA II GRADO,2,24,23,1,0,1
202223,VARCD7500V,SCUOLA SECONDARIA II GRADO,3,40,39,1,0,1
202223,BNRHT2500O,SCUOLA SECONDARIA II GRADO,4,2,1,1,0,1
202223,NAPS39500Q,SCUOLA SECONDARIA II GRADO,2,9,9,0,0,0
202223,NATLGU500N,SCUOLA SECONDARIA II GRADO,4,11,11,0,0,0
202223,RM1E015002,SCUOLA PRIMARIA,5,23,23,0,0,0
202223,CL1E003004,SCUOLA PRIMARIA,5,19,19,0,0,0
202223,LO1MOF5006,SCUOLA SECONDARIA I GRADO,2,22,21,1,0,1
202223,CA1E020006,SCUOLA PRIMARIA,5,25,23,2,1,1
202223,TOTA015004,SCUOLA SECONDARIA II GRADO,3,19,19,0,0,0
202223,CE1E03800T,SCUOLA PRIMARIA,3,28,26,2,0,2
202223,VI1M00600G,SCUOLA SECONDARIA I GRADO,3,20,20,0,0,0
202223,BGPSBT5004,SCUOLA SECONDARIA II GRADO,4,13,13,0,0,0
202223,CTTF04500E,SCUOLA SECONDARIA II GRADO,5,16,16,0,0,0
202223,MITF035002,SCUOLA SECONDARIA II GRADO,3,29,28,1,0,1
202223,PA1EAT500P,SCUOLA PRIMARIA,4,43,43,0,0,0
202223,RM1E150006,SCUOLA PRIMARIA,3,12,12,0,0,0
202223,AVRH2Q500U,SCUOLA SECONDARIA II GRADO,1,4,4,0,0,0
202223,RMRHRE5002,SCUOLA SECONDARIA II GRADO,2,10,8,2,2,0
202223,NA1E11600Q,SCUOLA PRIMARIA,5,16,16,0,0,0
202223,GO1E002006,SCUOLA PRIMARIA,2,5,5,0,0,0
202223,MI1E04300N,SCUOLA PRIMARIA,4,43,43,0,0,0
202223,NATL27500X,SCUOLA SECONDARIA II GRADO,5,66,63,3,1,2
202223,PVPS025003,SCUOLA SECONDARIA II GRADO,2,2,2,0,0,0
202223,SARHRM500C,SCUOLA SECONDARIA II GRADO,4,4,4,0,0,0
202223,LCRC4F500Q,SCUOLA SECONDARIA II GRADO,3,18,17,1,0,1
202223,SARF195006,SCUOLA SECONDARIA II GRADO,1,7,6,1,1,0
202223,CE1E03400E,SCUOLA PRIMARIA,3,17,17,0,0,0
202223,PAPSTT500B,SCUOLA SECONDARIA II GRADO,4,7,7,0,0,0
202223,TS1E007005,SCUOLA PRIMARIA,3,7,6,1,0,1
202223,VA1M017008,SCUOLA SECONDARIA I GRADO,3,130,128,2,0,2
202223,VE1E00200Q,SCUOLA PRIMARIA,5,15,15,0,0,0
202223,FI1E01800A,SCUOLA PRIMARIA,3,16,15,1,0,1
202223,UDTFI2500I,SCUOLA SECONDARIA II GRADO,5,23,23,0,0,0
202223,MI1E089003,SCUOLA PRIMARIA,4,11,7,4,0,4
202223,VRPSN9500T,SCUOLA SECONDARIA II GRADO,5,25,25,0,0,0
202223,PA1E00900L,SCUOLA PRIMARIA,4,26,22,4,0,4
202223,NA1E226007,SCUOLA PRIMARIA,4,15,15,0,0,0
202223,RM1E171007,SCUOLA PRIMARIA,5,29,26,3,1,2
202223,MI1E140003,SCUOLA PRIMARIA,4,40,39,1,0,1
202223,LC1M01000D,SCUOLA SECONDARIA I GRADO,3,37,37,0,0,0
202223,LCPSG9500D,SCUOLA SECONDARIA II GRADO,2,16,16,0,0,0
202223,ALPM02500D,SCUOLA SECONDARIA II GRADO,3,16,16,0,0,0
202223,GE1E027002,SCUOLA PRIMARIA,3,10,10,0,0,0
202223,SA1E004003,SCUOLA PRIMARIA,4,25,25,0,0,0
202223,VTPLR35005,SCUOLA SECONDARIA II GRADO,4,3,3,0,0,0
202223,RN1E01000R,SCUOLA PRIMARIA,4,26,26,0,0,0
202223,PO1E00700X,SCUOLA PRIMARIA,2,19,10,9,0,9
202223,PDPS00500A,SCUOLA SECONDARIA II GRADO,5,33,33,0,0,0
202223,RMPM00500N,SCUOLA SECONDARIA II GRADO,2,12,11,1,1,0
202223,FIPSZD500T,SCUOLA SECONDARIA II GRADO,1,12,11,1,0,1
202223,MI1E05100L,SCUOLA PRIMARIA,5,44,40,4,0,4
202223,SAPS06500Q,SCUOLA SECONDARIA II GRADO,4,5,5,0,0,0
202223,SAPMBS5006,SCUOLA SECONDARIA II GRADO,1,8,8,0,0,0
202223,LO1E001007,SCUOLA PRIMARIA,3,26,26,0,0,0
202223,FI1E030001,SCUOLA PRIMARIA,2,13,11,2,1,1
202223,NO1E00400G,SCUOLA PRIMARIA,3,69,66,3,0,3
202223,NOPL015002,SCUOLA SECONDARIA II GRADO,4,9,8,1,0,1
202223,PSPS005004,SCUOLA SECONDARIA II GRADO,1,5,3,2,0,2
202223,BOPMNL500M,SCUOLA SECONDARIA II GRADO,2,31,31,0,0,0
202223,FI1M01800G,SCUOLA SECONDARIA I GRADO,1,20,18,2,0,2
202223,COTD06500Q,SCUOLA SECONDARIA II GRADO,1,9,8,1,0,1
202223,NA1E24900X,SCUOLA PRIMARIA,4,24,24,0,0,0
202223,RM1E134008,SCUOLA PRIMARIA,1,13,13,0,0,0
202223,RMPM195002,SCUOLA SECONDARIA II GRADO,4,19,17,2,0,2
202223,ENTDID500H,SCUOLA SECONDARIA II GRADO,1,2,2,0,0,0
202223,CEPL015005,SCUOLA SECONDARIA II GRADO,1,14,11,3,0,3
202223,SAPMSZ500D,SCUOLA SECONDARIA II GRADO,3,8,8,0,0,0
202223,MNPC015004,SCUOLA SECONDARIA II GRADO,4,4,4,0,0,0
202223,LISL00500B,SCUOLA SECONDARIA II GRADO,2,6,6,0,0,0
202223,BG1E006004,SCUOLA PRIMARIA,5,52,49,3,0,3
202223,TO1E05800B,SCUOLA PRIMARIA,2,13,4,9,4,5
202223,VAPS1O500A,SCUOLA SECONDARIA II GRADO,2,42,40,2,1,1
202223,COPSIS500Q,SCUOLA SECONDARIA II GRADO,5,15,13,2,0,2
202223,MIPC125003,SCUOLA SECONDARIA II GRADO,1,14,14,0,0,0
202223,PATDEE500L,SCUOLA SECONDARIA II GRADO,4,3,3,0,0,0
202223,RM1M06900G,SCUOLA SECONDARIA I GRADO,2,34,34,0,0,0
202223,NAPS5M500T,SCUOLA SECONDARIA II GRADO,3,17,5,12,10,2
202223,GR1M00200E,SCUOLA SECONDARIA I GRADO,2,25,25,0,0,0
202223,MBPS40500C,SCUOLA SECONDARIA II GRADO,3,19,19,0,0,0
202223,NA1E08400D,SCUOLA PRIMARIA,3,34,34,0,0,0
202223,FO1E00300T,SCUOLA PRIMARIA,3,18,17,1,0,1
202223,CETDA05001,SCUOLA SECONDARIA II GRADO,2,11,9,2,0,2
202223,BS1E01900P,SCUOLA PRIMARIA,3,28,26,2,0,2
202223,BSPMS9500M,SCUOLA SECONDARIA II GRADO,5,45,42,3,1,2
202223,VE1E014002,SCUOLA PRIMARIA,1,16,16,0,0,0
202223,VAPS785001,SCUOLA SECONDARIA II GRADO,1,27,23,4,1,3
202223,BGPMDF500L,SCUOLA SECONDARIA II GRADO,3,16,16,0,0,0
202223,VATD18500G,SCUOLA SECONDARIA II GRADO,1,6,4,2,0,2
202223,VT1E006009,SCUOLA PRIMARIA,4,20,19,1,1,0
202223,CO1E005003,SCUOLA PRIMARIA,1,29,26,3,3,0
202223,CT1E033001,SCUOLA PRIMARIA,2,12,12,0,0,0
202223,AV1E01200R,SCUOLA PRIMARIA,3,2,2,0,0,0
202223,RMTD49500B,SCUOLA SECONDARIA II GRADO,3,10,10,0,0,0
202223,RM1E19500Q,SCUOLA PRIMARIA,1,21,18,3,0,3
202223,PVRFL2500T,SCUOLA SECONDARIA II GRADO,3,8,8,0,0,0
202223,RE1M8H500D,SCUOLA SECONDARIA I GRADO,1,24,23,1,0,1
202223,GE1E02200V,SCUOLA PRIMARIA,1,24,22,2,0,2
202223,RM1E072006,SCUOLA PRIMARIA,3,21,21,0,0,0
202223,VA1E00700C,SCUOLA PRIMARIA,4,46,45,1,0,1
202223,RO1E0L5003,SCUOLA PRIMARIA,2,16,15,1,0,1
202223,LU1E003004,SCUOLA PRIMARIA,5,22,20,2,1,1
202223,PD1EOO500S,SCUOLA PRIMARIA,3,11,5,6,0,6
202223,BGPM15500V,SCUOLA SECONDARIA II GRADO,1,17,13,4,2,2
202223,CO1E01500N,SCUOLA PRIMARIA,5,6,6,0,0,0
202223,MO1E012007,SCUOLA PRIMARIA,3,17,16,1,0,1
202223,SA1M012007,SCUOLA SECONDARIA I GRADO,1,6,4,2,0,2
202223,NA1E06200L,SCUOLA PRIMARIA,4,51,51,0,0,0
202223,TO1E038006,SCUOLA PRIMARIA,5,15,15,0,0,0
202223,BO1M007003,SCUOLA SECONDARIA I GRADO,2,137,127,10,2,8
202223,RM1E08900G,SCUOLA PRIMARIA,3,16,12,4,1,3
202223,VI1E008002,SCUOLA PRIMARIA,2,5,5,0,0,0
202223,LTTN125009,SCUOLA SECONDARIA II GRADO,4,2,2,0,0,0
202223,CT1MHE500T,SCUOLA SECONDARIA I GRADO,1,13,13,0,0,0
202223,VARHL7500G,SCUOLA SECONDARIA II GRADO,5,6,6,0,0,0
202223,RMPSV5500M,SCUOLA SECONDARIA II GRADO,3,4,3,1,1,0
202223,FIPS02500P,SCUOLA SECONDARIA II GRADO,4,6,6,0,0,0
202223,MIPL15500R,SCUOLA SECONDARIA II GRADO,4,34,31,3,0,3
202223,MBPSTE500O,SCUOLA SECONDARIA II GRADO,4,26,26,0,0,0
202223,MCPL0P500L,SCUOLA SECONDARIA II GRADO,1,1,1,0,0,0
202223,PD1E00100T,SCUOLA PRIMARIA,4,18,17,1,0,1
202223,CE1E066002,SCUOLA PRIMARIA,5,13,13,0,0,0
202223,MITF105003,SCUOLA SECONDARIA II GRADO,2,28,25,3,0,3
202223,MI1E05600Q,SCUOLA PRIMARIA,2,25,25,0,0,0
202223,MO1M006005,SCUOLA SECONDARIA I GRADO,1,102,99,3,0,3
202223,NA1E16000T,SCUOLA PRIMARIA,2,10,10,0,0,0
202223,NARF265006,SCUOLA SECONDARIA II GRADO,4,1,1,0,0,0
202223,MB1E04100V,SCUOLA PRIMARIA,2,56,54,2,1,1
202223,NAPM39500R,SCUOLA SECONDARIA II GRADO,5,68,65,3,1,2
202223,MEPS045007,SCUOLA SECONDARIA II GRADO,5,14,14,0,0,0
202223,SATDGN500Z,SCUOLA SECONDARIA II GRADO,2,4,4,0,0,0
202223,PA1E03800L,SCUOLA PRIMARIA,2,19,19,0,0,0
202223,BSPLMR500P,SCUOLA SECONDARIA II GRADO,2,30,26,4,1,3
202223,PA1E048007,SCUOLA PRIMARIA,3,35,35,0,0,0
202223,BSPM4P500U,SCUOLA SECONDARIA II GRADO,5,14,14,0,0,0
202223,NATDI75001,SCUOLA SECONDARIA II GRADO,1,8,3,5,0,5
202223,RM1E11500V,SCUOLA PRIMARIA,5,58,57,1,0,1
202223,MBPM005002,SCUOLA SECONDARIA II GRADO,3,29,29,0,0,0
202223,MITF11500N,SCUOLA SECONDARIA II GRADO,1,149,142,7,0,7
202223,BA1E00300G,SCUOLA PRIMARIA,4,37,37,0,0,0
202223,NA1E17900V,SCUOLA PRIMARIA,5,9,8,1,0,1
202223,NATD475007,SCUOLA SECONDARIA II GRADO,2,14,14,0,0,0
202223,MI1M07800T,SCUOLA SECONDARIA I GRADO,3,84,83,1,1,0
202223,MITB025006,SCUOLA SECONDARIA II GRADO,2,35,16,19,2,17
202223,MI1M10100N,SCUOLA SECONDARIA I GRADO,2,67,67,0,0,0
202223,RMPL325007,SCUOLA SECONDARIA II GRADO,2,7,7,0,0,0
202223,RCTDBT500S,SCUOLA SECONDARIA II GRADO,4,11,10,1,0,1
202223,RM1M04300B,SCUOLA SECONDARIA I GRADO,3,31,31,0,0,0
202223,RMSL3L500Q,SCUOLA SECONDARIA II GRADO,4,9,9,0,0,0
202223,MI1M05300D,SCUOLA SECONDARIA I GRADO,2,18,16,2,1,1
202223,MI1M05800L,SCUOLA SECONDARIA I GRADO,2,33,30,3,0,3
202223,MI1E123009,SCUOLA PRIMARIA,3,36,33,3,1,2
202223,NA1MTL500Q,SCUOLA SECONDARIA I GRADO,3,15,13,2,0,2
202223,ALRH01500G,SCUOLA SECONDARIA II GRADO,1,24,20,4,2,2
202223,TV1E018009,SCUOLA PRIMARIA,2,15,14,1,1,0
202223,PATD205004,SCUOLA SECONDARIA II GRADO,2,1,1,0,0,0
202223,NA1E04800A,SCUOLA PRIMARIA,2,33,33,0,0,0
202223,RM1E057004,SCUOLA PRIMARIA,3,25,25,0,0,0
202223,VR1E01500D,SCUOLA PRIMARIA,3,22,21,1,0,1
202223,CO1M01500V,SCUOLA SECONDARIA I GRADO,3,42,40,2,1,1
202223,CO1E00800E,SCUOLA PRIMARIA,3,31,25,6,1,5
202223,BN1E002002,SCUOLA PRIMARIA,5,7,7,0,0,0
202223,VAPSE5500O,SCUOLA SECONDARIA II GRADO,4,16,14,2,0,2
202223,CRPSVN500C,SCUOLA SECONDARIA II GRADO,5,27,27,0,0,0
202223,AGTD4Q5003,SCUOLA SECONDARIA II GRADO,4,7,6,1,0,1
202223,SIPS01500C,SCUOLA SECONDARIA II GRADO,5,16,15,1,0,1
202223,MB1E128009,SCUOLA PRIMARIA,4,40,40,0,0,0
202223,PT1E00200E,SCUOLA PRIMARIA,3,16,15,1,0,1
202223,PG1E00300P,SCUOLA PRIMARIA,2,18,17,1,0,1
202223,NARF265006,SCUOLA SECONDARIA II GRADO,5,25,24,1,0,1
202223,RM1EZR5005,SCUOLA PRIMARIA,4,15,14,1,1,0
202223,NA1E02000E,SCUOLA PRIMARIA,3,24,23,1,0,1
202223,LC1E00500R,SCUOLA PRIMARIA,1,42,40,2,0,2
202223,PAPC14500P,SCUOLA SECONDARIA II GRADO,5,6,6,0,0,0
202223,RC1E00700X,SCUOLA PRIMARIA,1,16,15,1,0,1
202223,NA1E113008,SCUOLA PRIMARIA,3,12,12,0,0,0
202223,MI1E033003,SCUOLA PRIMARIA,4,16,16,0,0,0
202223,NAPS68500Q,SCUOLA SECONDARIA II GRADO,3,29,26,3,0,3
202223,CERH015004,SCUOLA SECONDARIA II GRADO,5,10,10,0,0,0
202223,MI1E061007,SCUOLA PRIMARIA,3,30,27,3,0,3
202223,TP1E003005,SCUOLA PRIMARIA,5,5,4,1,0,1
202223,CAPC005006,SCUOLA SECONDARIA II GRADO,4,10,10,0,0,0
202223,AGTD02500N,SCUOLA SECONDARIA II GRADO,3,2,1,1,1,0
202223,SR1E009008,SCUOLA PRIMARIA,4,12,12,0,0,0
202223,CE1E05600B,SCUOLA PRIMARIA,5,12,12,0,0,0
202223,CTTD315003,SCUOLA SECONDARIA II GRADO,5,21,21,0,0,0
202223,SRTL49500I,SCUOLA SECONDARIA II GRADO,3,1,1,0,0,0
202223,NA1E01700P,SCUOLA PRIMARIA,2,30,30,0,0,0
202223,TVPS02500N,SCUOLA SECONDARIA II GRADO,3,24,23,1,0,1
202223,RA1M005008,SCUOLA SECONDARIA I GRADO,1,24,24,0,0,0
202223,TOPM09500L,SCUOLA SECONDARIA II GRADO,1,12,12,0,0,0
202223,BO1E00200P,SCUOLA PRIMARIA,3,53,51,2,0,2
202223,BL1M00100R,SCUOLA SECONDARIA I GRADO,2,33,32,1,0,1
202223,MI1E11800T,SCUOLA PRIMARIA,3,32,29,3,0,3
202223,VRPM01500Q,SCUOLA SECONDARIA II GRADO,5,45,44,1,1,0
202223,NA1E122003,SCUOLA PRIMARIA,5,26,24,2,0,2
202223,RM1M07600P,SCUOLA SECONDARIA I GRADO,2,44,43,1,0,1
202223,CE1ECZ5004,SCUOLA PRIMARIA,4,11,11,0,0,0
202223,RMPC1A5001,SCUOLA SECONDARIA II GRADO,2,15,15,0,0,0
202223,MIPSR85009,SCUOLA SECONDARIA II GRADO,3,21,21,0,0,0
202223,RN1E00900L,SCUOLA PRIMARIA,2,26,22,4,0,4
202223,LCPL025002,SCUOLA SECONDARIA II GRADO,4,13,13,0,0,0
202223,MI1M03200C,SCUOLA SECONDARIA I GRADO,2,38,36,2,0,2
202223,RMPC455002,SCUOLA SECONDARIA II GRADO,5,18,18,0,0,0
202223,CTTD92500V,SCUOLA SECONDARIA II GRADO,4,5,5,0,0,0
202223,RMPC355005,SCUOLA SECONDARIA II GRADO,1,21,21,0,0,0
202223,PR1M00900X,SCUOLA SECONDARIA I GRADO,2,66,65,1,1,0
202223,MI1E088007,SCUOLA PRIMARIA,4,33,31,2,0,2
202223,MI1E123009,SCUOLA PRIMARIA,2,41,39,2,0,2
202223,PA1E02300V,SCUOLA PRIMARIA,1,14,14,0,0,0
202223,NA1E20800N,SCUOLA PRIMARIA,3,15,15,0,0,0
202223,RMSL5N500U,SCUOLA SECONDARIA II GRADO,2,5,5,0,0,0
202223,NATL0L500Q,SCUOLA SECONDARIA II GRADO,1,8,8,0,0,0
202223,CSPM025005,SCUOLA SECONDARIA II GRADO,2,6,6,0,0,0
202223,TO1M012007,SCUOLA SECONDARIA I GRADO,3,52,50,2,0,2
202223,CTTD01500C,SCUOLA SECONDARIA II GRADO,5,35,35,0,0,0
202223,GE1E03100N,SCUOLA PRIMARIA,3,26,23,3,3,0
202223,RMPM55500G,SCUOLA SECONDARIA II GRADO,4,16,16,0,0,0
202223,NA1E27300R,SCUOLA PRIMARIA,4,19,18,1,0,1
202223,FIPMP9500U,SCUOLA SECONDARIA II GRADO,4,10,10,0,0,0
202223,FITB015001,SCUOLA SECONDARIA II GRADO,1,24,22,2,1,1
202223,MI1E090007,SCUOLA PRIMARIA,5,8,8,0,0,0
202223,AQ1M00200G,SCUOLA SECONDARIA I GRADO,1,8,8,0,0,0
202223,PA1E014004,SCUOLA PRIMARIA,1,61,57,4,1,3
202223,MIPS415006,SCUOLA SECONDARIA II GRADO,5,23,21,2,0,2
202223,MBPC215006,SCUOLA SECONDARIA II GRADO,3,17,17,0,0,0
202223,RMPSAD500D,SCUOLA SECONDARIA II GRADO,5,68,65,3,1,2
202223,LT1E00300L,SCUOLA PRIMARIA,3,18,17,1,0,1
202223,RM1E03300G,SCUOLA PRIMARIA,5,39,32,7,1,6
202223,MI1E00100G,SCUOLA PRIMARIA,3,40,32,8,0,8
202223,TVPL07500D,SCUOLA SECONDARIA II GRADO,4,6,6,0,0,0
202223,COPSZG500O,SCUOLA SECONDARIA II GRADO,2,13,11,2,0,2
202223,CAPS02500E,SCUOLA SECONDARIA II GRADO,5,17,17,0,0,0
202223,NA1E25800P,SCUOLA PRIMARIA,5,17,16,1,1,0
202223,NATDZR500T,SCUOLA SECONDARIA II GRADO,3,11,11,0,0,0
202223,RM1E127005,SCUOLA PRIMARIA,4,40,37,3,0,3
202223,FE1MFE500C,SCUOLA SECONDARIA I GRADO,1,33,33,0,0,0
202223,MITL035006,SCUOLA SECONDARIA II GRADO,1,4,3,1,0,1
202223,NA1E00500C,SCUOLA PRIMARIA,5,10,10,0,0,0
202223,CRPL01500R,SCUOLA SECONDARIA II GRADO,1,10,10,0,0,0
202223,AP1E00400B,SCUOLA PRIMARIA,2,17,17,0,0,0
202223,CA1E00600X,SCUOLA PRIMARIA,5,28,22,6,2,4
202223,MOPC005006,SCUOLA SECONDARIA II GRADO,5,18,18,0,0,0
202223,SAPS8F500U,SCUOLA SECONDARIA II GRADO,3,7,6,1,0,1
202223,NA1E01200G,SCUOLA PRIMARIA,1,13,13,0,0,0
202223,VIPL015005,SCUOLA SECONDARIA II GRADO,4,11,11,0,0,0
202223,CETFS0500N,SCUOLA SECONDARIA II GRADO,1,5,5,0,0,0
202223,TOPS19500C,SCUOLA SECONDARIA II GRADO,1,17,16,1,0,1
202223,RM1E150006,SCUOLA PRIMARIA,2,10,9,1,0,1
202223,RM1E14700A,SCUOLA PRIMARIA,1,21,20,1,0,1
202223,NATDPA500D,SCUOLA SECONDARIA II GRADO,3,4,4,0,0,0
202223,MIPL125001,SCUOLA SECONDARIA II GRADO,2,186,173,13,3,10
202223,TO1M056001,SCUOLA SECONDARIA I GRADO,2,81,81,0,0,0
202223,MIPS54500V,SCUOLA SECONDARIA II GRADO,2,23,23,0,0,0
202223,GEPS6L5006,SCUOLA SECONDARIA II GRADO,1,22,22,0,0,0
202223,RMPS24500R,SCUOLA SECONDARIA II GRADO,4,51,47,4,0,4
202223,ANTD02500V,SCUOLA SECONDARIA II GRADO,3,10,9,1,0,1
202223,MI1E140003,SCUOLA PRIMARIA,5,47,47,0,0,0
202223,NAPLQ2500N,SCUOLA SECONDARIA II GRADO,2,15,14,1,0,1
202223,VE1E00800P,SCUOLA PRIMARIA,1,29,28,1,0,1
202223,TS1E00500D,SCUOLA PRIMARIA,5,21,20,1,0,1
202223,VA1MAR500M,SCUOLA SECONDARIA I GRADO,3,43,41,2,0,2
202223,RM1E006007,SCUOLA PRIMARIA,2,24,21,3,2,1
202223,VAPS92500G,SCUOLA SECONDARIA II GRADO,5,18,18,0,0,0
202223,BS1EAP500V,SCUOLA PRIMARIA,2,20,17,3,1,2
202223,NA1M007009,SCUOLA SECONDARIA I GRADO,2,25,24,1,0,1
202223,NA1MLP500B,SCUOLA SECONDARIA I GRADO,2,16,16,0,0,0
202223,BSPSO5500G,SCUOLA SECONDARIA II GRADO,1,22,20,2,0,2
202223,FI1E01100G,SCUOLA PRIMARIA,3,28,21,7,0,7
202223,RM1E15300N,SCUOLA PRIMARIA,3,26,25,1,1,0
202223,NATFDD500F,SCUOLA SECONDARIA II GRADO,1,5,5,0,0,0
202223,SATFHG5004,SCUOLA SECONDARIA II GRADO,4,7,7,0,0,0
202223,CE1E02100C,SCUOLA PRIMARIA,1,10,10,0,0,0
202223,VRTN01500C,SCUOLA SECONDARIA II GRADO,4,18,18,0,0,0
202223,PA1E00300N,SCUOLA PRIMARIA,3,12,12,0,0,0
202223,CT1E008008,SCUOLA PRIMARIA,1,24,24,0,0,0
202223,NA1E22800V,SCUOLA PRIMARIA,2,18,18,0,0,0
202223,MBPS345002,SCUOLA SECONDARIA II GRADO,1,30,30,0,0,0
202223,AP1E00200Q,SCUOLA PRIMARIA,2,15,14,1,0,1
202223,VEPL04500N,SCUOLA SECONDARIA II GRADO,1,16,15,1,0,1
202223,TATD06500L,SCUOLA SECONDARIA II GRADO,4,4,4,0,0,0
202223,SARHB65008,SCUOLA SECONDARIA II GRADO,5,93,92,1,0,1
202223,RE1E007005,SCUOLA PRIMARIA,3,19,19,0,0,0
202223,LCPC00500V,SCUOLA SECONDARIA II GRADO,4,8,8,0,0,0
202223,NA1E07600E,SCUOLA PRIMARIA,3,20,20,0,0,0
202223,NA1E081002,SCUOLA PRIMARIA,2,11,10,1,1,0
202223,FR1M003006,SCUOLA SECONDARIA I GRADO,1,14,14,0,0,0
202223,PAPS00500E,SCUOLA SECONDARIA II GRADO,2,6,6,0,0,0
202223,VTTD015005,SCUOLA SECONDARIA II GRADO,1,4,4,0,0,0
202223,FO1E001006,SCUOLA PRIMARIA,2,14,11,3,0,3
202223,RM1E204009,SCUOLA PRIMARIA,2,8,8,0,0,0
202223,FGTD095004,SCUOLA SECONDARIA II GRADO,5,43,42,1,0,1
202223,SATFPG500G,SCUOLA SECONDARIA II GRADO,3,8,7,1,0,1
202223,SATFIP5005,SCUOLA SECONDARIA II GRADO,2,5,5,0,0,0
202223,RMPLA95002,SCUOLA SECONDARIA II GRADO,3,23,18,5,2,3
202223,APPSZ65005,SCUOLA SECONDARIA II GRADO,5,19,17,2,0,2
202223,NOTB12500G,SCUOLA SECONDARIA II GRADO,2,7,6,1,0,1
202223,AV1E008005,SCUOLA PRIMARIA,1,10,10,0,0,0
202223,RMTD77500R,SCUOLA SECONDARIA II GRADO,2,3,3,0,0,0
202223,PGPS00500G,SCUOLA SECONDARIA II GRADO,3,14,13,1,1,0
202223,MI1E018001,SCUOLA PRIMARIA,4,16,16,0,0,0
202223,TO1E032007,SCUOLA PRIMARIA,5,16,16,0,0,0
202223,BOPL57500R,SCUOLA SECONDARIA II GRADO,2,26,20,6,1,5
202223,MIPS06500Q,SCUOLA SECONDARIA II GRADO,5,26,25,1,0,1
202223,SATD25500P,SCUOLA SECONDARIA II GRADO,1,8,8,0,0,0
202223,AVTDAS5006,SCUOLA SECONDARIA II GRADO,5,53,51,2,1,1
202223,TOPM035001,SCUOLA SECONDARIA II GRADO,3,56,55,1,1,0
202223,CZPC00500G,SCUOLA SECONDARIA II GRADO,3,11,11,0,0,0
202223,NATF25500E,SCUOLA SECONDARIA II GRADO,5,15,15,0,0,0
202223,NA1E11800B,SCUOLA PRIMARIA,5,26,25,1,0,1
202223,PD1E00900C,SCUOLA PRIMARIA,4,24,24,0,0,0
202223,FGRHSR500L,SCUOLA SECONDARIA II GRADO,3,10,9,1,0,1
202223,RM1M02600N,SCUOLA SECONDARIA I GRADO,1,41,40,1,0,1
202223,COTN025007,SCUOLA SECONDARIA II GRADO,1,3,3,0,0,0
202223,MO1E00600X,SCUOLA PRIMARIA,5,22,22,0,0,0
202223,BATD105005,SCUOLA SECONDARIA II GRADO,4,12,12,0,0,0
202223,RM1E094003,SCUOLA PRIMARIA,4,72,72,0,0,0
202223,NAPMRP500S,SCUOLA SECONDARIA II GRADO,1,3,3,0,0,0
202223,SATD4D500E,SCUOLA SECONDARIA II GRADO,4,7,7,0,0,0
202223,SATD295005,SCUOLA SECONDARIA II GRADO,3,9,8,1,0,1
202223,PA1M01100T,SCUOLA SECONDARIA I GRADO,2,22,22,0,0,0
202223,MIPC09500C,SCUOLA SECONDARIA II GRADO,1,36,36,0,0,0
202223,TOPQ04500Q,SCUOLA SECONDARIA II GRADO,2,29,29,0,0,0
202223,BO1E005006,SCUOLA PRIMARIA,3,26,26,0,0,0
202223,NAPSAT500N,SCUOLA SECONDARIA II GRADO,1,4,4,0,0,0
202223,SATF4V500G,SCUOLA SECONDARIA II GRADO,3,2,0,2,0,2
202223,NATD255008,SCUOLA SECONDARIA II GRADO,3,21,21,0,0,0
202223,PVRFL2500T,SCUOLA SECONDARIA II GRADO,4,8,8,0,0,0
202223,RA1E00600V,SCUOLA PRIMARIA,2,30,29,1,1,0
202223,MI1M00800G,SCUOLA SECONDARIA I GRADO,1,70,69,1,0,1
202223,CSRFQA500F,SCUOLA SECONDARIA II GRADO,3,7,6,1,1,0
202223,BO1E01500R,SCUOLA PRIMARIA,4,45,44,1,0,1
202223,TV1E006003,SCUOLA PRIMARIA,1,11,10,1,0,1
202223,CE1E05900V,SCUOLA PRIMARIA,4,20,19,1,0,1
202223,CTTF005004,SCUOLA SECONDARIA II GRADO,1,2,2,0,0,0
202223,CE1E02700B,SCUOLA PRIMARIA,3,17,17,0,0,0
202223,MITDGN5002,SCUOLA SECONDARIA II GRADO,2,22,19,3,1,2
202223,VA1M009009,SCUOLA SECONDARIA I GRADO,2,11,11,0,0,0
202223,VAPL08500N,SCUOLA SECONDARIA II GRADO,5,20,18,2,1,1
202223,VATFQS5007,SCUOLA SECONDARIA II GRADO,2,22,21,1,0,1
202223,FI1E01700E,SCUOLA PRIMARIA,4,39,39,0,0,0
202223,BNTDOO5001,SCUOLA SECONDARIA II GRADO,2,4,4,0,0,0
202223,BGTD085006,SCUOLA SECONDARIA II GRADO,2,36,35,1,1,0
202223,NA1E150007,SCUOLA PRIMARIA,4,14,14,0,0,0
202223,PC1E001007,SCUOLA PRIMARIA,4,19,19,0,0,0
202223,BG1E021006,SCUOLA PRIMARIA,4,16,16,0,0,0
202223,BG1E030001,SCUOLA PRIMARIA,4,52,52,0,0,0
202223,RM1M07100G,SCUOLA SECONDARIA I GRADO,2,89,86,3,0,3
202223,CH1E005007,SCUOLA PRIMARIA,3,11,10,1,1,0
202223,PVPS345009,SCUOLA SECONDARIA II GRADO,1,3,2,1,0,1
202223,SATA2M500B,SCUOLA SECONDARIA II GRADO,4,1,1,0,0,0
202223,LI1E00200T,SCUOLA PRIMARIA,4,28,28,0,0,0
202223,MI1EA8500G,SCUOLA PRIMARIA,2,57,54,3,1,2
202223,NA1E06200L,SCUOLA PRIMARIA,5,40,40,0,0,0
202223,REPM01500A,SCUOLA SECONDARIA II GRADO,5,13,13,0,0,0
202223,GE1E00900C,SCUOLA PRIMARIA,1,23,23,0,0,0
202223,LE1E00200E,SCUOLA PRIMARIA,5,50,49,1,1,0
202223,PAPSVD500Q,SCUOLA SECONDARIA II GRADO,5,8,8,0,0,0
202223,RNPL01500X,SCUOLA SECONDARIA II GRADO,5,19,19,0,0,0
202223,TO1M02200T,SCUOLA SECONDARIA I GRADO,1,31,31,0,0,0
202223,BGPC05500B,SCUOLA SECONDARIA II GRADO,4,16,16,0,0,0
202223,PDPC01500T,SCUOLA SECONDARIA II GRADO,4,16,16,0,0,0
202223,SATL09500T,SCUOLA SECONDARIA II GRADO,3,7,7,0,0,0
202223,RMPM195002,SCUOLA SECONDARIA II GRADO,2,20,17,3,0,3
202223,RMPL39500D,SCUOLA SECONDARIA II GRADO,3,11,10,1,0,1
202223,NA1E093008,SCUOLA PRIMARIA,4,16,16,0,0,0
202223,MI1M092004,SCUOLA SECONDARIA I GRADO,2,49,44,5,0,5
202223,CA1M01000R,SCUOLA SECONDARIA I GRADO,1,54,53,1,0,1
202223,SATD075006,SCUOLA SECONDARIA II GRADO,5,95,92,3,0,3
202223,TO1E03400V,SCUOLA PRIMARIA,3,52,50,2,1,1
202223,LTTA335002,SCUOLA SECONDARIA II GRADO,4,3,3,0,0,0
202223,RNRCCE500C,SCUOLA SECONDARIA II GRADO,1,22,13,9,2,7
202223,BG1M014008,SCUOLA SECONDARIA I GRADO,1,113,107,6,4,2
202223,CT1ET9500Z,SCUOLA PRIMARIA,4,15,12,3,1,2
202223,BGPMIZ500F,SCUOLA SECONDARIA II GRADO,4,9,9,0,0,0
202223,RM1E11500V,SCUOLA PRIMARIA,4,75,75,0,0,0
202223,MI1E046005,SCUOLA PRIMARIA,1,78,75,3,1,2
202223,RM1M11900B,SCUOLA SECONDARIA I GRADO,3,66,64,2,0,2
202223,BA1E00300G,SCUOLA PRIMARIA,5,45,45,0,0,0
202223,CA1E01700A,SCUOLA PRIMARIA,3,13,13,0,0,0
202223,MI1EMR500E,SCUOLA PRIMARIA,2,64,58,6,1,5
202223,RM1E04100E,SCUOLA PRIMARIA,4,18,16,2,0,2
202223,RMTL08500Q,SCUOLA SECONDARIA II GRADO,3,1,1,0,0,0
202223,MB1E06900P,SCUOLA PRIMARIA,1,47,46,1,0,1
202223,CE1E04700L,SCUOLA PRIMARIA,4,11,11,0,0,0
202223,PETD03500L,SCUOLA SECONDARIA II GRADO,3,15,13,2,2,0
202223,BGSLAE500Q,SCUOLA SECONDARIA II GRADO,2,7,7,0,0,0
202223,MEPCPD5001,SCUOLA SECONDARIA II GRADO,1,1,1,0,0,0
202223,TARF2M500U,SCUOLA SECONDARIA II GRADO,2,5,5,0,0,0
202223,METAR6500G,SCUOLA SECONDARIA II GRADO,3,1,1,0,0,0
202223,BS1M02300G,SCUOLA SECONDARIA I GRADO,3,69,66,3,0,3
202223,NA1E23600T,SCUOLA PRIMARIA,4,15,15,0,0,0
202223,BNTDC1500F,SCUOLA SECONDARIA II GRADO,3,1,1,0,0,0
202223,RM1E11700E,SCUOLA PRIMARIA,5,11,11,0,0,0
202223,NAPS25500C,SCUOLA SECONDARIA II GRADO,5,18,17,1,0,1
202223,CT1E054002,SCUOLA PRIMARIA,4,21,19,2,0,2
202223,RM1M143008,SCUOLA SECONDARIA I GRADO,1,19,17,2,0,2
202223,CLTD095008,SCUOLA SECONDARIA II GRADO,1,10,9,1,1,0
202223,NA1E18300E,SCUOLA PRIMARIA,2,44,44,0,0,0
202223,MB1E03400Q,SCUOLA PRIMARIA,5,43,42,1,1,0
202223,MB1E05500R,SCUOLA PRIMARIA,5,65,64,1,0,1
202223,BGPSRR5006,SCUOLA SECONDARIA II GRADO,1,39,37,2,0,2
202223,PR1E00800V,SCUOLA PRIMARIA,4,12,12,0,0,0
202223,GEPMN4500Z,SCUOLA SECONDARIA II GRADO,4,24,24,0,0,0
202223,UDPLO3500Z,SCUOLA SECONDARIA II GRADO,2,15,13,2,1,1
202223,MI1E08600G,SCUOLA PRIMARIA,5,51,49,2,1,1
202223,NA1E14500Q,SCUOLA PRIMARIA,1,22,21,1,0,1
202223,CT1E00600L,SCUOLA PRIMARIA,2,15,14,1,0,1
202223,MIPSDF5000,SCUOLA SECONDARIA II GRADO,1,57,57,0,0,0
202223,RMRHZT500U,SCUOLA SECONDARIA II GRADO,2,3,3,0,0,0
202223,RM1E186001,SCUOLA PRIMARIA,4,15,15,0,0,0
202223,NATD33500X,SCUOLA SECONDARIA II GRADO,4,10,10,0,0,0
202223,PI1E00200G,SCUOLA PRIMARIA,3,15,14,1,0,1
202223,PO1E001001,SCUOLA PRIMARIA,1,24,24,0,0,0
202223,SARHGL500M,SCUOLA SECONDARIA II GRADO,3,217,215,2,0,2
202223,MI1E01400N,SCUOLA PRIMARIA,1,36,34,2,0,2
202223,RE1M00400V,SCUOLA SECONDARIA I GRADO,1,52,50,2,0,2
202223,FI1M02600E,SCUOLA SECONDARIA I GRADO,3,12,11,1,0,1
202223,MCPSL3500U,SCUOLA SECONDARIA II GRADO,2,1,1,0,0,0
202223,VA1E009004,SCUOLA PRIMARIA,3,59,59,0,0,0
202223,NA1E03900G,SCUOLA PRIMARIA,5,37,35,2,0,2
202223,CO1M021006,SCUOLA SECONDARIA I GRADO,2,26,26,0,0,0
202223,CE1E001007,SCUOLA PRIMARIA,4,11,10,1,0,1
202223,UD1E010003,SCUOLA PRIMARIA,1,15,14,1,1,0
202223,BNRHN2500D,SCUOLA SECONDARIA II GRADO,1,8,8,0,0,0
202223,NATDB75009,SCUOLA SECONDARIA II GRADO,4,11,9,2,2,0
202223,RMTD67500X,SCUOLA SECONDARIA II GRADO,4,9,9,0,0,0
202223,MB1EP85003,SCUOLA PRIMARIA,4,18,18,0,0,0
202223,BRTD04500A,SCUOLA SECONDARIA II GRADO,4,4,4,0,0,0
202223,MBPM145009,SCUOLA SECONDARIA II GRADO,4,16,16,0,0,0
202223,PGTDEI500F,SCUOLA SECONDARIA II GRADO,2,2,2,0,0,0
202223,AGTD02500N,SCUOLA SECONDARIA II GRADO,4,3,3,0,0,0
202223,AN1M00200A,SCUOLA SECONDARIA I GRADO,3,12,12,0,0,0
202223,RM1EVQ500H,SCUOLA PRIMARIA,1,20,19,1,1,0
202223,CERIOH500S,SCUOLA SECONDARIA II GRADO,1,7,7,0,0,0
202223,RM1E206001,SCUOLA PRIMARIA,3,19,19,0,0,0
202223,LC1E00700C,SCUOLA PRIMARIA,4,23,22,1,1,0
202223,NA1E01700P,SCUOLA PRIMARIA,3,48,46,2,1,1
202223,VR1M025009,SCUOLA SECONDARIA I GRADO,1,25,25,0,0,0
202223,RMPM9P500H,SCUOLA SECONDARIA II GRADO,4,3,3,0,0,0
202223,FIPS15500B,SCUOLA SECONDARIA II GRADO,1,16,11,5,0,5
202223,NATDE6500C,SCUOLA SECONDARIA II GRADO,5,66,62,4,2,2
202223,BNPC02500R,SCUOLA SECONDARIA II GRADO,3,14,14,0,0,0
202223,MI1E070002,SCUOLA PRIMARIA,2,12,12,0,0,0
202223,TS1E001006,SCUOLA PRIMARIA,2,16,15,1,0,1
202223,APPCU15007,SCUOLA SECONDARIA II GRADO,4,11,11,0,0,0
202223,RM1E02600C,SCUOLA PRIMARIA,2,59,59,0,0,0
202223,CA1EUL5004,SCUOLA PRIMARIA,5,9,9,0,0,0
202223,AGPSCE5001,SCUOLA SECONDARIA II GRADO,5,11,11,0,0,0
202223,FI1E034008,SCUOLA PRIMARIA,1,24,24,0,0,0
202223,BOPS525001,SCUOLA SECONDARIA II GRADO,1,39,39,0,0,0
202223,VA1E01900P,SCUOLA PRIMARIA,4,72,72,0,0,0
202223,VI1E00600A,SCUOLA PRIMARIA,5,29,29,0,0,0
202223,SSTD015004,SCUOLA SECONDARIA II GRADO,4,2,2,0,0,0
202223,METFU8500R,SCUOLA SECONDARIA II GRADO,3,1,1,0,0,0
202223,BS1M004006,SCUOLA SECONDARIA I GRADO,2,142,141,1,1,0
202223,VR1M020006,SCUOLA SECONDARIA I GRADO,2,25,24,1,0,1
202223,NA1E242005,SCUOLA PRIMARIA,1,11,11,0,0,0
202223,NA1E25900E,SCUOLA PRIMARIA,3,12,12,0,0,0
202223,BI1E00200D,SCUOLA PRIMARIA,4,26,26,0,0,0
202223,FE1E004005,SCUOLA PRIMARIA,5,24,22,2,0,2
202223,NATDAT500E,SCUOLA SECONDARIA II GRADO,1,2,2,0,0,0
202223,GO1EUT5002,SCUOLA PRIMARIA,4,4,4,0,0,0
202223,MIPSPS500G,SCUOLA SECONDARIA II GRADO,2,18,17,1,0,1
202223,MOPSMO5004,SCUOLA SECONDARIA II GRADO,2,9,9,0,0,0
202223,RMPS08500D,SCUOLA SECONDARIA II GRADO,2,44,44,0,0,0
202223,CHPMVZ5007,SCUOLA SECONDARIA II GRADO,3,6,6,0,0,0
202223,RA1E00200G,SCUOLA PRIMARIA,5,22,20,2,1,1
202223,MI1M00300C,SCUOLA SECONDARIA I GRADO,1,52,52,0,0,0
202223,TV1E00300G,SCUOLA PRIMARIA,3,42,41,1,0,1
202223,FRPS1T500V,SCUOLA SECONDARIA II GRADO,4,19,19,0,0,0
202223,VIPM01500B,SCUOLA SECONDARIA II GRADO,2,17,16,1,0,1
202223,RI1E00100D,SCUOLA PRIMARIA,1,19,19,0,0,0
202223,VA1M01400R,SCUOLA SECONDARIA I GRADO,2,50,49,1,0,1
202223,NA1EAN500C,SCUOLA PRIMARIA,2,24,24,0,0,0
202223,NATFRU500B,SCUOLA SECONDARIA II GRADO,4,2,2,0,0,0
202223,PATD91500R,SCUOLA SECONDARIA II GRADO,4,12,12,0,0,0
202223,MI1E09300P,SCUOLA PRIMARIA,1,11,10,1,1,0
202223,PATL00500R,SCUOLA SECONDARIA II GRADO,2,1,1,0,0,0
202223,MIPS445002,SCUOLA SECONDARIA II GRADO,4,27,27,0,0,0
202223,RMTA1T500M,SCUOLA SECONDARIA II GRADO,3,10,10,0,0,0
202223,MI1E00100G,SCUOLA PRIMARIA,4,46,38,8,0,8
202223,FR1E002005,SCUOLA PRIMARIA,5,15,14,1,1,0
202223,VT1M00400V,SCUOLA SECONDARIA I GRADO,3,39,39,0,0,0
202223,TS1E008001,SCUOLA PRIMARIA,1,20,20,0,0,0
202223,CERHOT500S,SCUOLA SECONDARIA II GRADO,1,15,15,0,0,0
202223,TO1M02900L,SCUOLA SECONDARIA I GRADO,1,13,11,2,0,2
202223,RM1E00300Q,SCUOLA PRIMARIA,5,82,81,1,1,0
202223,NA1EPH500O,SCUOLA PRIMARIA,4,18,18,0,0,0
202223,CETF1M500C,SCUOLA SECONDARIA II GRADO,2,9,9,0,0,0
202223,NARHRH500P,SCUOLA SECONDARIA II GRADO,1,10,10,0,0,0
202223,BSPS075008,SCUOLA SECONDARIA II GRADO,4,41,41,0,0,0
202223,FG1E023005,SCUOLA PRIMARIA,4,19,19,0,0,0
202223,MIPS295009,SCUOLA SECONDARIA II GRADO,1,50,47,3,0,3
202223,RMTD545007,SCUOLA SECONDARIA II GRADO,4,15,14,1,0,1
202223,VEPS04500V,SCUOLA SECONDARIA II GRADO,4,8,8,0,0,0
202223,SRPS52500Q,SCUOLA SECONDARIA II GRADO,1,5,5,0,0,0
202223,RMPS355008,SCUOLA SECONDARIA II GRADO,5,21,21,0,0,0
202223,RE1E00300T,SCUOLA PRIMARIA,4,41,41,0,0,0
202223,GE1E018007,SCUOLA PRIMARIA,2,14,13,1,0,1
202223,MIPM1C500T,SCUOLA SECONDARIA II GRADO,2,26,23,3,1,2
202223,MIPM2A500Z,SCUOLA SECONDARIA II GRADO,4,23,21,2,0,2
202223,RGTD11500L,SCUOLA SECONDARIA II GRADO,3,5,5,0,0,0
202223,NA1E6E500B,SCUOLA PRIMARIA,1,14,14,0,0,0
202223,NARHM0500C,SCUOLA SECONDARIA II GRADO,5,50,49,1,0,1
202223,RC1M00500D,SCUOLA SECONDARIA I GRADO,1,6,5,1,0,1
202223,TOPL03500P,SCUOLA SECONDARIA II GRADO,2,26,26,0,0,0
202223,RMPSMF500G,SCUOLA SECONDARIA II GRADO,2,25,24,1,0,1
202223,NA1E10200T,SCUOLA PRIMARIA,3,21,21,0,0,0
202223,CRPS00500B,SCUOLA SECONDARIA II GRADO,1,17,17,0,0,0
202223,MTTD01500D,SCUOLA SECONDARIA II GRADO,4,7,7,0,0,0
202223,CA1E00800G,SCUOLA PRIMARIA,3,25,25,0,0,0
202223,MO1E013003,SCUOLA PRIMARIA,5,18,18,0,0,0
202223,VETFO1500N,SCUOLA SECONDARIA II GRADO,2,5,5,0,0,0
202223,RMPSII500C,SCUOLA SECONDARIA II GRADO,2,2,2,0,0,0
202223,TOPSQB5003,SCUOLA SECONDARIA II GRADO,5,6,6,0,0,0
202223,RMPS72500B,SCUOLA SECONDARIA II GRADO,1,4,4,0,0,0
202223,BO1M00900P,SCUOLA SECONDARIA I GRADO,1,72,70,2,1,1
202223,BO1MUE500U,SCUOLA SECONDARIA I GRADO,2,16,15,1,0,1
202223,TS1E00300T,SCUOLA PRIMARIA,1,19,19,0,0,0
202223,CTTL005008,SCUOLA SECONDARIA II GRADO,3,3,3,0,0,0
202223,NARH02500L,SCUOLA SECONDARIA II GRADO,2,13,13,0,0,0
202223,RM1ERB5004,SCUOLA PRIMARIA,3,5,5,0,0,0
202223,PA1E02900T,SCUOLA PRIMARIA,2,14,13,1,0,1
202223,PRTD02500N,SCUOLA SECONDARIA II GRADO,5,9,9,0,0,0
202223,AVPSPT500F,SCUOLA SECONDARIA II GRADO,5,23,23,0,0,0
202223,CORH005002,SCUOLA SECONDARIA II GRADO,4,26,26,0,0,0
202223,RM1E15300N,SCUOLA PRIMARIA,2,24,22,2,2,0
202223,TOPS09500G,SCUOLA SECONDARIA II GRADO,3,27,23,4,0,4
202223,RM1E106004,SCUOLA PRIMARIA,3,22,22,0,0,0
202223,RMPSVP500H,SCUOLA SECONDARIA II GRADO,4,14,13,1,0,1
202223,BN1ES9500O,SCUOLA PRIMARIA,5,12,10,2,0,2
202223,PD1E006001,SCUOLA PRIMARIA,3,20,17,3,0,3
202223,RMPS27500L,SCUOLA SECONDARIA II GRADO,3,20,20,0,0,0
202223,NA1E007004,SCUOLA PRIMARIA,1,15,15,0,0,0
202223,PVPM025004,SCUOLA SECONDARIA II GRADO,3,17,17,0,0,0
202223,NATD3V500N,SCUOLA SECONDARIA II GRADO,4,5,5,0,0,0
202223,MI1E14200P,SCUOLA PRIMARIA,3,54,53,1,0,1
202223,MI1E445002,SCUOLA PRIMARIA,3,49,47,2,0,2
202223,LCPC00500V,SCUOLA SECONDARIA II GRADO,5,10,10,0,0,0
202223,TV1M001005,SCUOLA SECONDARIA I GRADO,2,18,17,1,0,1
202223,LCTDVP5000,SCUOLA SECONDARIA II GRADO,3,18,18,0,0,0
202223,NAPL975007,SCUOLA SECONDARIA II GRADO,2,3,3,0,0,0
202223,PAPS00500E,SCUOLA SECONDARIA II GRADO,3,20,20,0,0,0
202223,CE1E022008,SCUOLA PRIMARIA,4,30,26,4,0,4
202223,SATD9L5009,SCUOLA SECONDARIA II GRADO,3,4,4,0,0,0
202223,TO1E6R5003,SCUOLA PRIMARIA,5,50,49,1,0,1
202223,FI1E006004,SCUOLA PRIMARIA,2,27,26,1,1,0
202223,BSRF06500X,SCUOLA SECONDARIA II GRADO,2,25,25,0,0,0
202223,NATF55500V,SCUOLA SECONDARIA II GRADO,5,70,69,1,0,1
202223,TOPS04500E,SCUOLA SECONDARIA II GRADO,2,56,56,0,0,0
202223,VT1E00500D,SCUOLA PRIMARIA,4,22,20,2,1,1
202223,AV1E00500N,SCUOLA PRIMARIA,4,9,9,0,0,0
202223,RM1E193004,SCUOLA PRIMARIA,1,36,33,3,2,1
202223,MI1M098003,SCUOLA SECONDARIA I GRADO,1,117,113,4,0,4
202223,BS1E017003,SCUOLA PRIMARIA,3,76,75,1,0,1
202223,MBPQ035002,SCUOLA SECONDARIA II GRADO,3,26,26,0,0,0
202223,PVPL045003,SCUOLA SECONDARIA II GRADO,2,2,2,0,0,0
202223,CHTD07500E,SCUOLA SECONDARIA II GRADO,4,1,1,0,0,0
202223,SARHRM500C,SCUOLA SECONDARIA II GRADO,5,59,56,3,0,3
202223,CS1E008005,SCUOLA PRIMARIA,5,19,19,0,0,0
202223,VTPS015009,SCUOLA SECONDARIA II GRADO,4,2,2,0,0,0
202223,FR1E00600C,SCUOLA PRIMARIA,5,21,21,0,0,0
202223,AN1E002005,SCUOLA PRIMARIA,3,15,13,2,1,1
202223,CTTD195006,SCUOLA SECONDARIA II GRADO,3,15,15,0,0,0
202223,FRTD5O500I,SCUOLA SECONDARIA II GRADO,1,7,6,1,0,1
202223,LTPSO3500F,SCUOLA SECONDARIA II GRADO,3,3,3,0,0,0
202223,MIPSRS500B,SCUOLA SECONDARIA II GRADO,4,16,15,1,0,1
202223,CETD43500Q,SCUOLA SECONDARIA II GRADO,3,8,8,0,0,0
202223,TO1M004008,SCUOLA SECONDARIA I GRADO,1,71,70,1,1,0
202223,SATFTV500U,SCUOLA SECONDARIA II GRADO,2,10,10,0,0,0
202223,AT1M00200R,SCUOLA SECONDARIA I GRADO,3,28,28,0,0,0
202223,RMPS41500P,SCUOLA SECONDARIA II GRADO,3,10,10,0,0,0
202223,TV1M00500C,SCUOLA SECONDARIA I GRADO,3,8,8,0,0,0
202223,SI1E002005,SCUOLA PRIMARIA,5,17,17,0,0,0
202223,NA1E030005,SCUOLA PRIMARIA,4,11,11,0,0,0
202223,CO1E01500N,SCUOLA PRIMARIA,2,11,11,0,0,0
202223,NA1E285003,SCUOLA PRIMARIA,5,16,16,0,0,0
202223,NA1E086005,SCUOLA PRIMARIA,1,22,22,0,0,0
202223,RM1M665000,SCUOLA SECONDARIA I GRADO,3,14,13,1,0,1
202223,BAPLS4500L,SCUOLA SECONDARIA II GRADO,5,14,14,0,0,0
202223,TO1E04200T,SCUOLA PRIMARIA,1,31,26,5,3,2
202223,RN1E00200T,SCUOLA PRIMARIA,5,24,21,3,0,3
202223,PDTF015003,SCUOLA SECONDARIA II GRADO,3,18,17,1,1,0
202223,FI1E02500D,SCUOLA PRIMARIA,1,14,11,3,0,3
202223,PSPC01500G,SCUOLA SECONDARIA II GRADO,4,11,11,0,0,0
202223,FI1E03100R,SCUOLA PRIMARIA,3,18,18,0,0,0
202223,NA1E01100Q,SCUOLA PRIMARIA,2,11,11,0,0,0
202223,SATDVQ500D,SCUOLA SECONDARIA II GRADO,5,70,67,3,1,2
202223,PA1M02400X,SCUOLA SECONDARIA I GRADO,1,35,34,1,0,1
202223,MIPC10500T,SCUOLA SECONDARIA II GRADO,4,19,18,1,0,1
202223,NA1E13900C,SCUOLA PRIMARIA,4,22,21,1,0,1
202223,VRPSEM5005,SCUOLA SECONDARIA II GRADO,4,6,5,1,0,1
202223,CT1E016007,SCUOLA PRIMARIA,1,69,66,3,2,1
202223,NATNB7500P,SCUOLA SECONDARIA II GRADO,5,38,35,3,0,3
202223,CE1E04200D,SCUOLA PRIMARIA,5,10,10,0,0,0
202223,CE1E05900V,SCUOLA PRIMARIA,5,18,18,0,0,0
202223,BGPSH85002,SCUOLA SECONDARIA II GRADO,4,18,17,1,0,1
202223,CE1E029003,SCUOLA PRIMARIA,4,9,9,0,0,0
202223,VA1M005002,SCUOLA SECONDARIA I GRADO,3,12,12,0,0,0
202223,TO1M02400D,SCUOLA SECONDARIA I GRADO,2,15,15,0,0,0
202223,VBPM03500D,SCUOLA SECONDARIA II GRADO,4,15,14,1,0,1
202223,TVPS05500D,SCUOLA SECONDARIA II GRADO,4,7,7,0,0,0
202223,RM1E10400C,SCUOLA PRIMARIA,4,13,13,0,0,0
202223,RM1E12400N,SCUOLA PRIMARIA,3,26,26,0,0,0
202223,NA1E14600G,SCUOLA PRIMARIA,3,33,33,0,0,0
202223,NA1E151003,SCUOLA PRIMARIA,1,21,21,0,0,0
202223,VRPS025009,SCUOLA SECONDARIA II GRADO,5,49,48,1,1,0
202223,GR1M00200E,SCUOLA SECONDARIA I GRADO,1,23,23,0,0,0
202223,MB1M02700T,SCUOLA SECONDARIA I GRADO,2,36,35,1,0,1
202223,TO1E01500D,SCUOLA PRIMARIA,1,16,15,1,1,0
202223,SATD13500L,SCUOLA SECONDARIA II GRADO,2,5,5,0,0,0
202223,SATD01500E,SCUOLA SECONDARIA II GRADO,5,68,68,0,0,0
202223,SARFRL5003,SCUOLA SECONDARIA II GRADO,2,4,4,0,0,0
202223,SAPS9B500T,SCUOLA SECONDARIA II GRADO,5,25,24,1,1,0
202223,RM1E001004,SCUOLA PRIMARIA,3,27,23,4,1,3
202223,PARI045006,SCUOLA SECONDARIA II GRADO,5,5,4,1,1,0
202223,LU1ETH500S,SCUOLA PRIMARIA,4,4,3,1,0,1
202223,BG1M029002,SCUOLA SECONDARIA I GRADO,2,27,27,0,0,0
202223,SATNTR5000,SCUOLA SECONDARIA II GRADO,5,64,57,7,4,3
202223,UDTBCH500I,SCUOLA SECONDARIA II GRADO,5,13,10,3,2,1
202223,CE1E022008,SCUOLA PRIMARIA,3,28,28,0,0,0
202223,PA1E01700G,SCUOLA PRIMARIA,5,43,43,0,0,0
202223,BG1E00800Q,SCUOLA PRIMARIA,5,52,52,0,0,0
202223,CA1E01700A,SCUOLA PRIMARIA,4,6,6,0,0,0
202223,RM1E09000Q,SCUOLA PRIMARIA,3,49,48,1,0,1
202223,RM1E072006,SCUOLA PRIMARIA,5,23,21,2,2,0
202223,VA1E01300Q,SCUOLA PRIMARIA,5,35,34,1,0,1
202223,RO1E0L5003,SCUOLA PRIMARIA,3,17,17,0,0,0
202223,PD1EOO500S,SCUOLA PRIMARIA,1,8,6,2,0,2
202223,NA1E044003,SCUOLA PRIMARIA,1,50,49,1,0,1
202223,VR1E018001,SCUOLA PRIMARIA,2,22,19,3,0,3
202223,RM1E12500D,SCUOLA PRIMARIA,2,19,19,0,0,0
202223,GE1E03700L,SCUOLA PRIMARIA,3,24,21,3,1,2
202223,CB1E00100B,SCUOLA PRIMARIA,2,10,9,1,0,1
202223,MIPLGB500O,SCUOLA SECONDARIA II GRADO,1,26,25,1,0,1
202223,FIPMT8500I,SCUOLA SECONDARIA II GRADO,5,20,20,0,0,0
202223,MBPSFH500F,SCUOLA SECONDARIA II GRADO,3,14,14,0,0,0
202223,MBRH00500P,SCUOLA SECONDARIA II GRADO,4,39,38,1,0,1
202223,RM1M09700Q,SCUOLA SECONDARIA I GRADO,3,57,57,0,0,0
202223,BA1E005007,SCUOLA PRIMARIA,3,23,23,0,0,0
202223,MITN03500N,SCUOLA SECONDARIA II GRADO,5,16,13,3,1,2
202223,SA1M012007,SCUOLA SECONDARIA I GRADO,3,6,5,1,0,1
202223,LO1E00500E,SCUOLA PRIMARIA,2,21,21,0,0,0
202223,BG1E013007,SCUOLA PRIMARIA,1,19,19,0,0,0
202223,PZ1E002007,SCUOLA PRIMARIA,4,21,21,0,0,0
202223,RMPSCH500E,SCUOLA SECONDARIA II GRADO,4,22,22,0,0,0
202223,TO1E01900R,SCUOLA PRIMARIA,4,40,38,2,1,1
202223,PETD06500C,SCUOLA SECONDARIA II GRADO,3,8,8,0,0,0
202223,MEPM12500X,SCUOLA SECONDARIA II GRADO,5,22,21,1,0,1
202223,TVPS57500F,SCUOLA SECONDARIA II GRADO,1,46,46,0,0,0
202223,BS1M017008,SCUOLA SECONDARIA I GRADO,1,46,41,5,0,5
202223,VAPLVL5003,SCUOLA SECONDARIA II GRADO,4,8,8,0,0,0
202223,NA1E234006,SCUOLA PRIMARIA,4,15,15,0,0,0
202223,NATDR0500L,SCUOLA SECONDARIA II GRADO,5,68,65,3,0,3
202223,MBPSTE500O,SCUOLA SECONDARIA II GRADO,2,26,26,0,0,0
202223,NATD575004,SCUOLA SECONDARIA II GRADO,1,5,5,0,0,0
202223,BG1E026009,SCUOLA PRIMARIA,1,14,13,1,0,1
202223,VRPC01500G,SCUOLA SECONDARIA II GRADO,1,19,19,0,0,0
202223,BA1E00900E,SCUOLA PRIMARIA,2,64,62,2,1,1
202223,TO1E003007,SCUOLA PRIMARIA,4,31,31,0,0,0
202223,AP1MUM500N,SCUOLA SECONDARIA I GRADO,3,21,21,0,0,0
202223,RMTDSN500S,SCUOLA SECONDARIA II GRADO,5,14,14,0,0,0
202223,NAPM39500R,SCUOLA SECONDARIA II GRADO,3,5,5,0,0,0
202223,VR1E00500V,SCUOLA PRIMARIA,3,23,23,0,0,0
202223,FRTF2T500E,SCUOLA SECONDARIA II GRADO,2,3,3,0,0,0
202223,VI1M008007,SCUOLA SECONDARIA I GRADO,3,34,31,3,1,2
202223,RM1E01300A,SCUOLA PRIMARIA,5,23,23,0,0,0
202223,CETFAV500R,SCUOLA SECONDARIA II GRADO,2,9,8,1,0,1
202223,NATF9E5003,SCUOLA SECONDARIA II GRADO,1,5,5,0,0,0
202223,GEPCDG500G,SCUOLA SECONDARIA II GRADO,5,7,7,0,0,0
202223,NA1E14600G,SCUOLA PRIMARIA,4,26,26,0,0,0
202223,MIPCCH5001,SCUOLA SECONDARIA II GRADO,2,15,14,1,1,0
202223,BG1E014003,SCUOLA PRIMARIA,4,20,17,3,2,1
202223,PCPM79500U,SCUOLA SECONDARIA II GRADO,2,7,7,0,0,0
202223,SATFET500V,SCUOLA SECONDARIA II GRADO,1,8,8,0,0,0
202223,GEPMUO500T,SCUOLA SECONDARIA II GRADO,1,25,25,0,0,0
202223,MIPS79500P,SCUOLA SECONDARIA II GRADO,4,11,11,0,0,0
202223,PVPS01500C,SCUOLA SECONDARIA II GRADO,4,23,23,0,0,0
202223,NATD475007,SCUOLA SECONDARIA II GRADO,1,14,14,0,0,0
202223,NAPM05500Q,SCUOLA SECONDARIA II GRADO,1,24,23,1,0,1
202223,MCPSL3500U,SCUOLA SECONDARIA II GRADO,4,1,0,1,0,1
202223,RM1E20900C,SCUOLA PRIMARIA,1,6,6,0,0,0
202223,BS1E025002,SCUOLA PRIMARIA,2,16,13,3,0,3
202223,CTPC08500Q,SCUOLA SECONDARIA II GRADO,5,12,12,0,0,0
202223,BGPMVO500T,SCUOLA SECONDARIA II GRADO,3,45,44,1,0,1
202223,UD1E008003,SCUOLA PRIMARIA,3,23,23,0,0,0
202223,NA1E10900L,SCUOLA PRIMARIA,5,10,8,2,1,1
202223,NA1E21500R,SCUOLA PRIMARIA,4,16,16,0,0,0
202223,BS1E00500R,SCUOLA PRIMARIA,1,28,22,6,0,6
202223,BAPS815002,SCUOLA SECONDARIA II GRADO,4,4,4,0,0,0
202223,RM1E18900C,SCUOLA PRIMARIA,2,16,16,0,0,0
202223,VEPC02500E,SCUOLA SECONDARIA II GRADO,5,12,12,0,0,0
202223,VE1M007004,SCUOLA SECONDARIA I GRADO,2,48,44,4,0,4
202223,FOPS5G500N,SCUOLA SECONDARIA II GRADO,4,26,26,0,0,0
202223,SA1E02300C,SCUOLA PRIMARIA,5,17,17,0,0,0
202223,RM1E064007,SCUOLA PRIMARIA,4,23,23,0,0,0
202223,SA1E01300T,SCUOLA PRIMARIA,5,25,25,0,0,0
202223,VA1E00500R,SCUOLA PRIMARIA,3,50,49,1,1,0
202223,METD08500D,SCUOLA SECONDARIA II GRADO,3,1,1,0,0,0
202223,IM1E00500L,SCUOLA PRIMARIA,5,16,15,1,0,1
202223,CT1E82801D,SCUOLA PRIMARIA,1,14,14,0,0,0
202223,LU1EM35005,SCUOLA PRIMARIA,4,25,16,9,2,7
202223,RM1E200002,SCUOLA PRIMARIA,5,11,11,0,0,0
202223,RM1E057004,SCUOLA PRIMARIA,4,30,30,0,0,0
202223,CTPL655003,SCUOLA SECONDARIA II GRADO,4,5,5,0,0,0
202223,PAPC695004,SCUOLA SECONDARIA II GRADO,5,14,13,1,0,1
202223,PDPL02500A,SCUOLA SECONDARIA II GRADO,5,24,21,3,0,3
202223,BN1E002002,SCUOLA PRIMARIA,3,16,16,0,0,0
202223,MCPM00500L,SCUOLA SECONDARIA II GRADO,4,20,20,0,0,0
202223,RM1M13900L,SCUOLA SECONDARIA I GRADO,2,41,40,1,1,0
202223,RMTD665009,SCUOLA SECONDARIA II GRADO,3,4,3,1,1,0
202223,MI1E06300V,SCUOLA PRIMARIA,2,16,8,8,0,8
202223,RM1M08400N,SCUOLA SECONDARIA I GRADO,1,35,33,2,0,2
202223,NA1E17500G,SCUOLA PRIMARIA,4,11,8,3,1,2
202223,TOTF01500R,SCUOLA SECONDARIA II GRADO,4,77,72,5,2,3
202223,FI1E027005,SCUOLA PRIMARIA,4,18,18,0,0,0
202223,CE1E06300E,SCUOLA PRIMARIA,2,17,12,5,1,4
202223,SSPQC7500O,SCUOLA SECONDARIA II GRADO,5,16,16,0,0,0
202223,IM1E003001,SCUOLA PRIMARIA,4,18,17,1,0,1
202223,RM1E122002,SCUOLA PRIMARIA,5,14,13,1,0,1
202223,BL1E00100G,SCUOLA PRIMARIA,4,29,29,0,0,0
202223,ENRHA05008,SCUOLA SECONDARIA II GRADO,4,8,8,0,0,0
202223,TOPL20500L,SCUOLA SECONDARIA II GRADO,3,18,18,0,0,0
202223,FG1E010003,SCUOLA PRIMARIA,5,20,17,3,0,3
202223,RMPSQP500D,SCUOLA SECONDARIA II GRADO,3,29,28,1,0,1
202223,BNRHT2500O,SCUOLA SECONDARIA II GRADO,3,5,5,0,0,0
202223,CE1ECZ5004,SCUOLA PRIMARIA,3,17,17,0,0,0
202223,MI1E061007,SCUOLA PRIMARIA,1,50,48,2,0,2
202223,CL1E003004,SCUOLA PRIMARIA,4,20,20,0,0,0
202223,NA1E18700T,SCUOLA PRIMARIA,5,20,13,7,5,2
202223,VR1E00100G,SCUOLA PRIMARIA,3,14,10,4,2,2
202223,TV1E01600N,SCUOLA PRIMARIA,2,23,22,1,0,1
202223,LE1E00600T,SCUOLA PRIMARIA,5,22,22,0,0,0
202223,CE1E05600B,SCUOLA PRIMARIA,3,5,5,0,0,0
202223,PEPMDE500O,SCUOLA SECONDARIA II GRADO,3,21,20,1,0,1
202223,VI1M00700B,SCUOLA SECONDARIA I GRADO,1,22,21,1,0,1
202223,NAPMSV500U,SCUOLA SECONDARIA II GRADO,2,12,12,0,0,0
202223,RM1E00200X,SCUOLA PRIMARIA,3,21,18,3,0,3
202223,CTTF04500E,SCUOLA SECONDARIA II GRADO,4,5,5,0,0,0
202223,BO1E014001,SCUOLA PRIMARIA,2,42,39,3,2,1
202223,RMRHRE5002,SCUOLA SECONDARIA II GRADO,3,15,14,1,1,0
202223,BS1E002009,SCUOLA PRIMARIA,4,23,23,0,0,0
202223,NATD0C5008,SCUOLA SECONDARIA II GRADO,4,7,7,0,0,0
202223,MI1M07300P,SCUOLA SECONDARIA I GRADO,3,90,88,2,1,1
202223,LCTF66500Z,SCUOLA SECONDARIA II GRADO,5,27,27,0,0,0
202223,CSPM04500A,SCUOLA SECONDARIA II GRADO,3,8,8,0,0,0
202223,NAPC24500P,SCUOLA SECONDARIA II GRADO,2,17,15,2,0,2
202223,CE1E03400E,SCUOLA PRIMARIA,2,24,24,0,0,0
202223,RGTD11500L,SCUOLA SECONDARIA II GRADO,4,2,2,0,0,0
202223,MITD52500D,SCUOLA SECONDARIA II GRADO,5,13,12,1,0,1
202223,NA1E6E500B,SCUOLA PRIMARIA,2,15,15,0,0,0
202223,VE1E00300G,SCUOLA PRIMARIA,1,21,19,2,0,2
202223,NA1E03800Q,SCUOLA PRIMARIA,1,16,16,0,0,0
202223,GE1E03800C,SCUOLA PRIMARIA,3,19,18,1,0,1
202223,VA1E00100D,SCUOLA PRIMARIA,1,57,56,1,0,1
202223,AR1E00500C,SCUOLA PRIMARIA,2,12,12,0,0,0
202223,MB1M011008,SCUOLA SECONDARIA I GRADO,1,21,21,0,0,0
202223,NA1E226007,SCUOLA PRIMARIA,3,15,15,0,0,0
202223,PGPM02500T,SCUOLA SECONDARIA II GRADO,5,12,9,3,0,3
202223,MI1M06100C,SCUOLA SECONDARIA I GRADO,3,75,70,5,0,5
202223,LEPS02500C,SCUOLA SECONDARIA II GRADO,3,7,7,0,0,0
202223,RM1E04700D,SCUOLA PRIMARIA,1,9,7,2,0,2
202223,FI1M006009,SCUOLA SECONDARIA I GRADO,2,29,22,7,0,7
202223,SA1E00200B,SCUOLA PRIMARIA,3,16,16,0,0,0
202223,NARHR7500Q,SCUOLA SECONDARIA II GRADO,3,6,6,0,0,0
202223,PO1E00700X,SCUOLA PRIMARIA,1,20,10,10,0,10
202223,TVPC01500X,SCUOLA SECONDARIA II GRADO,3,19,19,0,0,0
202223,PAPM4U500C,SCUOLA SECONDARIA II GRADO,3,1,1,0,0,0
202223,NA1E26500T,SCUOLA PRIMARIA,5,10,10,0,0,0
202223,NA1E27300R,SCUOLA PRIMARIA,2,12,10,2,0,2
202223,VARCD7500V,SCUOLA SECONDARIA II GRADO,4,24,24,0,0,0
202223,MI1E05100L,SCUOLA PRIMARIA,4,38,36,2,0,2
202223,NATLGU500N,SCUOLA SECONDARIA II GRADO,3,11,11,0,0,0
202223,LO1MOF5006,SCUOLA SECONDARIA I GRADO,1,22,22,0,0,0
202223,RMPSBI5001,SCUOLA SECONDARIA II GRADO,1,19,18,1,0,1
202223,TOTA015004,SCUOLA SECONDARIA II GRADO,4,26,24,2,0,2
202223,AGTF825005,SCUOLA SECONDARIA II GRADO,2,1,1,0,0,0
202223,MIPM07500B,SCUOLA SECONDARIA II GRADO,2,24,22,2,0,2
202223,PT1M00100X,SCUOLA SECONDARIA I GRADO,2,24,19,5,1,4
202223,FI1E06200C,SCUOLA PRIMARIA,4,67,58,9,2,7
202223,FI1M01600X,SCUOLA SECONDARIA I GRADO,3,44,40,4,1,3
202223,BGPSBT5004,SCUOLA SECONDARIA II GRADO,3,9,9,0,0,0
202223,MITF035002,SCUOLA SECONDARIA II GRADO,2,29,25,4,1,3
202223,RM1E150006,SCUOLA PRIMARIA,4,12,10,2,0,2
202223,NA1E02500N,SCUOLA PRIMARIA,2,33,33,0,0,0
202223,AVRH015007,SCUOLA SECONDARIA II GRADO,5,49,47,2,0,2
202223,COTB01500Q,SCUOLA SECONDARIA II GRADO,5,14,13,1,1,0
202223,CO1E01100A,SCUOLA PRIMARIA,3,25,25,0,0,0
202223,TOPS04500E,SCUOLA SECONDARIA II GRADO,1,48,46,2,0,2
202223,RM1E126009,SCUOLA PRIMARIA,3,19,18,1,0,1
202223,RMRFB3500L,SCUOLA SECONDARIA II GRADO,3,4,3,1,0,1
202223,NAPSAV500Q,SCUOLA SECONDARIA II GRADO,3,7,7,0,0,0
202223,MI1E04300N,SCUOLA PRIMARIA,3,40,40,0,0,0
202223,NATLT3500M,SCUOLA SECONDARIA II GRADO,4,6,6,0,0,0
202223,NATL27500X,SCUOLA SECONDARIA II GRADO,4,7,7,0,0,0
202223,RN1E007001,SCUOLA PRIMARIA,4,22,20,2,1,1
202223,RMTF285009,SCUOLA SECONDARIA II GRADO,1,11,10,1,1,0
202223,TS1E007005,SCUOLA PRIMARIA,4,7,7,0,0,0
202223,CETFQ95001,SCUOLA SECONDARIA II GRADO,5,70,69,1,1,0
202223,BSPS2O5007,SCUOLA SECONDARIA II GRADO,2,21,18,3,0,3
202223,NATF34500R,SCUOLA SECONDARIA II GRADO,1,1,1,0,0,0
202223,NATFGP5005,SCUOLA SECONDARIA II GRADO,1,7,7,0,0,0
202223,RM1M06200R,SCUOLA SECONDARIA I GRADO,1,27,26,1,0,1
202223,GEPS4C5009,SCUOLA SECONDARIA II GRADO,5,5,5,0,0,0
202223,MBPS40500C,SCUOLA SECONDARIA II GRADO,2,23,23,0,0,0
202223,LCPSG9500D,SCUOLA SECONDARIA II GRADO,1,16,16,0,0,0
202223,ALPM02500D,SCUOLA SECONDARIA II GRADO,2,15,14,1,0,1
202223,RGPS98500R,SCUOLA SECONDARIA II GRADO,2,3,2,1,0,1
202223,VV1E00100R,SCUOLA PRIMARIA,2,27,25,2,0,2
202223,SA1E004003,SCUOLA PRIMARIA,5,29,29,0,0,0
202223,CETDA05001,SCUOLA SECONDARIA II GRADO,1,15,14,1,1,0
202223,BSPMS9500M,SCUOLA SECONDARIA II GRADO,4,46,45,1,0,1
202223,VE1E014002,SCUOLA PRIMARIA,2,23,23,0,0,0
202223,PR1E00400G,SCUOLA PRIMARIA,5,36,35,1,0,1
202223,VC1E00100P,SCUOLA PRIMARIA,1,16,16,0,0,0
202223,CO1E00300B,SCUOLA PRIMARIA,5,39,38,1,1,0
202223,SAPMBS5006,SCUOLA SECONDARIA II GRADO,2,8,8,0,0,0
202223,RMPS49500G,SCUOLA SECONDARIA II GRADO,4,25,25,0,0,0
202223,NOPL015002,SCUOLA SECONDARIA II GRADO,3,10,9,1,0,1
202223,PSPC01500G,SCUOLA SECONDARIA II GRADO,5,9,8,1,1,0
202223,BOPMNL500M,SCUOLA SECONDARIA II GRADO,1,56,54,2,0,2
202223,BOPSVN5005,SCUOLA SECONDARIA II GRADO,3,13,13,0,0,0
202223,VA1E00700C,SCUOLA PRIMARIA,5,26,26,0,0,0
202223,NARFA35009,SCUOLA SECONDARIA II GRADO,4,3,3,0,0,0
202223,COSL035001,SCUOLA SECONDARIA II GRADO,4,32,27,5,0,5
202223,RMPM195002,SCUOLA SECONDARIA II GRADO,5,23,21,2,0,2
202223,RM1E134008,SCUOLA PRIMARIA,2,21,20,1,0,1
202223,NATF2E500L,SCUOLA SECONDARIA II GRADO,2,4,4,0,0,0
202223,CE1E008002,SCUOLA PRIMARIA,3,24,23,1,0,1
202223,MC1EMU5009,SCUOLA PRIMARIA,5,12,12,0,0,0
202223,AR1E00400L,SCUOLA PRIMARIA,2,17,16,1,0,1
202223,SAPMSZ500D,SCUOLA SECONDARIA II GRADO,4,8,8,0,0,0
202223,MNPC015004,SCUOLA SECONDARIA II GRADO,3,5,5,0,0,0
202223,RMPS8Q500R,SCUOLA SECONDARIA II GRADO,1,13,12,1,0,1
202223,RMPS49500G,SCUOLA SECONDARIA II GRADO,1,28,28,0,0,0
202223,AGTA56500L,SCUOLA SECONDARIA II GRADO,2,4,4,0,0,0
202223,TO1E040006,SCUOLA PRIMARIA,1,32,29,3,0,3
202223,RM1E08900G,SCUOLA PRIMARIA,5,13,12,1,0,1
202223,PTPC8G500H,SCUOLA SECONDARIA II GRADO,1,4,4,0,0,0
202223,PG1E00400E,SCUOLA PRIMARIA,4,15,13,2,1,1
202223,SATDH85000,SCUOLA SECONDARIA II GRADO,1,1,1,0,0,0
202223,SATD25500P,SCUOLA SECONDARIA II GRADO,3,8,8,0,0,0
202223,LC1E003005,SCUOLA PRIMARIA,5,44,43,1,0,1
202223,COPSIS500Q,SCUOLA SECONDARIA II GRADO,4,27,27,0,0,0
202223,RC1E005008,SCUOLA PRIMARIA,4,23,23,0,0,0
202223,MIPC10500T,SCUOLA SECONDARIA II GRADO,5,16,16,0,0,0
202223,NATF25500E,SCUOLA SECONDARIA II GRADO,4,11,11,0,0,0
202223,PD1E00100T,SCUOLA PRIMARIA,3,20,18,2,0,2
202223,MITNUQ500H,SCUOLA SECONDARIA II GRADO,5,40,38,2,1,1
202223,NA1E08400D,SCUOLA PRIMARIA,2,32,32,0,0,0
202223,CETDHL500C,SCUOLA SECONDARIA II GRADO,5,56,56,0,0,0
202223,BS1M00600T,SCUOLA SECONDARIA I GRADO,1,66,64,2,0,2
202223,BS1M012005,SCUOLA SECONDARIA I GRADO,3,19,18,1,0,1
202223,FI1E019006,SCUOLA PRIMARIA,3,25,16,9,0,9
202223,NATDGE5008,SCUOLA SECONDARIA II GRADO,5,55,54,1,0,1
202223,RM1E14500P,SCUOLA PRIMARIA,3,11,7,4,1,3
202223,BG1E02000A,SCUOLA PRIMARIA,3,27,27,0,0,0
202223,VRPM27500E,SCUOLA SECONDARIA II GRADO,1,14,14,0,0,0
202223,CT1E033001,SCUOLA PRIMARIA,1,12,10,2,1,1
202223,AV1E01200R,SCUOLA PRIMARIA,2,1,0,1,0,1
202223,SATFCA5002,SCUOLA SECONDARIA II GRADO,2,3,2,1,0,1
202223,RMPS285007,SCUOLA SECONDARIA II GRADO,4,16,15,1,0,1
202223,RMPS135009,SCUOLA SECONDARIA II GRADO,5,4,4,0,0,0
202223,MBPM005002,SCUOLA SECONDARIA II GRADO,2,45,45,0,0,0
202223,NATD255008,SCUOLA SECONDARIA II GRADO,2,13,13,0,0,0
202223,PVRFL2500T,SCUOLA SECONDARIA II GRADO,2,6,5,1,0,1
202223,MI1M07800T,SCUOLA SECONDARIA I GRADO,2,89,88,1,0,1
202223,RE1M008006,SCUOLA SECONDARIA I GRADO,3,12,10,2,1,1
202223,RM1E072006,SCUOLA PRIMARIA,4,19,19,0,0,0
202223,PAPSIU5009,SCUOLA SECONDARIA II GRADO,2,7,7,0,0,0
202223,LU1E003004,SCUOLA PRIMARIA,4,21,17,4,2,2
202223,VAPS5H500H,SCUOLA SECONDARIA II GRADO,1,24,23,1,0,1
202223,PD1EOO500S,SCUOLA PRIMARIA,2,15,10,5,0,5
202223,CTPSQC5001,SCUOLA SECONDARIA II GRADO,4,2,2,0,0,0
202223,RMPL325007,SCUOLA SECONDARIA II GRADO,3,11,11,0,0,0
202223,PA1E007001,SCUOLA PRIMARIA,2,14,14,0,0,0
202223,MBPL20500D,SCUOLA SECONDARIA II GRADO,5,38,38,0,0,0
202223,BG1E01100G,SCUOLA PRIMARIA,4,23,23,0,0,0
202223,RM1E09700E,SCUOLA PRIMARIA,1,33,33,0,0,0
202223,RE1M002007,SCUOLA SECONDARIA I GRADO,1,38,35,3,1,2
202223,GE1E00800L,SCUOLA PRIMARIA,5,19,17,2,0,2
202223,SA1E00600P,SCUOLA PRIMARIA,5,26,26,0,0,0
202223,VR1E01500D,SCUOLA PRIMARIA,4,19,18,1,0,1
202223,TO1M02200T,SCUOLA SECONDARIA I GRADO,2,28,27,1,0,1
202223,LTTN125009,SCUOLA SECONDARIA II GRADO,3,4,4,0,0,0
202223,RM1E21100C,SCUOLA PRIMARIA,5,15,14,1,0,1
202223,PD1E01700B,SCUOLA PRIMARIA,5,27,26,1,0,1
202223,FI1E00300L,SCUOLA PRIMARIA,4,21,18,3,1,2
202223,VASLAA500P,SCUOLA SECONDARIA II GRADO,1,18,18,0,0,0
202223,RMPSV5500M,SCUOLA SECONDARIA II GRADO,4,9,9,0,0,0
202223,RMPMPL5008,SCUOLA SECONDARIA II GRADO,1,5,5,0,0,0
202223,AVTFN9500H,SCUOLA SECONDARIA II GRADO,4,4,4,0,0,0
202223,CO1M01500V,SCUOLA SECONDARIA I GRADO,2,48,47,1,0,1
202223,RMPL39500D,SCUOLA SECONDARIA II GRADO,4,15,14,1,0,1
202223,MIPL15500R,SCUOLA SECONDARIA II GRADO,3,37,36,1,1,0
202223,FIPS02500P,SCUOLA SECONDARIA II GRADO,3,8,8,0,0,0
202223,MBPSTE500O,SCUOLA SECONDARIA II GRADO,3,28,28,0,0,0
202223,APTFI65001,SCUOLA SECONDARIA II GRADO,5,31,27,4,1,3
202223,CE1E066002,SCUOLA PRIMARIA,4,12,11,1,0,1
202223,RCTD035005,SCUOLA SECONDARIA II GRADO,3,3,2,1,0,1
202223,MI1E05600Q,SCUOLA PRIMARIA,1,26,26,0,0,0
202223,CRPSVN500C,SCUOLA SECONDARIA II GRADO,4,29,27,2,1,1
202223,MO1M005009,SCUOLA SECONDARIA I GRADO,3,72,72,0,0,0
202223,MB1E128009,SCUOLA PRIMARIA,3,31,31,0,0,0
202223,NAPM39500R,SCUOLA SECONDARIA II GRADO,4,5,5,0,0,0
202223,PG1E00300P,SCUOLA PRIMARIA,1,15,15,0,0,0
202223,PA1E03800L,SCUOLA PRIMARIA,1,17,17,0,0,0
202223,RM1E11600P,SCUOLA PRIMARIA,1,21,18,3,0,3
202223,MIPCCH5001,SCUOLA SECONDARIA II GRADO,3,5,5,0,0,0
202223,NA1E113008,SCUOLA PRIMARIA,2,13,13,0,0,0
202223,FIPS08500A,SCUOLA SECONDARIA II GRADO,3,15,15,0,0,0
202223,VATD05500V,SCUOLA SECONDARIA II GRADO,4,7,7,0,0,0
202223,NA1E08900L,SCUOLA PRIMARIA,3,21,21,0,0,0
202223,BA1E00300G,SCUOLA PRIMARIA,3,38,38,0,0,0
202223,NA1E16000T,SCUOLA PRIMARIA,5,11,11,0,0,0
202223,NAPLZL5002,SCUOLA SECONDARIA II GRADO,4,2,2,0,0,0
202223,CZ1E00400N,SCUOLA PRIMARIA,3,2,1,1,0,1
202223,SSTD02500P,SCUOLA SECONDARIA II GRADO,5,18,18,0,0,0
202223,MITF005006,SCUOLA SECONDARIA II GRADO,1,93,67,26,2,24
202223,PO1EHR500Z,SCUOLA PRIMARIA,1,20,9,11,0,11
202223,BO1E00200P,SCUOLA PRIMARIA,2,46,44,2,0,2
202223,PCPSD7500T,SCUOLA SECONDARIA II GRADO,5,46,45,1,0,1
202223,RMPC1A5001,SCUOLA SECONDARIA II GRADO,3,14,14,0,0,0
202223,MIPSD2500P,SCUOLA SECONDARIA II GRADO,2,20,17,3,1,2
202223,RM1M04600V,SCUOLA SECONDARIA I GRADO,1,44,44,0,0,0
202223,NA1E22400G,SCUOLA PRIMARIA,1,41,41,0,0,0
202223,MI1M05300D,SCUOLA SECONDARIA I GRADO,1,14,14,0,0,0
202223,ALPS005007,SCUOLA SECONDARIA II GRADO,5,11,11,0,0,0
202223,NAPM31500X,SCUOLA SECONDARIA II GRADO,1,9,9,0,0,0
202223,TV1E018009,SCUOLA PRIMARIA,3,22,22,0,0,0
202223,CTPL075003,SCUOLA SECONDARIA II GRADO,2,3,3,0,0,0
202223,NA1E04800A,SCUOLA PRIMARIA,1,20,20,0,0,0
202223,BGPMC0500F,SCUOLA SECONDARIA II GRADO,1,21,21,0,0,0
202223,CO1E00800E,SCUOLA PRIMARIA,2,20,16,4,1,3
202223,NA1E20800N,SCUOLA PRIMARIA,2,16,14,2,0,2
202223,RM1E19500Q,SCUOLA PRIMARIA,3,43,38,5,1,4
202223,RM1E186001,SCUOLA PRIMARIA,5,13,13,0,0,0
202223,TO1E02600X,SCUOLA PRIMARIA,2,33,32,1,1,0
202223,AGTD4Q5003,SCUOLA SECONDARIA II GRADO,3,8,7,1,0,1
202223,CSPM025005,SCUOLA SECONDARIA II GRADO,1,5,5,0,0,0
202223,SA1E020001,SCUOLA PRIMARIA,2,21,20,1,0,1
202223,RM1E073002,SCUOLA PRIMARIA,4,45,42,3,0,3
202223,GE1E012008,SCUOLA PRIMARIA,5,19,19,0,0,0
202223,AN1M00200A,SCUOLA SECONDARIA I GRADO,2,13,12,1,0,1
202223,GE1E027002,SCUOLA PRIMARIA,2,7,7,0,0,0
202223,SA1E016009,SCUOLA PRIMARIA,5,40,39,1,0,1
202223,RN1E01000R,SCUOLA PRIMARIA,5,25,25,0,0,0
202223,PDPS00500A,SCUOLA SECONDARIA II GRADO,4,24,24,0,0,0
202223,RMPM00500N,SCUOLA SECONDARIA II GRADO,3,15,15,0,0,0
202223,CERH015004,SCUOLA SECONDARIA II GRADO,4,20,19,1,0,1
202223,SAPS06500Q,SCUOLA SECONDARIA II GRADO,5,60,59,1,0,1
202223,MI1E061007,SCUOLA PRIMARIA,2,50,45,5,1,4
202223,BSTD01500C,SCUOLA SECONDARIA II GRADO,2,20,20,0,0,0
202223,NO1E001004,SCUOLA PRIMARIA,1,21,19,2,0,2
202223,RM1E01700N,SCUOLA PRIMARIA,3,12,10,2,0,2
202223,CAPC005006,SCUOLA SECONDARIA II GRADO,2,9,9,0,0,0
202223,RM1E03300G,SCUOLA PRIMARIA,4,51,49,2,0,2
202223,NO1E00400G,SCUOLA PRIMARIA,2,64,58,6,1,5
202223,CE1E05600B,SCUOLA PRIMARIA,4,10,10,0,0,0
202223,PEPMDE500O,SCUOLA SECONDARIA II GRADO,4,6,5,1,1,0
202223,SRTL49500I,SCUOLA SECONDARIA II GRADO,5,47,47,0,0,0
202223,LC1E00700C,SCUOLA PRIMARIA,3,18,17,1,0,1
202223,BG1M006009,SCUOLA SECONDARIA I GRADO,3,46,46,0,0,0
202223,NA1E01700P,SCUOLA PRIMARIA,1,24,24,0,0,0
202223,TVPL07500D,SCUOLA SECONDARIA II GRADO,5,3,3,0,0,0
202223,COPSZG500O,SCUOLA SECONDARIA II GRADO,1,14,13,1,0,1
202223,NATD53500N,SCUOLA SECONDARIA II GRADO,2,16,16,0,0,0
202223,NA1E122003,SCUOLA PRIMARIA,4,21,21,0,0,0
202223,RM1M07600P,SCUOLA SECONDARIA I GRADO,3,44,44,0,0,0
202223,CEPL00500E,SCUOLA SECONDARIA II GRADO,5,13,13,0,0,0
202223,MIPSR85009,SCUOLA SECONDARIA II GRADO,2,22,22,0,0,0
202223,MT1E00100E,SCUOLA PRIMARIA,5,19,18,1,0,1
202223,CA1E00600X,SCUOLA PRIMARIA,4,34,30,4,1,3
202223,SAPS8F500U,SCUOLA SECONDARIA II GRADO,4,3,3,0,0,0
202223,RN1E00900L,SCUOLA PRIMARIA,3,22,19,3,1,2
202223,MI1M03200C,SCUOLA SECONDARIA I GRADO,1,37,37,0,0,0
202223,RMPL1M500I,SCUOLA SECONDARIA II GRADO,1,8,7,1,1,0
202223,MB1E09100X,SCUOLA PRIMARIA,5,25,25,0,0,0
202223,PDPS77500P,SCUOLA SECONDARIA II GRADO,5,18,18,0,0,0
202223,PE1E009003,SCUOLA PRIMARIA,2,37,36,1,1,0
202223,RGPM05500B,SCUOLA SECONDARIA II GRADO,4,2,2,0,0,0
202223,MCTD00500B,SCUOLA SECONDARIA II GRADO,4,2,1,1,0,1
202223,VIPL015005,SCUOLA SECONDARIA II GRADO,5,18,18,0,0,0
202223,METDP0500I,SCUOLA SECONDARIA II GRADO,5,3,3,0,0,0
202223,PR1M00900X,SCUOLA SECONDARIA I GRADO,1,49,47,2,0,2
202223,NA1E241009,SCUOLA PRIMARIA,4,10,10,0,0,0
202223,NATDPA500D,SCUOLA SECONDARIA II GRADO,2,3,2,1,0,1
202223,RM1E121006,SCUOLA PRIMARIA,4,40,40,0,0,0
202223,UD1M00100D,SCUOLA SECONDARIA I GRADO,3,24,23,1,0,1
202223,MIPS54500V,SCUOLA SECONDARIA II GRADO,1,23,23,0,0,0
202223,SATF5C5002,SCUOLA SECONDARIA II GRADO,1,1,1,0,0,0
202223,UD1E002004,SCUOLA PRIMARIA,2,12,9,3,1,2
202223,NATHES5002,SCUOLA SECONDARIA II GRADO,5,22,20,2,2,0
202223,PE1E002008,SCUOLA PRIMARIA,3,16,14,2,0,2
202223,VIPM01500B,SCUOLA SECONDARIA II GRADO,3,22,22,0,0,0
202223,ME1E00400Q,SCUOLA PRIMARIA,4,11,11,0,0,0
202223,MIPSZS500P,SCUOLA SECONDARIA II GRADO,3,26,25,1,0,1
202223,VE1E00800P,SCUOLA PRIMARIA,2,17,16,1,0,1
202223,VAPS785001,SCUOLA SECONDARIA II GRADO,2,16,16,0,0,0
202223,NA1MLP500B,SCUOLA SECONDARIA I GRADO,1,12,12,0,0,0
202223,TO1M01400V,SCUOLA SECONDARIA I GRADO,1,20,18,2,1,1
202223,BG1MV3500S,SCUOLA SECONDARIA I GRADO,2,16,16,0,0,0
202223,FI1E01100G,SCUOLA PRIMARIA,2,43,36,7,0,7
202223,CTTD01500C,SCUOLA SECONDARIA II GRADO,4,2,2,0,0,0
202223,GE1E03100N,SCUOLA PRIMARIA,2,22,18,4,1,3
202223,MI1E090007,SCUOLA PRIMARIA,4,9,8,1,0,1
202223,AQ1E00700D,SCUOLA PRIMARIA,5,30,30,0,0,0
202223,PA1E01000R,SCUOLA PRIMARIA,5,20,20,0,0,0
202223,MIPS415006,SCUOLA SECONDARIA II GRADO,4,17,15,2,0,2
202223,NA1E22800V,SCUOLA PRIMARIA,1,11,11,0,0,0
202223,SAPC005001,SCUOLA SECONDARIA II GRADO,5,20,20,0,0,0
202223,VI1E00300V,SCUOLA PRIMARIA,5,13,11,2,0,2
202223,MI1E00100G,SCUOLA PRIMARIA,2,44,25,19,0,19
202223,MI1E017005,SCUOLA PRIMARIA,5,61,59,2,0,2
202223,REPM01500A,SCUOLA SECONDARIA II GRADO,3,10,10,0,0,0
202223,NARHR7500Q,SCUOLA SECONDARIA II GRADO,4,12,12,0,0,0
202223,SATLCL500F,SCUOLA SECONDARIA II GRADO,3,8,8,0,0,0
202223,SATFIP5005,SCUOLA SECONDARIA II GRADO,3,5,5,0,0,0
202223,CAPS02500E,SCUOLA SECONDARIA II GRADO,4,6,6,0,0,0
202223,NA1E25800P,SCUOLA PRIMARIA,4,21,18,3,2,1
202223,NATDZR500T,SCUOLA SECONDARIA II GRADO,2,14,14,0,0,0
202223,RM1E127005,SCUOLA PRIMARIA,5,42,40,2,0,2
202223,FE1ME9500R,SCUOLA SECONDARIA I GRADO,3,41,32,9,2,7
202223,FG1E01300E,SCUOLA PRIMARIA,5,24,24,0,0,0
202223,NOTB12500G,SCUOLA SECONDARIA II GRADO,1,5,2,3,0,3
202223,MITFDH5000,SCUOLA SECONDARIA II GRADO,5,29,28,1,0,1
202223,CRPC035004,SCUOLA SECONDARIA II GRADO,5,10,10,0,0,0
202223,MOPC005006,SCUOLA SECONDARIA II GRADO,4,16,16,0,0,0
202223,RA1M00400C,SCUOLA SECONDARIA I GRADO,3,30,30,0,0,0
202223,TO1E033003,SCUOLA PRIMARIA,1,73,64,9,8,1
202223,BOPL57500R,SCUOLA SECONDARIA II GRADO,1,21,18,3,0,3
202223,FI1M001006,SCUOLA SECONDARIA I GRADO,1,25,24,1,0,1
202223,PA1E04000L,SCUOLA PRIMARIA,5,20,20,0,0,0
202223,AVTDAS5006,SCUOLA SECONDARIA II GRADO,4,6,6,0,0,0
202223,TOPS19500C,SCUOLA SECONDARIA II GRADO,2,17,17,0,0,0
202223,CZPC00500G,SCUOLA SECONDARIA II GRADO,2,21,21,0,0,0
202223,TO1M056001,SCUOLA SECONDARIA I GRADO,3,84,82,2,2,0
202223,FG1E010003,SCUOLA PRIMARIA,1,22,18,4,1,3
202223,PD1E00900C,SCUOLA PRIMARIA,3,21,21,0,0,0
202223,RM1M02600N,SCUOLA SECONDARIA I GRADO,2,51,48,3,0,3
202223,RMPS24500R,SCUOLA SECONDARIA II GRADO,5,56,46,10,0,10
202223,RA1E004007,SCUOLA PRIMARIA,3,51,45,6,4,2
202223,RMPS99500H,SCUOLA SECONDARIA II GRADO,1,7,7,0,0,0
202223,VA1MIT5001,SCUOLA SECONDARIA I GRADO,1,32,32,0,0,0
202223,TS1E00300T,SCUOLA PRIMARIA,2,19,17,2,1,1
202223,GE1E006001,SCUOLA PRIMARIA,4,71,61,10,0,10
202223,RM1E006007,SCUOLA PRIMARIA,1,21,20,1,1,0
202223,MEPS045007,SCUOLA SECONDARIA II GRADO,4,21,19,2,0,2
202223,SATD4D500E,SCUOLA SECONDARIA II GRADO,5,65,57,8,2,6
202223,NA1M007009,SCUOLA SECONDARIA I GRADO,1,7,4,3,0,3
202223,BSPS125004,SCUOLA SECONDARIA II GRADO,3,16,16,0,0,0
202223,BSPSL9500N,SCUOLA SECONDARIA II GRADO,4,21,21,0,0,0
202223,PA1E4O500T,SCUOLA PRIMARIA,5,9,9,0,0,0
202223,CORH005002,SCUOLA SECONDARIA II GRADO,3,25,24,1,0,1
202223,RM1E15300N,SCUOLA PRIMARIA,4,26,26,0,0,0
202223,CZ1EQB500O,SCUOLA PRIMARIA,4,19,18,1,1,0
202223,NAPS065009,SCUOLA SECONDARIA II GRADO,3,6,6,0,0,0
202223,AP1E00200Q,SCUOLA PRIMARIA,1,10,9,1,0,1
202223,VEPL04500N,SCUOLA SECONDARIA II GRADO,2,14,14,0,0,0
202223,RM1E16700G,SCUOLA PRIMARIA,3,24,24,0,0,0
202223,TATD06500L,SCUOLA SECONDARIA II GRADO,5,18,18,0,0,0
202223,SARHDF500N,SCUOLA SECONDARIA II GRADO,1,1,1,0,0,0
202223,LCPC00500V,SCUOLA SECONDARIA II GRADO,3,6,6,0,0,0
202223,MI1M03000R,SCUOLA SECONDARIA I GRADO,2,115,112,3,0,3
202223,NA1E081002,SCUOLA PRIMARIA,1,14,12,2,1,1
202223,TV1E006003,SCUOLA PRIMARIA,2,11,11,0,0,0
202223,FR1E010004,SCUOLA PRIMARIA,5,10,9,1,0,1
202223,CE1E05900V,SCUOLA PRIMARIA,3,15,15,0,0,0
202223,FR1M00200A,SCUOLA SECONDARIA I GRADO,3,25,25,0,0,0
202223,CERIH2500T,SCUOLA SECONDARIA II GRADO,1,8,8,0,0,0
202223,VAPLB6500A,SCUOLA SECONDARIA II GRADO,2,10,9,1,1,0
202223,VA1M009009,SCUOLA SECONDARIA I GRADO,3,44,44,0,0,0
202223,FO1E001006,SCUOLA PRIMARIA,1,12,9,3,0,3
202223,LU1M8R500T,SCUOLA SECONDARIA I GRADO,1,25,19,6,2,4
202223,PR1E007003,SCUOLA PRIMARIA,3,15,15,0,0,0
202223,VATFQS5007,SCUOLA SECONDARIA II GRADO,3,22,22,0,0,0
202223,FI1E01700E,SCUOLA PRIMARIA,3,35,34,1,0,1
202223,SATFPG500G,SCUOLA SECONDARIA II GRADO,4,9,9,0,0,0
202223,PC1E001007,SCUOLA PRIMARIA,3,20,20,0,0,0
202223,AR1E00400L,SCUOLA PRIMARIA,3,15,14,1,0,1
202223,AV1E007009,SCUOLA PRIMARIA,5,27,27,0,0,0
202223,RMTD77500R,SCUOLA SECONDARIA II GRADO,3,4,3,1,0,1
202223,RMPS265002,SCUOLA SECONDARIA II GRADO,3,22,21,1,0,1
202223,PGPS00500G,SCUOLA SECONDARIA II GRADO,2,8,6,2,0,2
202223,MI1E00500V,SCUOLA PRIMARIA,3,26,24,2,0,2
202223,RM1E08200R,SCUOLA PRIMARIA,1,9,9,0,0,0
202223,MIPMZS500F,SCUOLA SECONDARIA II GRADO,3,24,24,0,0,0
202223,CERHZ85003,SCUOLA SECONDARIA II GRADO,5,23,23,0,0,0
202223,SATD25500P,SCUOLA SECONDARIA II GRADO,2,11,11,0,0,0
202223,NARHZ5500Q,SCUOLA SECONDARIA II GRADO,1,8,8,0,0,0
202223,BGPC05500B,SCUOLA SECONDARIA II GRADO,3,27,27,0,0,0
202223,SATL09500T,SCUOLA SECONDARIA II GRADO,4,8,8,0,0,0
202223,NA1E11800B,SCUOLA PRIMARIA,4,20,18,2,0,2
202223,FGRHSR500L,SCUOLA SECONDARIA II GRADO,2,11,8,3,1,2
202223,NA1E093008,SCUOLA PRIMARIA,3,15,15,0,0,0
202223,LI1E00800R,SCUOLA PRIMARIA,4,14,13,1,0,1
202223,MO1E00600X,SCUOLA PRIMARIA,4,14,9,5,0,5
202223,BATD105005,SCUOLA SECONDARIA II GRADO,3,7,7,0,0,0
202223,VEPL4H500R,SCUOLA SECONDARIA II GRADO,5,16,16,0,0,0
202223,RM1E094003,SCUOLA PRIMARIA,5,72,68,4,0,4
202223,PT1E00200E,SCUOLA PRIMARIA,2,15,14,1,0,1
202223,BOPS02500L,SCUOLA SECONDARIA II GRADO,3,29,29,0,0,0
202223,AGPC4A5009,SCUOLA SECONDARIA II GRADO,3,2,2,0,0,0
202223,PA1M01100T,SCUOLA SECONDARIA I GRADO,1,28,28,0,0,0
202223,PAPC14500P,SCUOLA SECONDARIA II GRADO,4,3,3,0,0,0
202223,NATF2C500R,SCUOLA SECONDARIA II GRADO,4,5,5,0,0,0
202223,TOPQ04500Q,SCUOLA SECONDARIA II GRADO,3,26,25,1,1,0
202223,BO1E005006,SCUOLA PRIMARIA,2,19,18,1,0,1
202223,NAPS68500Q,SCUOLA SECONDARIA II GRADO,2,28,26,2,0,2
202223,MI1E047001,SCUOLA PRIMARIA,2,66,65,1,1,0
202223,MI1EMR500E,SCUOLA PRIMARIA,1,60,54,6,0,6
202223,NA1E01000X,SCUOLA PRIMARIA,5,15,7,8,0,8
202223,CTTE01500X,SCUOLA SECONDARIA II GRADO,5,9,8,1,1,0
202223,TARF2M500U,SCUOLA SECONDARIA II GRADO,3,3,3,0,0,0
202223,CE1E02700B,SCUOLA PRIMARIA,2,13,11,2,1,1
202223,AVTD06500A,SCUOLA SECONDARIA II GRADO,4,5,4,1,0,1
202223,TOPM09500L,SCUOLA SECONDARIA II GRADO,2,19,18,1,1,0
202223,BNTDC1500F,SCUOLA SECONDARIA II GRADO,2,1,1,0,0,0
202223,BGTD085006,SCUOLA SECONDARIA II GRADO,1,10,8,2,0,2
202223,RM1E11800A,SCUOLA PRIMARIA,1,30,29,1,0,1
202223,BG1E021006,SCUOLA PRIMARIA,3,20,18,2,1,1
202223,CT1E054002,SCUOLA PRIMARIA,3,20,17,3,0,3
202223,VRPC01500G,SCUOLA SECONDARIA II GRADO,3,22,22,0,0,0
202223,RMPS235006,SCUOLA SECONDARIA II GRADO,4,39,39,0,0,0
202223,CH1E005007,SCUOLA PRIMARIA,2,14,14,0,0,0
202223,PVPS1S500G,SCUOLA SECONDARIA II GRADO,2,7,7,0,0,0
202223,LI1E00200T,SCUOLA PRIMARIA,3,40,39,1,0,1
202223,MI1EA8500G,SCUOLA PRIMARIA,1,60,58,2,1,1
202223,MB1E05500R,SCUOLA PRIMARIA,4,46,42,4,2,2
202223,LE1E00200E,SCUOLA PRIMARIA,4,38,37,1,0,1
202223,RMPC525003,SCUOLA SECONDARIA II GRADO,1,5,5,0,0,0
202223,CE1E029003,SCUOLA PRIMARIA,3,11,11,0,0,0
202223,RNPM015006,SCUOLA SECONDARIA II GRADO,1,53,29,24,0,24
202223,PDPC01500T,SCUOLA SECONDARIA II GRADO,3,17,17,0,0,0
202223,UDPLO3500Z,SCUOLA SECONDARIA II GRADO,3,13,13,0,0,0
202223,MI1E088007,SCUOLA PRIMARIA,3,33,28,5,0,5
202223,PA1E02000B,SCUOLA PRIMARIA,5,11,11,0,0,0
202223,MB1M026002,SCUOLA SECONDARIA I GRADO,3,46,46,0,0,0
202223,MI1M092004,SCUOLA SECONDARIA I GRADO,1,50,47,3,0,3
202223,NARHZL500O,SCUOLA SECONDARIA II GRADO,5,98,96,2,0,2
202223,NATD33500X,SCUOLA SECONDARIA II GRADO,3,23,22,1,0,1
202223,SATD125002,SCUOLA SECONDARIA II GRADO,1,4,4,0,0,0
202223,TO1E03400V,SCUOLA PRIMARIA,4,45,42,3,1,2
202223,LTTA335002,SCUOLA SECONDARIA II GRADO,2,2,2,0,0,0
202223,NA1E03900G,SCUOLA PRIMARIA,4,34,32,2,0,2
202223,NA1E04100G,SCUOLA PRIMARIA,5,45,45,0,0,0
202223,VR1E020001,SCUOLA PRIMARIA,3,52,48,4,2,2
202223,CO1M021006,SCUOLA SECONDARIA I GRADO,1,20,19,1,0,1
202223,RC1E00800Q,SCUOLA PRIMARIA,4,14,13,1,1,0
202223,CE1E001007,SCUOLA PRIMARIA,3,1,1,0,0,0
202223,FIPMP9500U,SCUOLA SECONDARIA II GRADO,3,8,8,0,0,0
202223,RMPLCV500U,SCUOLA SECONDARIA II GRADO,1,6,6,0,0,0
202223,RC1M00300T,SCUOLA SECONDARIA I GRADO,2,13,13,0,0,0
202223,CRPC035004,SCUOLA SECONDARIA II GRADO,1,12,12,0,0,0
202223,BSTN01500A,SCUOLA SECONDARIA II GRADO,2,13,13,0,0,0
202223,CA1E01700A,SCUOLA PRIMARIA,2,14,14,0,0,0
202223,LT1E00300L,SCUOLA PRIMARIA,2,14,13,1,0,1
202223,PGTDEI500F,SCUOLA SECONDARIA II GRADO,1,1,1,0,0,0
202223,RM1E04100E,SCUOLA PRIMARIA,3,12,12,0,0,0
202223,RMTL08500Q,SCUOLA SECONDARIA II GRADO,4,5,4,1,0,1
202223,VR1M021002,SCUOLA SECONDARIA I GRADO,3,4,4,0,0,0
202223,BS1M02300G,SCUOLA SECONDARIA I GRADO,2,86,81,5,0,5
202223,BSPM6Z500C,SCUOLA SECONDARIA II GRADO,4,10,10,0,0,0
202223,NA1E03700X,SCUOLA PRIMARIA,3,41,40,1,0,1
202223,TV1M014007,SCUOLA SECONDARIA I GRADO,1,19,19,0,0,0
202223,VR1E018001,SCUOLA PRIMARIA,4,29,27,2,0,2
202223,RMPM9P500H,SCUOLA SECONDARIA II GRADO,5,26,22,4,3,1
202223,CB1E00100B,SCUOLA PRIMARIA,1,9,8,1,0,1
202223,NA1E27400L,SCUOLA PRIMARIA,4,45,45,0,0,0
202223,BNPC02500R,SCUOLA SECONDARIA II GRADO,2,12,12,0,0,0
202223,NA1E09100L,SCUOLA PRIMARIA,5,22,22,0,0,0
202223,RM1M143008,SCUOLA SECONDARIA I GRADO,2,16,15,1,0,1
202223,APPCU15007,SCUOLA SECONDARIA II GRADO,3,5,4,1,0,1
202223,CA1E012007,SCUOLA PRIMARIA,3,20,20,0,0,0
202223,RN1E00200T,SCUOLA PRIMARIA,3,22,21,1,0,1
202223,LE1E00100P,SCUOLA PRIMARIA,2,29,29,0,0,0
202223,MB1E03400Q,SCUOLA PRIMARIA,4,43,43,0,0,0
202223,PE1E00600G,SCUOLA PRIMARIA,2,23,22,1,1,0
202223,PETD06500C,SCUOLA SECONDARIA II GRADO,2,3,3,0,0,0
202223,BGSLAE500Q,SCUOLA SECONDARIA II GRADO,4,7,6,1,0,1
202223,BGPSQZ500T,SCUOLA SECONDARIA II GRADO,5,17,16,1,0,1
202223,SSTD015004,SCUOLA SECONDARIA II GRADO,5,11,11,0,0,0
202223,RM1E14700A,SCUOLA PRIMARIA,2,25,24,1,0,1
202223,GEPMN4500Z,SCUOLA SECONDARIA II GRADO,3,45,45,0,0,0
202223,MIPL125001,SCUOLA SECONDARIA II GRADO,1,204,190,14,2,12
202223,CT1E00600L,SCUOLA PRIMARIA,1,18,14,4,0,4
202223,MIPSD2500P,SCUOLA SECONDARIA II GRADO,3,15,15,0,0,0
202223,RMSL02500P,SCUOLA SECONDARIA II GRADO,5,18,16,2,1,1
202223,PV1E00900X,SCUOLA PRIMARIA,5,20,20,0,0,0
202223,RMRHZT500U,SCUOLA SECONDARIA II GRADO,3,4,3,1,0,1
202223,PNTD7Z500U,SCUOLA SECONDARIA II GRADO,5,12,12,0,0,0
202223,MI1E01300T,SCUOLA PRIMARIA,5,21,20,1,0,1
202223,MCPSL3500U,SCUOLA SECONDARIA II GRADO,1,3,1,2,0,2
202223,BGRH005007,SCUOLA SECONDARIA II GRADO,1,12,12,0,0,0
202223,VAPSDE500S,SCUOLA SECONDARIA II GRADO,1,18,18,0,0,0
202223,BS1EAP500V,SCUOLA PRIMARIA,1,29,29,0,0,0
202223,CO1M02500D,SCUOLA SECONDARIA I GRADO,3,56,55,1,0,1
202223,NATFRU500B,SCUOLA SECONDARIA II GRADO,3,2,2,0,0,0
202223,VRTN01500C,SCUOLA SECONDARIA II GRADO,5,12,12,0,0,0
202223,BG1E014003,SCUOLA PRIMARIA,2,19,19,0,0,0
202223,UD1E010003,SCUOLA PRIMARIA,2,22,21,1,0,1
202223,ATRI02500P,SCUOLA SECONDARIA II GRADO,3,10,5,5,0,5
202223,MB1EP85003,SCUOLA PRIMARIA,3,22,22,0,0,0
202223,MBPM145009,SCUOLA SECONDARIA II GRADO,3,15,15,0,0,0
202223,MBPS28500G,SCUOLA SECONDARIA II GRADO,5,5,5,0,0,0
202223,TO1E009006,SCUOLA PRIMARIA,2,30,28,2,2,0
202223,NA1E06100R,SCUOLA PRIMARIA,4,26,24,2,0,2
202223,MI1E016009,SCUOLA PRIMARIA,1,39,39,0,0,0
202223,CSPM03500Q,SCUOLA SECONDARIA II GRADO,5,17,17,0,0,0
202223,RM1E099006,SCUOLA PRIMARIA,1,26,25,1,0,1
202223,REPSRL500H,SCUOLA SECONDARIA II GRADO,2,18,17,1,0,1
202223,MIPS04500E,SCUOLA SECONDARIA II GRADO,2,20,20,0,0,0
202223,VA1E00500R,SCUOLA PRIMARIA,4,44,43,1,0,1
202223,PD1M015007,SCUOLA SECONDARIA I GRADO,1,10,1,9,0,9
202223,UDPS0G500U,SCUOLA SECONDARIA II GRADO,1,20,17,3,0,3
202223,FIPS08500A,SCUOLA SECONDARIA II GRADO,5,26,26,0,0,0
202223,FG1E02500R,SCUOLA PRIMARIA,1,25,25,0,0,0
202223,MIPS20500T,SCUOLA SECONDARIA II GRADO,5,28,28,0,0,0
202223,RMTD545007,SCUOLA SECONDARIA II GRADO,5,195,174,21,3,18
202223,MI1E070002,SCUOLA PRIMARIA,1,22,22,0,0,0
202223,CA1EUL5004,SCUOLA PRIMARIA,4,11,11,0,0,0
202223,AGPSCE5001,SCUOLA SECONDARIA II GRADO,4,4,4,0,0,0
202223,RE1E00300T,SCUOLA PRIMARIA,3,42,41,1,0,1
202223,FI1E03300C,SCUOLA PRIMARIA,5,22,22,0,0,0
202223,VI1E007006,SCUOLA PRIMARIA,1,21,20,1,0,1
202223,BOPS3D500P,SCUOLA SECONDARIA II GRADO,5,10,10,0,0,0
202223,VA1E01900P,SCUOLA PRIMARIA,5,85,81,4,1,3
202223,VA1E010008,SCUOLA PRIMARIA,1,38,36,2,0,2
202223,NARFZO500E,SCUOLA SECONDARIA II GRADO,3,9,9,0,0,0
202223,IM1E00500L,SCUOLA PRIMARIA,4,20,19,1,0,1
202223,BS1M004006,SCUOLA SECONDARIA I GRADO,1,150,147,3,1,2
202223,NA1E241009,SCUOLA PRIMARIA,5,9,8,1,0,1
202223,RM1E130001,SCUOLA PRIMARIA,1,7,6,1,1,0
202223,MBPSUD500O,SCUOLA SECONDARIA II GRADO,5,18,18,0,0,0
202223,NATDAR5000,SCUOLA SECONDARIA II GRADO,5,68,65,3,1,2
202223,RMPC185007,SCUOLA SECONDARIA II GRADO,3,27,26,1,0,1
202223,MCPM00500L,SCUOLA SECONDARIA II GRADO,3,15,15,0,0,0
202223,TATD08500T,SCUOLA SECONDARIA II GRADO,3,25,23,2,1,1
202223,RMPS08500D,SCUOLA SECONDARIA II GRADO,3,48,48,0,0,0
202223,MIPSPS500G,SCUOLA SECONDARIA II GRADO,1,11,11,0,0,0
202223,MOPSMO5004,SCUOLA SECONDARIA II GRADO,1,21,19,2,1,1
202223,RM1M08400N,SCUOLA SECONDARIA I GRADO,2,43,39,4,0,4
202223,BA1E014002,SCUOLA PRIMARIA,2,17,17,0,0,0
202223,CHPMVZ5007,SCUOLA SECONDARIA II GRADO,2,9,9,0,0,0
202223,CA1E00800G,SCUOLA PRIMARIA,2,27,26,1,0,1
202223,RMPSII500C,SCUOLA SECONDARIA II GRADO,3,9,9,0,0,0
202223,RA1E00200G,SCUOLA PRIMARIA,4,38,37,1,0,1
202223,APPS3R5004,SCUOLA SECONDARIA II GRADO,5,25,25,0,0,0
202223,MI1M00200L,SCUOLA SECONDARIA I GRADO,3,21,21,0,0,0
202223,NAPMRM500O,SCUOLA SECONDARIA II GRADO,5,105,98,7,3,4
202223,CTTL005008,SCUOLA SECONDARIA II GRADO,2,3,3,0,0,0
202223,VA1M01400R,SCUOLA SECONDARIA I GRADO,3,49,49,0,0,0
202223,PA1E02600A,SCUOLA PRIMARIA,5,18,18,0,0,0
202223,PRTD02500N,SCUOLA SECONDARIA II GRADO,3,17,17,0,0,0
202223,MIPC075007,SCUOLA SECONDARIA II GRADO,5,22,22,0,0,0
202223,PATD91500R,SCUOLA SECONDARIA II GRADO,3,7,7,0,0,0
202223,PATFCO500Z,SCUOLA SECONDARIA II GRADO,5,17,16,1,0,1
202223,SATF4V500G,SCUOLA SECONDARIA II GRADO,5,70,70,0,0,0
202223,RMTA1T500M,SCUOLA SECONDARIA II GRADO,4,17,17,0,0,0
202223,NAPL975007,SCUOLA SECONDARIA II GRADO,1,3,2,1,0,1
202223,FR1E002005,SCUOLA PRIMARIA,4,10,10,0,0,0
202223,VR1E00100G,SCUOLA PRIMARIA,4,24,13,11,1,10
202223,TS1E008001,SCUOLA PRIMARIA,2,24,22,2,0,2
202223,CERHFI5007,SCUOLA SECONDARIA II GRADO,5,77,76,1,0,1
202223,CTTF04500E,SCUOLA SECONDARIA II GRADO,2,3,3,0,0,0
202223,BSPS01500L,SCUOLA SECONDARIA II GRADO,1,12,10,2,1,1
202223,NARHR7500Q,SCUOLA SECONDARIA II GRADO,5,130,128,2,0,2
202223,TO1M02900L,SCUOLA SECONDARIA I GRADO,2,17,14,3,0,3
202223,CTPM315008,SCUOLA SECONDARIA II GRADO,4,10,10,0,0,0
202223,FI1E013007,SCUOLA PRIMARIA,4,17,12,5,0,5
202223,NATF55500V,SCUOLA SECONDARIA II GRADO,4,9,8,1,0,1
202223,AQ1E00100E,SCUOLA PRIMARIA,1,19,18,1,0,1
202223,NA1E150007,SCUOLA PRIMARIA,3,12,11,1,0,1
202223,BS1E01200X,SCUOLA PRIMARIA,1,10,10,0,0,0
202223,MI1M097007,SCUOLA SECONDARIA I GRADO,3,21,21,0,0,0
202223,BS1E017003,SCUOLA PRIMARIA,2,76,75,1,0,1
202223,RM1E177006,SCUOLA PRIMARIA,2,9,9,0,0,0
202223,SRPS52500Q,SCUOLA SECONDARIA II GRADO,2,4,4,0,0,0
202223,REPM01500A,SCUOLA SECONDARIA II GRADO,4,15,15,0,0,0
202223,MIPM1C500T,SCUOLA SECONDARIA II GRADO,1,23,23,0,0,0
202223,FR1E00600C,SCUOLA PRIMARIA,4,24,24,0,0,0
202223,PARI025001,SCUOLA SECONDARIA II GRADO,3,1,1,0,0,0
202223,NARHM0500C,SCUOLA SECONDARIA II GRADO,4,1,1,0,0,0
202223,PAPM9C5005,SCUOLA SECONDARIA II GRADO,4,27,27,0,0,0
202223,SATFTV500U,SCUOLA SECONDARIA II GRADO,3,10,9,1,0,1
202223,TOPL03500P,SCUOLA SECONDARIA II GRADO,3,41,40,1,1,0
202223,FG1E00300X,SCUOLA PRIMARIA,4,20,20,0,0,0
202223,NA1E12500E,SCUOLA PRIMARIA,4,30,30,0,0,0
202223,UD1E00300X,SCUOLA PRIMARIA,4,22,22,0,0,0
202223,NA1E10200T,SCUOLA PRIMARIA,2,27,26,1,0,1
202223,NA1E21000N,SCUOLA PRIMARIA,4,20,20,0,0,0
202223,CRPLAB5007,SCUOLA SECONDARIA II GRADO,4,16,15,1,0,1
202223,VETFO1500N,SCUOLA SECONDARIA II GRADO,3,4,4,0,0,0
202223,SR1E3H5006,SCUOLA PRIMARIA,3,16,16,0,0,0
202223,MIPM06500R,SCUOLA SECONDARIA II GRADO,5,11,11,0,0,0
202223,BO1MUE500U,SCUOLA SECONDARIA I GRADO,1,11,10,1,0,1
202223,CTSD015003,SCUOLA SECONDARIA II GRADO,5,28,28,0,0,0
202223,RM1ERB5004,SCUOLA PRIMARIA,4,3,3,0,0,0
202223,CT1ET9500Z,SCUOLA PRIMARIA,3,22,22,0,0,0
202223,BG1M9L500G,SCUOLA SECONDARIA I GRADO,2,35,33,2,0,2
202223,PAPM4U500C,SCUOLA SECONDARIA II GRADO,2,2,2,0,0,0
202223,TOPC06500L,SCUOLA SECONDARIA II GRADO,3,18,18,0,0,0
202223,RM1E106004,SCUOLA PRIMARIA,4,40,38,2,0,2
202223,RMPSVP500H,SCUOLA SECONDARIA II GRADO,5,120,104,16,5,11
202223,MI1E02600X,SCUOLA PRIMARIA,3,20,19,1,0,1
202223,RM1M12400V,SCUOLA SECONDARIA I GRADO,1,25,25,0,0,0
202223,MI1E05100L,SCUOLA PRIMARIA,2,41,39,2,0,2
202223,NATFZE5004,SCUOLA SECONDARIA II GRADO,1,4,4,0,0,0
202223,NATLGU500N,SCUOLA SECONDARIA II GRADO,2,9,9,0,0,0
202223,NA1E006008,SCUOLA PRIMARIA,5,39,36,3,0,3
202223,TOTA015004,SCUOLA SECONDARIA II GRADO,5,18,18,0,0,0
202223,RN1E005009,SCUOLA PRIMARIA,4,44,40,4,0,4
202223,MI1M03000R,SCUOLA SECONDARIA I GRADO,3,115,115,0,0,0
202223,FI1E03200L,SCUOLA PRIMARIA,5,18,15,3,0,3
202223,PETD03500L,SCUOLA SECONDARIA II GRADO,2,8,8,0,0,0
202223,MEPC2A500L,SCUOLA SECONDARIA II GRADO,5,1,1,0,0,0
202223,SATD9L5009,SCUOLA SECONDARIA II GRADO,4,6,6,0,0,0
202223,PR1E007003,SCUOLA PRIMARIA,4,22,22,0,0,0
202223,PA1M01900C,SCUOLA SECONDARIA I GRADO,3,69,68,1,0,1
202223,NA1E13900C,SCUOLA PRIMARIA,3,15,15,0,0,0
202223,CT1E010008,SCUOLA PRIMARIA,5,22,19,3,0,3
202223,NAPS5M500T,SCUOLA SECONDARIA II GRADO,1,19,6,13,9,4
202223,RM1E193004,SCUOLA PRIMARIA,2,45,45,0,0,0
202223,CLSD00500B,SCUOLA SECONDARIA II GRADO,5,20,19,1,0,1
202223,SARHTF500G,SCUOLA SECONDARIA II GRADO,1,7,7,0,0,0
202223,NA1E08200T,SCUOLA PRIMARIA,4,12,11,1,0,1
202223,CS1E008005,SCUOLA PRIMARIA,4,20,20,0,0,0
202223,CE1E04200D,SCUOLA PRIMARIA,1,10,10,0,0,0
202223,VTPS015009,SCUOLA SECONDARIA II GRADO,5,22,21,1,1,0
202223,VA1M00600T,SCUOLA SECONDARIA I GRADO,1,24,23,1,0,1
202223,NA1M26500L,SCUOLA SECONDARIA I GRADO,3,12,8,4,4,0
202223,PO1E01100G,SCUOLA PRIMARIA,2,26,24,2,0,2
202223,PR1E00200X,SCUOLA PRIMARIA,2,23,23,0,0,0
202223,VBPM03500D,SCUOLA SECONDARIA II GRADO,5,18,18,0,0,0
202223,BO1E01100D,SCUOLA PRIMARIA,2,36,33,3,1,2
202223,RMPL445009,SCUOLA SECONDARIA II GRADO,4,26,24,2,0,2
202223,AT1M00200R,SCUOLA SECONDARIA I GRADO,2,16,16,0,0,0
202223,GEPMAH500O,SCUOLA SECONDARIA II GRADO,5,15,15,0,0,0
202223,RMPS41500P,SCUOLA SECONDARIA II GRADO,4,3,3,0,0,0
202223,SARHE75006,SCUOLA SECONDARIA II GRADO,1,4,4,0,0,0
202223,SI1E003001,SCUOLA PRIMARIA,1,11,11,0,0,0
202223,FI1M02600E,SCUOLA SECONDARIA I GRADO,2,14,13,1,0,1
202223,PAPMRG500C,SCUOLA SECONDARIA II GRADO,4,9,9,0,0,0
202223,CERIDA500F,SCUOLA SECONDARIA II GRADO,3,34,34,0,0,0
202223,VA1M01000D,SCUOLA SECONDARIA I GRADO,3,76,73,3,0,3
202223,BG1M029002,SCUOLA SECONDARIA I GRADO,1,25,24,1,1,0
202223,VC1E00100P,SCUOLA PRIMARIA,2,14,13,1,0,1
202223,SATNV3500O,SCUOLA SECONDARIA II GRADO,1,4,4,0,0,0
202223,UDPSMD500L,SCUOLA SECONDARIA II GRADO,2,12,12,0,0,0
202223,NA1E285003,SCUOLA PRIMARIA,4,12,12,0,0,0
202223,CO1E00300B,SCUOLA PRIMARIA,3,43,41,2,0,2
202223,BLPSD7500D,SCUOLA SECONDARIA II GRADO,3,15,14,1,0,1
202223,PA1E01700G,SCUOLA PRIMARIA,4,42,42,0,0,0
202223,CR1E005006,SCUOLA PRIMARIA,3,15,15,0,0,0
202223,SAPMBS5006,SCUOLA SECONDARIA II GRADO,3,8,7,1,1,0
202223,MI1M09400Q,SCUOLA SECONDARIA I GRADO,1,26,25,1,0,1
202223,BAPLS4500L,SCUOLA SECONDARIA II GRADO,3,5,5,0,0,0
202223,TO1E04200T,SCUOLA PRIMARIA,2,33,31,2,2,0
202223,FI1E02400N,SCUOLA PRIMARIA,5,14,14,0,0,0
202223,PSPC01500G,SCUOLA SECONDARIA II GRADO,3,5,5,0,0,0
202223,NA1E01100Q,SCUOLA PRIMARIA,1,6,6,0,0,0
202223,METD065008,SCUOLA SECONDARIA II GRADO,2,4,4,0,0,0
202223,RM1E206001,SCUOLA PRIMARIA,4,22,21,1,0,1
202223,NATF2C500R,SCUOLA SECONDARIA II GRADO,5,62,61,1,0,1
202223,RM1E12500D,SCUOLA PRIMARIA,3,14,13,1,0,1
202223,TS1E001006,SCUOLA PRIMARIA,3,22,22,0,0,0
202223,SAPMP9500T,SCUOLA SECONDARIA II GRADO,1,1,1,0,0,0
202223,NATNB7500P,SCUOLA SECONDARIA II GRADO,3,5,5,0,0,0
202223,LO1E00500E,SCUOLA PRIMARIA,1,33,33,0,0,0
202223,PZ1E002007,SCUOLA PRIMARIA,3,14,14,0,0,0
202223,TO1E05800B,SCUOLA PRIMARIA,3,22,12,10,7,3
202223,BGPSH85002,SCUOLA SECONDARIA II GRADO,3,14,13,1,0,1
202223,TA1E00500X,SCUOLA PRIMARIA,2,20,20,0,0,0
202223,SSPM9L500Q,SCUOLA SECONDARIA II GRADO,3,6,6,0,0,0
202223,BS1M01600C,SCUOLA SECONDARIA I GRADO,3,40,38,2,0,2
202223,VAPLVL5003,SCUOLA SECONDARIA II GRADO,5,3,3,0,0,0
202223,TVPS05500D,SCUOLA SECONDARIA II GRADO,5,13,13,0,0,0
202223,RM1E10400C,SCUOLA PRIMARIA,5,21,21,0,0,0
202223,PATDEE500L,SCUOLA SECONDARIA II GRADO,3,3,3,0,0,0
202223,FE1E004005,SCUOLA PRIMARIA,4,18,16,2,1,1
202223,BG1E02500D,SCUOLA PRIMARIA,5,55,54,1,1,0
202223,GO1EUT5002,SCUOLA PRIMARIA,3,8,8,0,0,0
202223,GR1E74500I,SCUOLA PRIMARIA,2,11,11,0,0,0
202223,MB1M02700T,SCUOLA SECONDARIA I GRADO,1,53,50,3,1,2
202223,TO1E003007,SCUOLA PRIMARIA,5,43,43,0,0,0
202223,SATD13500L,SCUOLA SECONDARIA II GRADO,3,9,9,0,0,0
202223,LCTB00500V,SCUOLA SECONDARIA II GRADO,1,6,6,0,0,0
202223,SAPSL4500R,SCUOLA SECONDARIA II GRADO,1,9,9,0,0,0
202223,RM1E05400L,SCUOLA PRIMARIA,1,22,19,3,2,1
202223,RM1E001004,SCUOLA PRIMARIA,2,27,25,2,0,2
202223,PARI045006,SCUOLA SECONDARIA II GRADO,4,3,3,0,0,0
202223,CE1E022008,SCUOLA PRIMARIA,2,43,37,6,1,5
202223,PATL095008,SCUOLA SECONDARIA II GRADO,5,17,17,0,0,0
202223,CT1E031009,SCUOLA PRIMARIA,5,20,20,0,0,0
202223,MB1M017007,SCUOLA SECONDARIA I GRADO,1,51,51,0,0,0
202223,NATANI5007,SCUOLA SECONDARIA II GRADO,4,3,3,0,0,0
202223,RM1E09000Q,SCUOLA PRIMARIA,4,44,43,1,0,1
202223,VT1M00500P,SCUOLA SECONDARIA I GRADO,1,8,8,0,0,0
202223,RO1E0L5003,SCUOLA PRIMARIA,4,12,12,0,0,0
202223,RM1EM25008,SCUOLA PRIMARIA,4,42,27,15,0,15
202223,LTPM4Q5001,SCUOLA SECONDARIA II GRADO,1,3,1,2,1,1
202223,LU1E003004,SCUOLA PRIMARIA,3,12,9,3,0,3
202223,CETF1M500C,SCUOLA SECONDARIA II GRADO,1,8,7,1,0,1
202223,BSPS075008,SCUOLA SECONDARIA II GRADO,3,44,44,0,0,0
202223,CTPC08500Q,SCUOLA SECONDARIA II GRADO,4,9,9,0,0,0
202223,PD1E076018,SCUOLA PRIMARIA,5,18,18,0,0,0
202223,BGPMVO500T,SCUOLA SECONDARIA II GRADO,2,35,33,2,0,2
202223,VR1E018001,SCUOLA PRIMARIA,3,18,17,1,0,1
202223,GE1E03700L,SCUOLA PRIMARIA,2,24,22,2,1,1
202223,CERH325008,SCUOLA SECONDARIA II GRADO,4,7,7,0,0,0
202223,RM1M09800G,SCUOLA SECONDARIA I GRADO,1,8,8,0,0,0
202223,RMTD00500C,SCUOLA SECONDARIA II GRADO,3,7,6,1,1,0
202223,RM1E18900C,SCUOLA PRIMARIA,3,14,14,0,0,0
202223,BG1E01200B,SCUOLA PRIMARIA,5,43,41,2,1,1
202223,PGPC00500C,SCUOLA SECONDARIA II GRADO,3,1,1,0,0,0
202223,RMPSCH500E,SCUOLA SECONDARIA II GRADO,5,14,14,0,0,0
202223,TO1E01900R,SCUOLA PRIMARIA,5,21,21,0,0,0
202223,GE1E026006,SCUOLA PRIMARIA,4,24,21,3,2,1
202223,MIPM2A500Z,SCUOLA SECONDARIA II GRADO,3,31,28,3,0,3
202223,PT1E00300A,SCUOLA PRIMARIA,4,13,9,4,0,4
202223,VA1E004001,SCUOLA PRIMARIA,1,18,17,1,1,0
202223,METD08500D,SCUOLA SECONDARIA II GRADO,2,1,1,0,0,0
202223,TVPS57500F,SCUOLA SECONDARIA II GRADO,2,25,25,0,0,0
202223,PD1E019003,SCUOLA PRIMARIA,1,39,35,4,0,4
202223,PDPL02500A,SCUOLA SECONDARIA II GRADO,4,20,18,2,0,2
202223,CO1E00700P,SCUOLA PRIMARIA,2,27,25,2,1,1
202223,MBPSTE500O,SCUOLA SECONDARIA II GRADO,1,29,29,0,0,0
202223,BN1E002002,SCUOLA PRIMARIA,2,6,6,0,0,0
202223,VASLAA500P,SCUOLA SECONDARIA II GRADO,2,15,12,3,1,2
202223,MITF105003,SCUOLA SECONDARIA II GRADO,1,28,25,3,1,2
202223,NA1E00300R,SCUOLA PRIMARIA,5,10,8,2,0,2
202223,MO1E00200L,SCUOLA PRIMARIA,5,29,28,1,0,1
202223,MO1M005009,SCUOLA SECONDARIA I GRADO,2,49,49,0,0,0
202223,NA1E17500G,SCUOLA PRIMARIA,3,12,10,2,0,2
202223,MB1E04100V,SCUOLA PRIMARIA,1,42,41,1,1,0
202223,NAPL19500R,SCUOLA SECONDARIA II GRADO,2,18,16,2,0,2
202223,VR1E00500V,SCUOLA PRIMARIA,4,19,19,0,0,0
202223,FRTF2T500E,SCUOLA SECONDARIA II GRADO,1,2,2,0,0,0
202223,RM1E01300A,SCUOLA PRIMARIA,4,19,19,0,0,0
202223,CETFAV500R,SCUOLA SECONDARIA II GRADO,1,8,7,1,0,1
202223,IM1E003001,SCUOLA PRIMARIA,3,14,13,1,0,1
202223,AVPSPT500F,SCUOLA SECONDARIA II GRADO,4,12,11,1,0,1
202223,MIPCCH5001,SCUOLA SECONDARIA II GRADO,1,8,8,0,0,0
202223,BG1E014003,SCUOLA PRIMARIA,3,27,27,0,0,0
202223,PCPM79500U,SCUOLA SECONDARIA II GRADO,1,12,12,0,0,0
202223,PD1E006001,SCUOLA PRIMARIA,2,17,16,1,0,1
202223,GEPMN4500Z,SCUOLA SECONDARIA II GRADO,5,35,35,0,0,0
202223,RMPS27500L,SCUOLA SECONDARIA II GRADO,4,25,23,2,0,2
202223,BS1E01400G,SCUOLA PRIMARIA,5,24,24,0,0,0
202223,MITL035006,SCUOLA SECONDARIA II GRADO,5,4,3,1,0,1
202223,RMSL3M5001,SCUOLA SECONDARIA II GRADO,4,9,9,0,0,0
202223,NATD3V500N,SCUOLA SECONDARIA II GRADO,3,5,5,0,0,0
202223,NATD46500L,SCUOLA SECONDARIA II GRADO,5,70,63,7,4,3
202223,NAPM015009,SCUOLA SECONDARIA II GRADO,5,18,18,0,0,0
202223,RM1E00900P,SCUOLA PRIMARIA,5,25,24,1,0,1
202223,BS1E025002,SCUOLA PRIMARIA,1,15,11,4,1,3
202223,NA1M03300T,SCUOLA SECONDARIA I GRADO,1,28,20,8,0,8
202223,FI1E01200B,SCUOLA PRIMARIA,4,25,24,1,0,1
202223,VT1E00500D,SCUOLA PRIMARIA,5,26,26,0,0,0
202223,BS1E002009,SCUOLA PRIMARIA,3,24,23,1,0,1
202223,BS1E004001,SCUOLA PRIMARIA,5,50,50,0,0,0
202223,RMSL3L500Q,SCUOLA SECONDARIA II GRADO,5,19,19,0,0,0
202223,MBPQ035002,SCUOLA SECONDARIA II GRADO,2,28,28,0,0,0
202223,VE1M007004,SCUOLA SECONDARIA I GRADO,3,60,59,1,0,1
202223,REPM7R500G,SCUOLA SECONDARIA II GRADO,1,14,14,0,0,0
202223,RM1E064007,SCUOLA PRIMARIA,5,26,26,0,0,0
202223,SA1E01400N,SCUOLA PRIMARIA,1,17,17,0,0,0
202223,LTPSO3500F,SCUOLA SECONDARIA II GRADO,1,3,3,0,0,0
202223,LU1EM35005,SCUOLA PRIMARIA,3,26,24,2,0,2
202223,RM1E20200N,SCUOLA PRIMARIA,1,24,22,2,0,2
202223,RM1E057004,SCUOLA PRIMARIA,5,30,27,3,1,2
202223,PAPC695004,SCUOLA SECONDARIA II GRADO,4,3,3,0,0,0
202223,NA1E20700T,SCUOLA PRIMARIA,5,15,15,0,0,0
202223,RM1M13900L,SCUOLA SECONDARIA I GRADO,3,55,50,5,1,4
202223,RMTD72500Q,SCUOLA SECONDARIA II GRADO,1,9,8,1,0,1
202223,RMTD665009,SCUOLA SECONDARIA II GRADO,4,3,3,0,0,0
202223,MI1E06300V,SCUOLA PRIMARIA,1,12,7,5,1,4
202223,MI1M085001,SCUOLA SECONDARIA I GRADO,2,107,106,1,1,0
202223,RM1E02000D,SCUOLA PRIMARIA,3,23,23,0,0,0
202223,RM1E03100X,SCUOLA PRIMARIA,3,11,10,1,0,1
202223,MI1M068007,SCUOLA SECONDARIA I GRADO,2,20,17,3,0,3
202223,FI1E027005,SCUOLA PRIMARIA,3,7,7,0,0,0
202223,PG1MB2500Q,SCUOLA SECONDARIA I GRADO,2,18,17,1,0,1
202223,SA1E01900R,SCUOLA PRIMARIA,1,14,14,0,0,0
202223,SA1E00200B,SCUOLA PRIMARIA,4,12,12,0,0,0
202223,SSPS00500N,SCUOLA SECONDARIA II GRADO,3,2,2,0,0,0
202223,CT1MHE500T,SCUOLA SECONDARIA I GRADO,3,15,15,0,0,0
202223,TVPC01500X,SCUOLA SECONDARIA II GRADO,4,11,11,0,0,0
202223,AVTFVM500N,SCUOLA SECONDARIA II GRADO,1,7,7,0,0,0
202223,VARH00500Q,SCUOLA SECONDARIA II GRADO,1,17,16,1,0,1
202223,TOPL20500L,SCUOLA SECONDARIA II GRADO,4,19,19,0,0,0
202223,BL1E00100G,SCUOLA PRIMARIA,3,25,24,1,0,1
202223,RMPSQP500D,SCUOLA SECONDARIA II GRADO,4,30,30,0,0,0
202223,NA1E12000B,SCUOLA PRIMARIA,2,13,13,0,0,0
202223,NA1E122003,SCUOLA PRIMARIA,3,32,32,0,0,0
202223,CE1E06800N,SCUOLA PRIMARIA,2,10,10,0,0,0
202223,CE1ECZ5004,SCUOLA PRIMARIA,2,10,10,0,0,0
202223,RM1MHD500Z,SCUOLA SECONDARIA I GRADO,1,16,16,0,0,0
202223,MI1E06000B,SCUOLA PRIMARIA,5,39,36,3,1,2
202223,RM1E01700N,SCUOLA PRIMARIA,2,8,5,3,1,2
202223,SAPS975006,SCUOLA SECONDARIA II GRADO,1,2,2,0,0,0
202223,PDTF015003,SCUOLA SECONDARIA II GRADO,2,17,17,0,0,0
202223,CE1E05600B,SCUOLA PRIMARIA,2,7,7,0,0,0
202223,PT1M00100X,SCUOLA SECONDARIA I GRADO,1,20,19,1,0,1
202223,BGPSBT5004,SCUOLA SECONDARIA II GRADO,2,5,5,0,0,0
202223,CTTF04500E,SCUOLA SECONDARIA II GRADO,3,6,5,1,0,1
202223,SV1M00400G,SCUOLA SECONDARIA I GRADO,1,52,48,4,0,4
202223,MITF035002,SCUOLA SECONDARIA II GRADO,1,30,28,2,0,2
202223,BO1E014001,SCUOLA PRIMARIA,1,37,36,1,1,0
202223,MIPC10500T,SCUOLA SECONDARIA II GRADO,3,29,28,1,1,0
202223,RMRHRE5002,SCUOLA SECONDARIA II GRADO,4,12,12,0,0,0
202223,RMRFB3500L,SCUOLA SECONDARIA II GRADO,4,6,5,1,0,1
202223,NA1E11800B,SCUOLA PRIMARIA,1,19,18,1,0,1
202223,RMPC00500D,SCUOLA SECONDARIA II GRADO,2,7,7,0,0,0
202223,NAPSAV500Q,SCUOLA SECONDARIA II GRADO,2,5,5,0,0,0
202223,MI1E04300N,SCUOLA PRIMARIA,2,50,49,1,0,1
202223,NATD0C5008,SCUOLA SECONDARIA II GRADO,3,5,5,0,0,0
202223,CA1E00600X,SCUOLA PRIMARIA,2,23,19,4,3,1
202223,RN1E007001,SCUOLA PRIMARIA,5,12,9,3,1,2
202223,CSPM04500A,SCUOLA SECONDARIA II GRADO,2,10,9,1,1,0
202223,VR1E00600P,SCUOLA PRIMARIA,4,34,33,1,0,1
202223,RMPL1M500I,SCUOLA SECONDARIA II GRADO,2,10,8,2,0,2
202223,TV1E01100E,SCUOLA PRIMARIA,3,17,17,0,0,0
202223,CTTD92500V,SCUOLA SECONDARIA II GRADO,3,11,11,0,0,0
202223,TS1E007005,SCUOLA PRIMARIA,5,11,11,0,0,0
202223,LU1E00700B,SCUOLA PRIMARIA,1,14,14,0,0,0
202223,MITD52500D,SCUOLA SECONDARIA II GRADO,4,16,16,0,0,0
202223,PR1M008004,SCUOLA SECONDARIA I GRADO,3,51,50,1,1,0
202223,NATF32500G,SCUOLA SECONDARIA II GRADO,5,69,68,1,0,1
202223,BO1E01000N,SCUOLA PRIMARIA,2,25,24,1,0,1
202223,VA1E00100D,SCUOLA PRIMARIA,2,53,51,2,0,2
202223,RM1E12400N,SCUOLA PRIMARIA,4,27,27,0,0,0
202223,MI1E123009,SCUOLA PRIMARIA,1,31,28,3,1,2
202223,MIPSO8500I,SCUOLA SECONDARIA II GRADO,3,24,23,1,1,0
202223,NA1E226007,SCUOLA PRIMARIA,2,15,15,0,0,0
202223,MI1M06100C,SCUOLA SECONDARIA I GRADO,2,66,61,5,0,5
202223,SARHZG500U,SCUOLA SECONDARIA II GRADO,2,7,7,0,0,0
202223,LCPS025007,SCUOLA SECONDARIA II GRADO,5,12,12,0,0,0
202223,ALPM02500D,SCUOLA SECONDARIA II GRADO,1,12,11,1,0,1
202223,NARHR7500Q,SCUOLA SECONDARIA II GRADO,2,9,9,0,0,0
202223,PO1E00300L,SCUOLA PRIMARIA,3,38,29,9,0,9
202223,PO1E006004,SCUOLA PRIMARIA,5,25,21,4,0,4
202223,BO1E012009,SCUOLA PRIMARIA,3,56,51,5,2,3
202223,SATL04500R,SCUOLA SECONDARIA II GRADO,4,6,6,0,0,0
202223,NA1E26500T,SCUOLA PRIMARIA,4,8,8,0,0,0
202223,UDTF00500V,SCUOLA SECONDARIA II GRADO,1,51,47,4,1,3
202223,MI1E05100L,SCUOLA PRIMARIA,3,37,37,0,0,0
202223,MO1E00700Q,SCUOLA PRIMARIA,4,46,46,0,0,0
202223,BG1E01000Q,SCUOLA PRIMARIA,3,16,16,0,0,0
202223,RMPSBI5001,SCUOLA SECONDARIA II GRADO,2,23,22,1,0,1
202223,NA1E057005,SCUOLA PRIMARIA,4,15,15,0,0,0
202223,AGTF825005,SCUOLA SECONDARIA II GRADO,1,2,2,0,0,0
202223,MIPM07500B,SCUOLA SECONDARIA II GRADO,1,25,25,0,0,0
202223,FI1E06200C,SCUOLA PRIMARIA,3,47,39,8,0,8
202223,FI1M01600X,SCUOLA SECONDARIA I GRADO,2,56,53,3,0,3
202223,RM1EG8500F,SCUOLA PRIMARIA,2,19,19,0,0,0
202223,NA1E02500N,SCUOLA PRIMARIA,1,19,19,0,0,0
202223,PAPM9C5005,SCUOLA SECONDARIA II GRADO,1,33,30,3,1,2
202223,COSL035001,SCUOLA SECONDARIA II GRADO,3,50,45,5,1,4
202223,COTB01500Q,SCUOLA SECONDARIA II GRADO,4,16,11,5,1,4
202223,RMPM3G5002,SCUOLA SECONDARIA II GRADO,1,9,9,0,0,0
202223,MBPSFH500F,SCUOLA SECONDARIA II GRADO,2,14,14,0,0,0
202223,SAPMSZ500D,SCUOLA SECONDARIA II GRADO,5,66,65,1,0,1
202223,NATLT3500M,SCUOLA SECONDARIA II GRADO,3,6,6,0,0,0
202223,RA1M001001,SCUOLA SECONDARIA I GRADO,3,24,24,0,0,0
202223,RMPS8Q500R,SCUOLA SECONDARIA II GRADO,2,20,19,1,1,0
202223,FI1ECP5008,SCUOLA PRIMARIA,4,15,3,12,1,11
202223,CE1E06200P,SCUOLA PRIMARIA,5,11,11,0,0,0
202223,CETFQ95001,SCUOLA SECONDARIA II GRADO,4,8,2,6,0,6
202223,TVPM8T500U,SCUOLA SECONDARIA II GRADO,5,14,14,0,0,0
202223,BSPC12500Q,SCUOLA SECONDARIA II GRADO,4,15,15,0,0,0
202223,TVPC035005,SCUOLA SECONDARIA II GRADO,1,6,6,0,0,0
202223,CORH005002,SCUOLA SECONDARIA II GRADO,2,19,18,1,0,1
202223,RM1M06200R,SCUOLA SECONDARIA I GRADO,2,18,15,3,0,3
202223,NATL83500Z,SCUOLA SECONDARIA II GRADO,1,3,3,0,0,0
202223,MBPS40500C,SCUOLA SECONDARIA II GRADO,1,20,20,0,0,0
202223,AP1MUM500N,SCUOLA SECONDARIA I GRADO,2,35,34,1,1,0
202223,SASLFZ5001,SCUOLA SECONDARIA II GRADO,4,8,8,0,0,0
202223,NA1E064008,SCUOLA PRIMARIA,5,14,5,9,0,9
202223,NA1E08400D,SCUOLA PRIMARIA,1,30,30,0,0,0
202223,CE1E044005,SCUOLA PRIMARIA,2,19,19,0,0,0
202223,RGPMSZ500N,SCUOLA SECONDARIA II GRADO,5,4,4,0,0,0
202223,CERIDA500F,SCUOLA SECONDARIA II GRADO,4,8,8,0,0,0
202223,VI1M011003,SCUOLA SECONDARIA I GRADO,1,32,32,0,0,0
202223,CETD4C500S,SCUOLA SECONDARIA II GRADO,5,70,66,4,1,3
202223,TAPS02500A,SCUOLA SECONDARIA II GRADO,3,7,7,0,0,0
202223,FI1E019006,SCUOLA PRIMARIA,2,22,20,2,0,2
202223,SATFHG5004,SCUOLA SECONDARIA II GRADO,5,67,66,1,1,0
202223,GEPC07500D,SCUOLA SECONDARIA II GRADO,5,29,29,0,0,0
202223,PATD475004,SCUOLA SECONDARIA II GRADO,3,4,4,0,0,0
202223,CO1E00300B,SCUOLA PRIMARIA,4,40,38,2,1,1
202223,AR1E006008,SCUOLA PRIMARIA,2,13,9,4,1,3
202223,SATFCA5002,SCUOLA SECONDARIA II GRADO,3,4,4,0,0,0
202223,MIPS79500P,SCUOLA SECONDARIA II GRADO,3,6,6,0,0,0
202223,PVRFL2500T,SCUOLA SECONDARIA II GRADO,1,5,3,2,1,1
202223,RMPS49500G,SCUOLA SECONDARIA II GRADO,5,36,36,0,0,0
202223,TV1E019005,SCUOLA PRIMARIA,4,15,15,0,0,0
202223,VAPLB6500A,SCUOLA SECONDARIA II GRADO,3,16,16,0,0,0
202223,VA1E008008,SCUOLA PRIMARIA,1,28,28,0,0,0
202223,NARFA35009,SCUOLA SECONDARIA II GRADO,3,3,3,0,0,0
202223,VAPS5H500H,SCUOLA SECONDARIA II GRADO,2,25,24,1,0,1
202223,CTPL00500R,SCUOLA SECONDARIA II GRADO,1,4,2,2,0,2
202223,VE1E00400B,SCUOLA PRIMARIA,3,47,35,12,0,12
202223,VATFQS5007,SCUOLA SECONDARIA II GRADO,5,26,25,1,0,1
202223,FI1E01700E,SCUOLA PRIMARIA,1,31,26,5,0,5
202223,NATF2E500L,SCUOLA SECONDARIA II GRADO,1,7,7,0,0,0
202223,APPSZ65005,SCUOLA SECONDARIA II GRADO,4,27,26,1,1,0
202223,VAPSZC500T,SCUOLA SECONDARIA II GRADO,4,41,41,0,0,0
202223,MC1EMU5009,SCUOLA PRIMARIA,4,16,15,1,0,1
202223,AR1E00400L,SCUOLA PRIMARIA,1,20,20,0,0,0
202223,PA1E007001,SCUOLA PRIMARIA,1,15,15,0,0,0
202223,RM1E09700E,SCUOLA PRIMARIA,2,44,43,1,1,0
202223,RE1M00100B,SCUOLA SECONDARIA I GRADO,3,24,24,0,0,0
202223,RM1M003001,SCUOLA SECONDARIA I GRADO,3,34,33,1,0,1
202223,SATDH85000,SCUOLA SECONDARIA II GRADO,2,2,2,0,0,0
202223,LC1E003005,SCUOLA PRIMARIA,4,26,26,0,0,0
202223,RM1E198007,SCUOLA PRIMARIA,4,19,19,0,0,0
202223,PA1EC8500U,SCUOLA PRIMARIA,5,19,19,0,0,0
202223,AVTFN9500H,SCUOLA SECONDARIA II GRADO,3,4,4,0,0,0
202223,NATF25500E,SCUOLA SECONDARIA II GRADO,3,9,9,0,0,0
202223,FIPS02500P,SCUOLA SECONDARIA II GRADO,2,7,7,0,0,0
202223,APTFI65001,SCUOLA SECONDARIA II GRADO,4,3,2,1,0,1
202223,MITNUQ500H,SCUOLA SECONDARIA II GRADO,4,35,35,0,0,0
202223,SAPME1500D,SCUOLA SECONDARIA II GRADO,5,62,60,2,0,2
202223,NA1E185006,SCUOLA PRIMARIA,2,20,20,0,0,0
202223,RMPSHQ500O,SCUOLA SECONDARIA II GRADO,5,23,22,1,0,1
202223,NO1M01200Q,SCUOLA SECONDARIA I GRADO,3,24,23,1,1,0
202223,VI1M01300P,SCUOLA SECONDARIA I GRADO,2,26,25,1,0,1
202223,BOPS02500L,SCUOLA SECONDARIA II GRADO,1,10,10,0,0,0
202223,PA1E035005,SCUOLA PRIMARIA,5,59,59,0,0,0
202223,BS1M012005,SCUOLA SECONDARIA I GRADO,2,26,26,0,0,0
202223,TOPS07500A,SCUOLA SECONDARIA II GRADO,2,15,12,3,0,3
202223,AVTF1Q5009,SCUOLA SECONDARIA II GRADO,3,8,8,0,0,0
202223,NATDGE5008,SCUOLA SECONDARIA II GRADO,4,8,8,0,0,0
202223,RM1E14500P,SCUOLA PRIMARIA,4,12,12,0,0,0
202223,TOPQ04500Q,SCUOLA SECONDARIA II GRADO,4,26,26,0,0,0
202223,ENRHA05008,SCUOLA SECONDARIA II GRADO,3,7,7,0,0,0
202223,VRPS01500P,SCUOLA SECONDARIA II GRADO,1,33,28,5,0,5
202223,VRPM27500E,SCUOLA SECONDARIA II GRADO,2,24,23,1,0,1
202223,VATB01500D,SCUOLA SECONDARIA II GRADO,3,19,18,1,0,1
202223,PD1E01400X,SCUOLA PRIMARIA,2,23,22,1,0,1
202223,NA1E08900L,SCUOLA PRIMARIA,2,17,17,0,0,0
202223,RMPS165005,SCUOLA SECONDARIA II GRADO,1,7,7,0,0,0
202223,MI1M07800T,SCUOLA SECONDARIA I GRADO,1,93,92,1,0,1
202223,MI1EGH5005,SCUOLA PRIMARIA,4,30,30,0,0,0
202223,MB1E032004,SCUOLA PRIMARIA,3,14,14,0,0,0
202223,NAPC08500B,SCUOLA SECONDARIA II GRADO,3,29,29,0,0,0
202223,LE1E00600T,SCUOLA PRIMARIA,4,14,13,1,1,0
202223,MCTD00500B,SCUOLA SECONDARIA II GRADO,2,2,0,2,0,2
202223,NAPMTL5004,SCUOLA SECONDARIA II GRADO,5,63,61,2,1,1
202223,PAPSIU5009,SCUOLA SECONDARIA II GRADO,1,7,7,0,0,0
202223,PR1M00600C,SCUOLA SECONDARIA I GRADO,1,42,41,1,1,0
202223,CTPSQC5001,SCUOLA SECONDARIA II GRADO,3,3,3,0,0,0
202223,BNTD02500Q,SCUOLA SECONDARIA II GRADO,5,11,11,0,0,0
202223,RMPL325007,SCUOLA SECONDARIA II GRADO,4,13,11,2,1,1
202223,PCPSD7500T,SCUOLA SECONDARIA II GRADO,4,32,32,0,0,0
202223,RM1M04600V,SCUOLA SECONDARIA I GRADO,2,46,44,2,0,2
202223,NA1E22300Q,SCUOLA PRIMARIA,5,49,49,0,0,0
202223,BG1E01100G,SCUOLA PRIMARIA,3,14,14,0,0,0
202223,NA1E156006,SCUOLA PRIMARIA,2,10,6,4,0,4
202223,NATD33500X,SCUOLA SECONDARIA II GRADO,2,18,16,2,0,2
202223,GE1E00800L,SCUOLA PRIMARIA,4,17,17,0,0,0
202223,ALPS005007,SCUOLA SECONDARIA II GRADO,4,6,5,1,1,0
202223,SA1E00700E,SCUOLA PRIMARIA,1,9,9,0,0,0
202223,PD1E01700B,SCUOLA PRIMARIA,4,22,20,2,0,2
202223,CTPL075003,SCUOLA SECONDARIA II GRADO,1,3,3,0,0,0
202223,FI1E00300L,SCUOLA PRIMARIA,3,19,18,1,0,1
202223,BGPM15500V,SCUOLA SECONDARIA II GRADO,5,19,18,1,0,1
202223,VR1E01500D,SCUOLA PRIMARIA,5,28,25,3,0,3
202223,RMPMPL5008,SCUOLA SECONDARIA II GRADO,2,6,6,0,0,0
202223,CO1M01500V,SCUOLA SECONDARIA I GRADO,1,55,53,2,1,1
202223,RMPL39500D,SCUOLA SECONDARIA II GRADO,5,16,15,1,1,0
202223,RCRI015009,SCUOLA SECONDARIA II GRADO,5,35,34,1,0,1
202223,RM1M087005,SCUOLA SECONDARIA I GRADO,3,21,20,1,0,1
202223,CRPSVN500C,SCUOLA SECONDARIA II GRADO,3,26,25,1,1,0
202223,LITD02500G,SCUOLA SECONDARIA II GRADO,3,15,15,0,0,0
202223,BG1E00700X,SCUOLA PRIMARIA,3,48,48,0,0,0
202223,NARHZL500O,SCUOLA SECONDARIA II GRADO,4,2,2,0,0,0
202223,RM1E19500Q,SCUOLA PRIMARIA,4,30,26,4,0,4
202223,SATD125002,SCUOLA SECONDARIA II GRADO,2,5,5,0,0,0
202223,GE1E012008,SCUOLA PRIMARIA,4,18,17,1,0,1
202223,PG1E00200V,SCUOLA PRIMARIA,5,18,18,0,0,0
202223,SA1E018001,SCUOLA PRIMARIA,1,8,8,0,0,0
202223,RMPC29500P,SCUOLA SECONDARIA II GRADO,5,22,22,0,0,0
202223,PD1E021003,SCUOLA PRIMARIA,3,16,11,5,2,3
202223,VR1M01600E,SCUOLA SECONDARIA I GRADO,3,17,15,2,0,2
202223,BGPL06500X,SCUOLA SECONDARIA II GRADO,3,11,11,0,0,0
202223,RMPMBG500A,SCUOLA SECONDARIA II GRADO,2,7,7,0,0,0
202223,BLPM01500Q,SCUOLA SECONDARIA II GRADO,4,14,14,0,0,0
202223,NA1E113008,SCUOLA PRIMARIA,1,14,14,0,0,0
202223,FIPS08500A,SCUOLA SECONDARIA II GRADO,2,19,19,0,0,0
202223,VATD05500V,SCUOLA SECONDARIA II GRADO,5,8,8,0,0,0
202223,NA1E099007,SCUOLA PRIMARIA,2,9,9,0,0,0
202223,CR1M00500B,SCUOLA SECONDARIA I GRADO,2,54,52,2,0,2
202223,BSTD01500C,SCUOLA SECONDARIA II GRADO,1,24,24,0,0,0
202223,CAPC005006,SCUOLA SECONDARIA II GRADO,1,16,15,1,0,1
202223,RMTL08500Q,SCUOLA SECONDARIA II GRADO,5,59,56,3,2,1
202223,NAPLZL5002,SCUOLA SECONDARIA II GRADO,3,16,15,1,0,1
202223,BGPSDM500A,SCUOLA SECONDARIA II GRADO,4,19,19,0,0,0
202223,MERHF3500O,SCUOLA SECONDARIA II GRADO,4,4,4,0,0,0
202223,SSTF00500Q,SCUOLA SECONDARIA II GRADO,1,1,1,0,0,0
202223,RM1E126009,SCUOLA PRIMARIA,4,21,21,0,0,0
202223,BO1E00200P,SCUOLA PRIMARIA,1,34,31,3,0,3
202223,RM1E11100G,SCUOLA PRIMARIA,5,18,18,0,0,0
202223,RMPC1A5001,SCUOLA SECONDARIA II GRADO,4,6,6,0,0,0
202223,MIPSR85009,SCUOLA SECONDARIA II GRADO,1,26,26,0,0,0
202223,RN1E00900L,SCUOLA PRIMARIA,4,25,23,2,1,1
202223,RGPM05500B,SCUOLA SECONDARIA II GRADO,3,6,6,0,0,0
202223,MB1E09100X,SCUOLA PRIMARIA,4,24,24,0,0,0
202223,NAPM29500X,SCUOLA SECONDARIA II GRADO,5,25,25,0,0,0
202223,CE1E052004,SCUOLA PRIMARIA,2,16,16,0,0,0
202223,PG1E001003,SCUOLA PRIMARIA,2,22,21,1,0,1
202223,MEPS01500B,SCUOLA SECONDARIA II GRADO,3,5,5,0,0,0
202223,TA1E00700G,SCUOLA PRIMARIA,2,24,23,1,0,1
202223,VATFE2500M,SCUOLA SECONDARIA II GRADO,5,20,19,1,0,1
202223,GEPMN4500Z,SCUOLA SECONDARIA II GRADO,2,20,20,0,0,0
202223,BNTF2A500Q,SCUOLA SECONDARIA II GRADO,3,8,7,1,0,1
202223,UD1M002009,SCUOLA SECONDARIA I GRADO,1,25,23,2,1,1
202223,NA1E20800N,SCUOLA PRIMARIA,1,12,12,0,0,0
202223,MBPL315001,SCUOLA SECONDARIA II GRADO,5,11,11,0,0,0
202223,CS1MUP500H,SCUOLA SECONDARIA I GRADO,3,30,30,0,0,0
202223,TO1E02600X,SCUOLA PRIMARIA,3,43,40,3,0,3
202223,RM1E073002,SCUOLA PRIMARIA,5,49,46,3,2,1
202223,AN1E00500L,SCUOLA PRIMARIA,5,1,1,0,0,0
202223,SA1E020001,SCUOLA PRIMARIA,3,15,15,0,0,0
202223,VV1E00100R,SCUOLA PRIMARIA,3,23,23,0,0,0
202223,RN1M010002,SCUOLA SECONDARIA I GRADO,1,21,16,5,1,4
202223,RM1E21000L,SCUOLA PRIMARIA,5,25,25,0,0,0
202223,BG1MV3500S,SCUOLA SECONDARIA I GRADO,1,14,13,1,0,1
202223,MI1E08100C,SCUOLA PRIMARIA,3,15,12,3,0,3
202223,NA1E052002,SCUOLA PRIMARIA,5,14,14,0,0,0
202223,CTTD01500C,SCUOLA SECONDARIA II GRADO,3,3,3,0,0,0
202223,PDPS00500A,SCUOLA SECONDARIA II GRADO,3,25,25,0,0,0
202223,GE1E03100N,SCUOLA PRIMARIA,1,26,22,4,1,3
202223,RMPM00500N,SCUOLA SECONDARIA II GRADO,4,16,16,0,0,0
202223,MI1E090007,SCUOLA PRIMARIA,3,7,7,0,0,0
202223,BRTD04500A,SCUOLA SECONDARIA II GRADO,3,11,11,0,0,0
202223,PN1E001008,SCUOLA PRIMARIA,3,39,39,0,0,0
202223,FI1E022002,SCUOLA PRIMARIA,2,20,19,1,0,1
202223,NO1E00400G,SCUOLA PRIMARIA,1,63,61,2,0,2
202223,AL1E005002,SCUOLA PRIMARIA,5,28,26,2,1,1
202223,FIPC04500R,SCUOLA SECONDARIA II GRADO,4,2,2,0,0,0
202223,VA1E00500R,SCUOLA PRIMARIA,5,38,36,2,2,0
202223,RM1EVQ500H,SCUOLA PRIMARIA,2,26,25,1,0,1
202223,BG1M023003,SCUOLA SECONDARIA I GRADO,1,19,19,0,0,0
202223,TVPL08500G,SCUOLA SECONDARIA II GRADO,1,14,14,0,0,0
202223,NA1E04600P,SCUOLA PRIMARIA,3,16,14,2,1,1
202223,NA1E25800P,SCUOLA PRIMARIA,3,24,18,6,2,4
202223,COPCCE5008,SCUOLA SECONDARIA II GRADO,2,16,14,2,0,2
202223,CE1E008002,SCUOLA PRIMARIA,2,19,19,0,0,0
202223,FE1ME9500R,SCUOLA SECONDARIA I GRADO,2,27,24,3,1,2
202223,MI1E053008,SCUOLA PRIMARIA,4,80,80,0,0,0
202223,MNPC015004,SCUOLA SECONDARIA II GRADO,2,5,5,0,0,0
202223,CA1E00600X,SCUOLA PRIMARIA,3,16,16,0,0,0
202223,SAPS8F500U,SCUOLA SECONDARIA II GRADO,5,51,51,0,0,0
202223,PDPS77500P,SCUOLA SECONDARIA II GRADO,4,44,43,1,0,1
202223,VIPL02500Q,SCUOLA SECONDARIA II GRADO,3,12,10,2,1,1
202223,RM1M00900X,SCUOLA SECONDARIA I GRADO,2,25,22,3,2,1
202223,NARFGU5004,SCUOLA SECONDARIA II GRADO,3,3,3,0,0,0
202223,METDP0500I,SCUOLA SECONDARIA II GRADO,4,4,4,0,0,0
202223,MI1M104005,SCUOLA SECONDARIA I GRADO,2,26,25,1,0,1
202223,NATFI55003,SCUOLA SECONDARIA II GRADO,5,135,131,4,0,4
202223,NA1E241009,SCUOLA PRIMARIA,3,9,9,0,0,0
202223,RM1E121006,SCUOLA PRIMARIA,5,51,51,0,0,0
202223,SATF5C5002,SCUOLA SECONDARIA II GRADO,2,2,2,0,0,0
202223,UD1E002004,SCUOLA PRIMARIA,3,15,13,2,2,0
202223,APPS3R5004,SCUOLA SECONDARIA II GRADO,4,4,4,0,0,0
202223,NA1MUL500P,SCUOLA SECONDARIA I GRADO,3,14,11,3,0,3
202223,MI1E020001,SCUOLA PRIMARIA,5,67,65,2,0,2
202223,TV1E00700V,SCUOLA PRIMARIA,1,16,16,0,0,0
202223,RMPL00500B,SCUOLA SECONDARIA II GRADO,3,10,10,0,0,0
202223,PE1E002008,SCUOLA PRIMARIA,2,23,23,0,0,0
202223,CTTD215006,SCUOLA SECONDARIA II GRADO,3,5,5,0,0,0
202223,ME1E00400Q,SCUOLA PRIMARIA,3,13,13,0,0,0
202223,MIPSZS500P,SCUOLA SECONDARIA II GRADO,2,13,13,0,0,0
202223,VE1E00800P,SCUOLA PRIMARIA,3,20,20,0,0,0
202223,BSPS125004,SCUOLA SECONDARIA II GRADO,2,13,13,0,0,0
202223,BSPSL9500N,SCUOLA SECONDARIA II GRADO,3,16,16,0,0,0
202223,VAPS785001,SCUOLA SECONDARIA II GRADO,3,14,14,0,0,0
202223,COPM02500E,SCUOLA SECONDARIA II GRADO,4,27,26,1,0,1
202223,BG1E02000A,SCUOLA PRIMARIA,2,24,24,0,0,0
202223,RMTA1T500M,SCUOLA SECONDARIA II GRADO,5,23,22,1,0,1
202223,MIPSEN500E,SCUOLA SECONDARIA II GRADO,5,62,62,0,0,0
202223,MB1M02100V,SCUOLA SECONDARIA I GRADO,2,111,110,1,1,0
202223,VI1E00400P,SCUOLA PRIMARIA,1,22,21,1,1,0
202223,SATAIC500V,SCUOLA SECONDARIA II GRADO,4,1,1,0,0,0
202223,LCPC00500V,SCUOLA SECONDARIA II GRADO,2,10,10,0,0,0
202223,MI1E017005,SCUOLA PRIMARIA,4,64,62,2,0,2
202223,REPM01500A,SCUOLA SECONDARIA II GRADO,2,12,12,0,0,0
202223,FR1M00200A,SCUOLA SECONDARIA I GRADO,2,43,43,0,0,0
202223,TS1E008001,SCUOLA PRIMARIA,3,16,16,0,0,0
202223,RM1E00300Q,SCUOLA PRIMARIA,4,46,46,0,0,0
202223,NARH05500C,SCUOLA SECONDARIA II GRADO,3,1,1,0,0,0
202223,RM1EG8500F,SCUOLA PRIMARIA,1,42,40,2,1,1
202223,NA1EPH500O,SCUOLA PRIMARIA,3,24,24,0,0,0
202223,MO1E013003,SCUOLA PRIMARIA,4,17,17,0,0,0
202223,TORI46500C,SCUOLA SECONDARIA II GRADO,5,13,13,0,0,0
202223,PGPS00500G,SCUOLA SECONDARIA II GRADO,1,15,15,0,0,0
202223,TOPST1500C,SCUOLA SECONDARIA II GRADO,1,17,17,0,0,0
202223,MI1E00500V,SCUOLA PRIMARIA,2,28,26,2,1,1
202223,RMPS36500V,SCUOLA SECONDARIA II GRADO,1,11,11,0,0,0
202223,AL1E004006,SCUOLA PRIMARIA,2,19,19,0,0,0
202223,BO1E01600L,SCUOLA PRIMARIA,5,49,47,2,1,1
202223,BOPL02500B,SCUOLA SECONDARIA II GRADO,5,23,20,3,0,3
202223,FI1ECP5008,SCUOLA PRIMARIA,5,19,4,15,2,13
202223,PA1E04000L,SCUOLA PRIMARIA,4,25,25,0,0,0
202223,RC1M00400N,SCUOLA SECONDARIA I GRADO,3,14,14,0,0,0
202223,RMPSV5500M,SCUOLA SECONDARIA II GRADO,5,37,33,4,0,4
202223,NA1E11800B,SCUOLA PRIMARIA,3,14,14,0,0,0
202223,CE1E066002,SCUOLA PRIMARIA,3,19,19,0,0,0
202223,PD1E00900C,SCUOLA PRIMARIA,2,19,19,0,0,0
202223,FGRHSR500L,SCUOLA SECONDARIA II GRADO,1,11,7,4,1,3
202223,RM1M02600N,SCUOLA SECONDARIA I GRADO,3,30,29,1,0,1
202223,RMPSAD500D,SCUOLA SECONDARIA II GRADO,1,22,21,1,0,1
202223,MI1M03600Q,SCUOLA SECONDARIA I GRADO,3,21,20,1,0,1
202223,SRPM475001,SCUOLA SECONDARIA II GRADO,5,17,17,0,0,0
202223,BO1M00800V,SCUOLA SECONDARIA I GRADO,3,52,52,0,0,0
202223,NA1E19700C,SCUOLA PRIMARIA,3,20,20,0,0,0
202223,MIPMRI500E,SCUOLA SECONDARIA II GRADO,1,87,84,3,1,2
202223,TS1E00300T,SCUOLA PRIMARIA,3,21,21,0,0,0
202223,MEPS045007,SCUOLA SECONDARIA II GRADO,3,6,6,0,0,0
202223,PA1E034009,SCUOLA PRIMARIA,5,17,17,0,0,0
202223,PA1E4O500T,SCUOLA PRIMARIA,4,10,10,0,0,0
202223,BO1E005006,SCUOLA PRIMARIA,1,25,25,0,0,0
202223,NAPMUF500A,SCUOLA SECONDARIA II GRADO,5,105,101,4,2,2
202223,NAPS065009,SCUOLA SECONDARIA II GRADO,2,5,5,0,0,0
202223,RM1M05100A,SCUOLA SECONDARIA I GRADO,3,26,25,1,0,1
202223,RMPMT8500D,SCUOLA SECONDARIA II GRADO,1,6,5,1,1,0
202223,MOTD04500G,SCUOLA SECONDARIA II GRADO,5,29,28,1,0,1
202223,NA1E006008,SCUOLA PRIMARIA,4,23,21,2,0,2
202223,PVPM025004,SCUOLA SECONDARIA II GRADO,2,15,14,1,0,1
202223,CHTD07500E,SCUOLA SECONDARIA II GRADO,2,4,4,0,0,0
202223,CA1E012007,SCUOLA PRIMARIA,1,21,21,0,0,0
202223,MI1E14200P,SCUOLA PRIMARIA,2,52,52,0,0,0
202223,MI1M03000R,SCUOLA SECONDARIA I GRADO,1,116,115,1,0,1
202223,PASD005001,SCUOLA SECONDARIA II GRADO,4,52,52,0,0,0
202223,CZ1E00400N,SCUOLA PRIMARIA,2,7,6,1,1,0
202223,MITDOT5002,SCUOLA SECONDARIA II GRADO,4,10,10,0,0,0
202223,PO1E01700E,SCUOLA PRIMARIA,5,12,5,7,0,7
202223,PR1E007003,SCUOLA PRIMARIA,2,16,16,0,0,0
202223,PA1E03900C,SCUOLA PRIMARIA,1,21,21,0,0,0
202223,VATFQS5007,SCUOLA SECONDARIA II GRADO,4,22,22,0,0,0
202223,FI1E01700E,SCUOLA PRIMARIA,2,27,26,1,0,1
202223,AVTD06500A,SCUOLA SECONDARIA II GRADO,3,4,4,0,0,0
202223,BGTB015001,SCUOLA SECONDARIA II GRADO,5,64,61,3,1,2
202223,MIPSD2500P,SCUOLA SECONDARIA II GRADO,1,18,18,0,0,0
202223,RMPS265002,SCUOLA SECONDARIA II GRADO,4,26,26,0,0,0
202223,RMPS235006,SCUOLA SECONDARIA II GRADO,5,20,20,0,0,0
202223,PV1MPM500O,SCUOLA SECONDARIA I GRADO,1,22,22,0,0,0
202223,PVPS1S500G,SCUOLA SECONDARIA II GRADO,1,6,5,1,0,1
202223,MI1E8P5009,SCUOLA PRIMARIA,2,10,7,3,1,2
202223,RM1E04600N,SCUOLA PRIMARIA,1,12,11,1,0,1
202223,SR1E00600R,SCUOLA PRIMARIA,3,10,10,0,0,0
202223,LCPS025007,SCUOLA SECONDARIA II GRADO,1,9,9,0,0,0
202223,LE1E00200E,SCUOLA PRIMARIA,3,49,49,0,0,0
202223,CE1E04100N,SCUOLA PRIMARIA,4,14,14,0,0,0
202223,TV1E018009,SCUOLA PRIMARIA,4,15,15,0,0,0
202223,CERHZ85003,SCUOLA SECONDARIA II GRADO,4,11,11,0,0,0
202223,CTTD045008,SCUOLA SECONDARIA II GRADO,4,4,4,0,0,0
202223,NARHV2500V,SCUOLA SECONDARIA II GRADO,5,24,24,0,0,0
202223,TO1M018006,SCUOLA SECONDARIA I GRADO,1,31,30,1,0,1
202223,FI1E00900G,SCUOLA PRIMARIA,5,20,17,3,0,3
202223,VT1E001006,SCUOLA PRIMARIA,1,23,21,2,1,1
202223,TO1MNU500Z,SCUOLA SECONDARIA I GRADO,2,14,14,0,0,0
202223,VAPSDE500S,SCUOLA SECONDARIA II GRADO,3,26,26,0,0,0
202223,NOTD035008,SCUOLA SECONDARIA II GRADO,2,1,1,0,0,0
202223,AT1M00200R,SCUOLA SECONDARIA I GRADO,1,19,18,1,0,1
202223,CEPS875001,SCUOLA SECONDARIA II GRADO,5,13,13,0,0,0
202223,LI1E00800R,SCUOLA PRIMARIA,3,12,10,2,0,2
202223,VEPMLV5000,SCUOLA SECONDARIA II GRADO,1,26,25,1,0,1
202223,PT1E00200E,SCUOLA PRIMARIA,1,16,15,1,0,1
202223,MIPM58500Q,SCUOLA SECONDARIA II GRADO,5,15,15,0,0,0
202223,BOPS02500L,SCUOLA SECONDARIA II GRADO,2,22,22,0,0,0
202223,SA1E01000A,SCUOLA PRIMARIA,2,14,14,0,0,0
202223,LTTA335002,SCUOLA SECONDARIA II GRADO,1,3,3,0,0,0
202223,AGPC4A5009,SCUOLA SECONDARIA II GRADO,2,2,2,0,0,0
202223,NATF2C500R,SCUOLA SECONDARIA II GRADO,3,4,3,1,1,0
202223,NOPSUI500C,SCUOLA SECONDARIA II GRADO,4,5,5,0,0,0
202223,NA1E085009,SCUOLA PRIMARIA,5,20,20,0,0,0
202223,BSTN01500A,SCUOLA SECONDARIA II GRADO,1,3,1,2,1,1
202223,CS1E002006,SCUOLA PRIMARIA,4,16,16,0,0,0
202223,NATNIZ500M,SCUOLA SECONDARIA II GRADO,1,14,14,0,0,0
202223,LIPL035005,SCUOLA SECONDARIA II GRADO,1,8,8,0,0,0
202223,MI1EGH5005,SCUOLA PRIMARIA,5,24,24,0,0,0
202223,TOPSA6500N,SCUOLA SECONDARIA II GRADO,3,9,8,1,1,0
202223,FI1E02400N,SCUOLA PRIMARIA,4,16,15,1,0,1
202223,NA1E01000X,SCUOLA PRIMARIA,4,18,10,8,1,7
202223,TARF2M500U,SCUOLA SECONDARIA II GRADO,4,4,4,0,0,0
202223,VRPS055005,SCUOLA SECONDARIA II GRADO,5,53,52,1,0,1
202223,TOPM09500L,SCUOLA SECONDARIA II GRADO,3,16,15,1,0,1
202223,NA1E24000D,SCUOLA PRIMARIA,3,10,10,0,0,0
202223,RM1E14100B,SCUOLA PRIMARIA,2,26,26,0,0,0
202223,BNTDC1500F,SCUOLA SECONDARIA II GRADO,1,2,1,1,0,1
202223,CZ1M002007,SCUOLA SECONDARIA I GRADO,1,11,8,3,0,3
202223,RM1E11800A,SCUOLA PRIMARIA,2,32,31,1,0,1
202223,NA1E148007,SCUOLA PRIMARIA,3,11,10,1,0,1
202223,NA1E10800R,SCUOLA PRIMARIA,2,35,35,0,0,0
202223,RM1M07800A,SCUOLA SECONDARIA I GRADO,1,48,46,2,0,2
202223,CT1E038004,SCUOLA PRIMARIA,5,25,23,2,0,2
202223,CT1E054002,SCUOLA PRIMARIA,2,26,21,5,0,5
202223,GEPQ015006,SCUOLA SECONDARIA II GRADO,4,9,9,0,0,0
202223,NA1E09100L,SCUOLA PRIMARIA,4,19,19,0,0,0
202223,RM1M143008,SCUOLA SECONDARIA I GRADO,3,16,15,1,0,1
202223,NAPSNL500R,SCUOLA SECONDARIA II GRADO,4,23,23,0,0,0
202223,LI1E005009,SCUOLA PRIMARIA,4,41,39,2,1,1
202223,RN1E00200T,SCUOLA PRIMARIA,4,18,17,1,0,1
202223,SARHB65008,SCUOLA SECONDARIA II GRADO,1,6,5,1,0,1
202223,MB1E03400Q,SCUOLA PRIMARIA,3,41,39,2,0,2
202223,RMPC525003,SCUOLA SECONDARIA II GRADO,2,17,17,0,0,0
202223,PE1E00600G,SCUOLA PRIMARIA,1,24,23,1,0,1
202223,PAPS00500E,SCUOLA SECONDARIA II GRADO,5,45,45,0,0,0
202223,CE1E029003,SCUOLA PRIMARIA,2,12,9,3,1,2
202223,NATF91500F,SCUOLA SECONDARIA II GRADO,5,90,90,0,0,0
202223,MI1E083004,SCUOLA PRIMARIA,1,69,65,4,1,3
202223,NA1E14600G,SCUOLA PRIMARIA,2,27,27,0,0,0
202223,MI1E088007,SCUOLA PRIMARIA,2,43,39,4,0,4
202223,VRPS055005,SCUOLA SECONDARIA II GRADO,1,61,61,0,0,0
202223,CT1E031009,SCUOLA PRIMARIA,4,6,6,0,0,0
202223,PA1E02000B,SCUOLA PRIMARIA,4,15,14,1,0,1
202223,NAPS265003,SCUOLA SECONDARIA II GRADO,1,6,6,0,0,0
202223,MB1M026002,SCUOLA SECONDARIA I GRADO,2,46,44,2,0,2
202223,NATHES5002,SCUOLA SECONDARIA II GRADO,4,3,3,0,0,0
202223,RM1E18300D,SCUOLA PRIMARIA,3,15,15,0,0,0
202223,VT1M00500P,SCUOLA SECONDARIA I GRADO,3,20,20,0,0,0
202223,VR1M01600E,SCUOLA SECONDARIA I GRADO,2,12,8,4,0,4
202223,TO1M01400V,SCUOLA SECONDARIA I GRADO,2,32,31,1,0,1
202223,NA1E03900G,SCUOLA PRIMARIA,3,37,34,3,0,3
202223,VATN01500A,SCUOLA SECONDARIA II GRADO,4,13,13,0,0,0
202223,BGPL06500X,SCUOLA SECONDARIA II GRADO,4,11,11,0,0,0
202223,CO1M019006,SCUOLA SECONDARIA I GRADO,3,52,51,1,0,1
202223,CO1M02500D,SCUOLA SECONDARIA I GRADO,2,28,28,0,0,0
202223,CE1E001007,SCUOLA PRIMARIA,2,6,6,0,0,0
202223,FIPMP9500U,SCUOLA SECONDARIA II GRADO,2,13,12,1,1,0
202223,RMPLCV500U,SCUOLA SECONDARIA II GRADO,2,3,2,1,1,0
202223,AQ1E00700D,SCUOLA PRIMARIA,4,28,28,0,0,0
202223,NATDBQ500Q,SCUOLA SECONDARIA II GRADO,5,70,66,4,0,4
202223,RC1M00300T,SCUOLA SECONDARIA I GRADO,1,16,15,1,0,1
202223,CR1M00500B,SCUOLA SECONDARIA I GRADO,3,53,50,3,3,0
202223,MB1M01900V,SCUOLA SECONDARIA I GRADO,1,66,64,2,1,1
202223,SAPL025004,SCUOLA SECONDARIA II GRADO,1,5,5,0,0,0
202223,MO1MSQ500N,SCUOLA SECONDARIA I GRADO,3,11,10,1,0,1
202223,PGRF8G5009,SCUOLA SECONDARIA II GRADO,5,13,13,0,0,0
202223,NA1E06100R,SCUOLA PRIMARIA,3,16,15,1,0,1
202223,TO1E03400V,SCUOLA PRIMARIA,2,44,42,2,0,2
202223,GE1E01400X,SCUOLA PRIMARIA,2,21,20,1,0,1
202223,REPSRL500H,SCUOLA SECONDARIA II GRADO,1,20,19,1,0,1
202223,MERHF3500O,SCUOLA SECONDARIA II GRADO,5,32,29,3,2,1
202223,VR1M02200T,SCUOLA SECONDARIA I GRADO,1,26,26,0,0,0
202223,BGPC02500G,SCUOLA SECONDARIA II GRADO,1,12,12,0,0,0
202223,BSPM6Z500C,SCUOLA SECONDARIA II GRADO,3,16,15,1,1,0
202223,NA1E03700X,SCUOLA PRIMARIA,2,39,39,0,0,0
202223,TV1M014007,SCUOLA SECONDARIA I GRADO,2,25,25,0,0,0
202223,SATLCL500F,SCUOLA SECONDARIA II GRADO,4,8,8,0,0,0
202223,CO1M013007,SCUOLA SECONDARIA I GRADO,1,51,51,0,0,0
202223,CAPS02500E,SCUOLA SECONDARIA II GRADO,3,11,11,0,0,0
202223,RMPMBG500A,SCUOLA SECONDARIA II GRADO,1,15,14,1,0,1
202223,NA1E27400L,SCUOLA PRIMARIA,3,55,55,0,0,0
202223,UDPS0G500U,SCUOLA SECONDARIA II GRADO,2,23,22,1,0,1
202223,FIPS08500A,SCUOLA SECONDARIA II GRADO,4,18,17,1,0,1
202223,BA1E005007,SCUOLA PRIMARIA,2,18,18,0,0,0
202223,MO1E004008,SCUOLA PRIMARIA,5,27,27,0,0,0
202223,CRPC035004,SCUOLA SECONDARIA II GRADO,4,16,16,0,0,0
202223,BATD07500E,SCUOLA SECONDARIA II GRADO,2,16,16,0,0,0
202223,BG1E01200B,SCUOLA PRIMARIA,4,35,35,0,0,0
202223,CA1EUL5004,SCUOLA PRIMARIA,3,9,9,0,0,0
202223,AGPSCE5001,SCUOLA SECONDARIA II GRADO,3,5,5,0,0,0
202223,NAPSZI500L,SCUOLA SECONDARIA II GRADO,5,26,25,1,0,1
202223,TO1E03600E,SCUOLA PRIMARIA,3,46,27,19,7,12
202223,VI1M00400X,SCUOLA SECONDARIA I GRADO,2,25,25,0,0,0
202223,VA1E02100P,SCUOLA PRIMARIA,1,103,99,4,0,4
202223,MEPM12500X,SCUOLA SECONDARIA II GRADO,4,3,3,0,0,0
202223,VI1E007006,SCUOLA PRIMARIA,2,22,21,1,1,0
202223,SSTD02500P,SCUOLA SECONDARIA II GRADO,1,3,3,0,0,0
202223,CT1ELO5000,SCUOLA PRIMARIA,2,21,20,1,1,0
202223,RM1E15400D,SCUOLA PRIMARIA,4,11,10,1,1,0
202223,MIPL0Z500D,SCUOLA SECONDARIA II GRADO,5,19,19,0,0,0
202223,MIPLVI500L,SCUOLA SECONDARIA II GRADO,4,31,30,1,1,0
202223,MBPSUD500O,SCUOLA SECONDARIA II GRADO,4,24,24,0,0,0
202223,BG1E03200L,SCUOLA PRIMARIA,5,47,46,1,1,0
202223,MIPSOC500H,SCUOLA SECONDARIA II GRADO,4,6,5,1,0,1
202223,SAPS07500A,SCUOLA SECONDARIA II GRADO,5,13,13,0,0,0
202223,BA1E014002,SCUOLA PRIMARIA,1,11,11,0,0,0
202223,PV1E00900X,SCUOLA PRIMARIA,4,26,26,0,0,0
202223,TATD08500T,SCUOLA SECONDARIA II GRADO,4,22,22,0,0,0
202223,NA1E17500G,SCUOLA PRIMARIA,1,7,3,4,1,3
202223,RA1E004007,SCUOLA PRIMARIA,2,57,51,6,0,6
202223,VA1M01500L,SCUOLA SECONDARIA I GRADO,1,75,75,0,0,0
202223,BGRF2Q5004,SCUOLA SECONDARIA II GRADO,5,20,19,1,0,1
202223,FITF265001,SCUOLA SECONDARIA II GRADO,1,10,8,2,0,2
202223,VB1E00300Q,SCUOLA PRIMARIA,1,23,21,2,0,2
202223,VAPS025007,SCUOLA SECONDARIA II GRADO,3,16,16,0,0,0
202223,BSPSB05000,SCUOLA SECONDARIA II GRADO,3,5,4,1,0,1
202223,BS1M6C500D,SCUOLA SECONDARIA I GRADO,1,43,39,4,0,4
202223,NATFPQ500Q,SCUOLA SECONDARIA II GRADO,5,137,133,4,0,4
202223,NA1E12900T,SCUOLA PRIMARIA,5,19,19,0,0,0
202223,PATD91500R,SCUOLA SECONDARIA II GRADO,2,5,5,0,0,0
202223,ATRI02500P,SCUOLA SECONDARIA II GRADO,2,10,5,5,0,5
202223,BG1E02900R,SCUOLA PRIMARIA,4,92,90,2,1,1
202223,TO1E009006,SCUOLA PRIMARIA,3,23,22,1,1,0
202223,NA1E165001,SCUOLA PRIMARIA,2,11,11,0,0,0
202223,MI1E01500D,SCUOLA PRIMARIA,5,40,35,5,0,5
202223,CSPM03500Q,SCUOLA SECONDARIA II GRADO,4,9,7,2,0,2
202223,MIPS04500E,SCUOLA SECONDARIA II GRADO,1,19,16,3,1,2
202223,FITF265001,SCUOLA SECONDARIA II GRADO,5,11,9,2,0,2
202223,LU1M7F5008,SCUOLA SECONDARIA I GRADO,3,7,7,0,0,0
202223,CTPM315008,SCUOLA SECONDARIA II GRADO,3,10,9,1,1,0
202223,PD1M01100N,SCUOLA SECONDARIA I GRADO,3,48,46,2,1,1
202223,FG1E024001,SCUOLA PRIMARIA,5,11,8,3,2,1
202223,BS1E002009,SCUOLA PRIMARIA,1,24,21,3,0,3
202223,RMTD55500T,SCUOLA SECONDARIA II GRADO,1,3,2,1,0,1
202223,RM1E177006,SCUOLA PRIMARIA,3,10,10,0,0,0
202223,VEPL01500T,SCUOLA SECONDARIA II GRADO,1,5,5,0,0,0
202223,SRPS52500Q,SCUOLA SECONDARIA II GRADO,3,8,7,1,0,1
202223,MI1E012002,SCUOLA PRIMARIA,1,25,21,4,1,3
202223,RE1E00300T,SCUOLA PRIMARIA,2,37,35,2,0,2
202223,VA1E010008,SCUOLA PRIMARIA,2,24,23,1,1,0
202223,NARFZO500E,SCUOLA SECONDARIA II GRADO,2,14,14,0,0,0
202223,IM1E00500L,SCUOLA PRIMARIA,3,20,17,3,2,1
202223,VE1M001005,SCUOLA SECONDARIA I GRADO,1,10,9,1,0,1
202223,RM1E20200N,SCUOLA PRIMARIA,2,23,23,0,0,0
202223,CTPL145004,SCUOLA SECONDARIA II GRADO,5,9,9,0,0,0
202223,TOPS01500P,SCUOLA SECONDARIA II GRADO,1,28,24,4,2,2
202223,TOPL03500P,SCUOLA SECONDARIA II GRADO,4,45,45,0,0,0
202223,FG1E00300X,SCUOLA PRIMARIA,3,18,18,0,0,0
202223,MBRH02500X,SCUOLA SECONDARIA II GRADO,1,21,21,0,0,0
202223,BNPS12500Z,SCUOLA SECONDARIA II GRADO,2,15,15,0,0,0
202223,VARFR75004,SCUOLA SECONDARIA II GRADO,1,2,2,0,0,0
202223,RMPC185007,SCUOLA SECONDARIA II GRADO,4,24,24,0,0,0
202223,MI1E062003,SCUOLA PRIMARIA,5,40,36,4,1,3
202223,RM1M08400N,SCUOLA SECONDARIA I GRADO,3,33,29,4,1,3
202223,BATD105005,SCUOLA SECONDARIA II GRADO,2,8,8,0,0,0
202223,CA1E00800G,SCUOLA PRIMARIA,1,27,25,2,0,2
202223,RM1E02000D,SCUOLA PRIMARIA,1,25,19,6,1,5
202223,RMPSII500C,SCUOLA SECONDARIA II GRADO,4,6,6,0,0,0
202223,MIPM06500R,SCUOLA SECONDARIA II GRADO,4,15,15,0,0,0
202223,NAPMRM500O,SCUOLA SECONDARIA II GRADO,4,7,7,0,0,0
202223,CTTD215006,SCUOLA SECONDARIA II GRADO,4,6,6,0,0,0
202223,SA1E01900R,SCUOLA PRIMARIA,2,2,2,0,0,0
202223,CTTFQT500Q,SCUOLA SECONDARIA II GRADO,5,11,11,0,0,0
202223,LT1E00400C,SCUOLA PRIMARIA,4,23,22,1,0,1
202223,RM1ERB5004,SCUOLA PRIMARIA,5,13,13,0,0,0
202223,ISPM1I500P,SCUOLA SECONDARIA II GRADO,5,28,26,2,1,1
202223,PRTD02500N,SCUOLA SECONDARIA II GRADO,2,12,11,1,0,1
202223,BN1M4D5009,SCUOLA SECONDARIA I GRADO,3,17,17,0,0,0
202223,MI1E02200L,SCUOLA PRIMARIA,3,15,14,1,0,1
202223,RMPC00500D,SCUOLA SECONDARIA II GRADO,4,13,13,0,0,0
202223,NATFVB500S,SCUOLA SECONDARIA II GRADO,5,65,65,0,0,0
202223,APPSL05000,SCUOLA SECONDARIA II GRADO,2,2,2,0,0,0
202223,NA1E18200P,SCUOLA PRIMARIA,2,31,31,0,0,0
202223,LCTF66500Z,SCUOLA SECONDARIA II GRADO,4,23,23,0,0,0
202223,CTTD34500V,SCUOLA SECONDARIA II GRADO,3,10,10,0,0,0
202223,VR1E00100G,SCUOLA PRIMARIA,5,22,16,6,1,5
202223,MIRC1N500Z,SCUOLA SECONDARIA II GRADO,5,7,6,1,1,0
202223,MIRFHT500U,SCUOLA SECONDARIA II GRADO,4,26,24,2,0,2
202223,CE1E02700B,SCUOLA PRIMARIA,1,12,11,1,0,1
202223,VA1M00600T,SCUOLA SECONDARIA I GRADO,2,27,26,1,0,1
202223,NATF55500V,SCUOLA SECONDARIA II GRADO,3,4,4,0,0,0
202223,MI1E08500Q,SCUOLA PRIMARIA,5,26,26,0,0,0
202223,NA1E150007,SCUOLA PRIMARIA,2,23,23,0,0,0
202223,BS1E011004,SCUOLA PRIMARIA,5,25,25,0,0,0
202223,BS1E017003,SCUOLA PRIMARIA,1,73,71,2,0,2
202223,MI1M07300P,SCUOLA SECONDARIA I GRADO,2,92,92,0,0,0
202223,PNPS9G5000,SCUOLA SECONDARIA II GRADO,4,18,18,0,0,0
202223,LC1E010008,SCUOLA PRIMARIA,2,30,30,0,0,0
202223,SARHTF500G,SCUOLA SECONDARIA II GRADO,2,5,5,0,0,0
202223,TV1E01100E,SCUOLA PRIMARIA,4,21,17,4,0,4
202223,FR1E00600C,SCUOLA PRIMARIA,3,26,26,0,0,0
202223,PARI025001,SCUOLA SECONDARIA II GRADO,2,4,4,0,0,0
202223,PD1E020007,SCUOLA PRIMARIA,2,24,23,1,0,1
202223,SATFTV500U,SCUOLA SECONDARIA II GRADO,4,11,11,0,0,0
202223,UD1E00300X,SCUOLA PRIMARIA,5,23,23,0,0,0
202223,BS1E00600L,SCUOLA PRIMARIA,2,60,58,2,0,2
202223,NA1E21000N,SCUOLA PRIMARIA,3,22,22,0,0,0
202223,NA1E219004,SCUOLA PRIMARIA,2,20,20,0,0,0
202223,PGPSVU500T,SCUOLA SECONDARIA II GRADO,5,6,6,0,0,0
202223,TOTB005001,SCUOLA SECONDARIA II GRADO,4,15,14,1,1,0
202223,RM1E04000P,SCUOLA PRIMARIA,3,17,12,5,0,5
202223,AGTDE45003,SCUOLA SECONDARIA II GRADO,2,2,2,0,0,0
202223,SR1E3H5006,SCUOLA PRIMARIA,4,19,19,0,0,0
202223,FI1E034008,SCUOLA PRIMARIA,5,36,35,1,0,1
202223,CTSD015003,SCUOLA SECONDARIA II GRADO,4,28,26,2,1,1
202223,SS1E00400L,SCUOLA PRIMARIA,2,7,6,1,0,1
202223,CT1ET9500Z,SCUOLA PRIMARIA,2,17,17,0,0,0
202223,BG1M9L500G,SCUOLA SECONDARIA I GRADO,1,36,33,3,0,3
202223,NA1E04100G,SCUOLA PRIMARIA,4,55,55,0,0,0
202223,VR1E020001,SCUOLA PRIMARIA,4,56,47,9,2,7
202223,PAPM4U500C,SCUOLA SECONDARIA II GRADO,1,4,4,0,0,0
202223,RMPMFO500A,SCUOLA SECONDARIA II GRADO,3,18,18,0,0,0
202223,RC1E00800Q,SCUOLA PRIMARIA,3,24,23,1,0,1
202223,NA1E285003,SCUOLA PRIMARIA,3,14,14,0,0,0
202223,TOPC06500L,SCUOLA SECONDARIA II GRADO,4,22,22,0,0,0
202223,BLPSD7500D,SCUOLA SECONDARIA II GRADO,2,13,13,0,0,0
202223,MI1E02600X,SCUOLA PRIMARIA,2,26,26,0,0,0
202223,RM1M12400V,SCUOLA SECONDARIA I GRADO,2,24,23,1,0,1
202223,MI1M09300X,SCUOLA SECONDARIA I GRADO,3,46,42,4,0,4
202223,MI1E06600A,SCUOLA PRIMARIA,5,63,58,5,1,4
202223,TOTB005001,SCUOLA SECONDARIA II GRADO,1,12,8,4,2,2
202223,RM1E04100E,SCUOLA PRIMARIA,2,13,13,0,0,0
202223,SRTD06500N,SCUOLA SECONDARIA II GRADO,2,9,9,0,0,0
202223,PSPC01500G,SCUOLA SECONDARIA II GRADO,2,10,10,0,0,0
202223,FI1E03200L,SCUOLA PRIMARIA,4,19,18,1,0,1
202223,PETD03500L,SCUOLA SECONDARIA II GRADO,1,10,8,2,0,2
202223,MEPC2A500L,SCUOLA SECONDARIA II GRADO,1,2,1,1,0,1
202223,PA1E03900C,SCUOLA PRIMARIA,2,20,19,1,1,0
202223,PA1M01900C,SCUOLA SECONDARIA I GRADO,2,92,92,0,0,0
202223,NA1E23200E,SCUOLA PRIMARIA,2,10,10,0,0,0
202223,RM1E150006,SCUOLA PRIMARIA,5,16,15,1,0,1
202223,NA1E13900C,SCUOLA PRIMARIA,2,25,25,0,0,0
202223,NA1E27900Q,SCUOLA PRIMARIA,5,10,10,0,0,0
202223,BLPC01500G,SCUOLA SECONDARIA II GRADO,1,7,7,0,0,0
202223,CT1E010008,SCUOLA PRIMARIA,4,24,21,3,0,3
202223,AP1E006003,SCUOLA PRIMARIA,4,15,15,0,0,0
202223,NATN7V500I,SCUOLA SECONDARIA II GRADO,5,58,56,2,0,2
202223,CH1E006003,SCUOLA PRIMARIA,5,16,16,0,0,0
202223,CLSD00500B,SCUOLA SECONDARIA II GRADO,4,17,16,1,1,0
202223,CE1E04100N,SCUOLA PRIMARIA,5,9,7,2,0,2
202223,BGPS505007,SCUOLA SECONDARIA II GRADO,3,24,24,0,0,0
202223,BGPSQZ500T,SCUOLA SECONDARIA II GRADO,4,20,20,0,0,0
202223,NA1M26500L,SCUOLA SECONDARIA I GRADO,2,26,13,13,10,3
202223,PO1E01100G,SCUOLA PRIMARIA,1,28,27,1,0,1
202223,PR1E00200X,SCUOLA PRIMARIA,1,25,24,1,0,1
202223,VBRH155008,SCUOLA SECONDARIA II GRADO,1,7,7,0,0,0
202223,TVPS065004,SCUOLA SECONDARIA II GRADO,1,25,24,1,0,1
202223,RM1E105008,SCUOLA PRIMARIA,1,16,16,0,0,0
202223,GEPMAH500O,SCUOLA SECONDARIA II GRADO,4,21,18,3,0,3
202223,RMTAZI500E,SCUOLA SECONDARIA II GRADO,1,15,15,0,0,0
202223,RMRHZT500U,SCUOLA SECONDARIA II GRADO,4,1,1,0,0,0
202223,SATD13500L,SCUOLA SECONDARIA II GRADO,4,7,7,0,0,0
202223,MI1E125001,SCUOLA PRIMARIA,1,32,32,0,0,0
202223,PNTD7Z500U,SCUOLA SECONDARIA II GRADO,4,7,7,0,0,0
202223,MI1E01300T,SCUOLA PRIMARIA,4,40,40,0,0,0
202223,SARHE75006,SCUOLA SECONDARIA II GRADO,2,2,2,0,0,0
202223,LCTAB3500P,SCUOLA SECONDARIA II GRADO,5,10,10,0,0,0
202223,FI1M02600E,SCUOLA SECONDARIA I GRADO,1,12,12,0,0,0
202223,CERIDA500F,SCUOLA SECONDARIA II GRADO,2,8,8,0,0,0
202223,PO1EHR500Z,SCUOLA PRIMARIA,5,4,0,4,0,4
202223,BG1M02700A,SCUOLA SECONDARIA I GRADO,3,41,40,1,0,1
202223,VC1E00100P,SCUOLA PRIMARIA,3,24,23,1,0,1
202223,SATNV3500O,SCUOLA SECONDARIA II GRADO,2,5,5,0,0,0
202223,NATF545002,SCUOLA SECONDARIA II GRADO,1,5,5,0,0,0
202223,UDPSMD500L,SCUOLA SECONDARIA II GRADO,3,12,12,0,0,0
202223,FIPS04500X,SCUOLA SECONDARIA II GRADO,2,42,38,4,2,2
202223,CE1E010002,SCUOLA PRIMARIA,3,16,16,0,0,0
202223,CE1E022008,SCUOLA PRIMARIA,1,37,33,4,0,4
202223,CO1E00300B,SCUOLA PRIMARIA,2,30,30,0,0,0
202223,AR1E006008,SCUOLA PRIMARIA,1,12,11,1,0,1
202223,CSTDDC500C,SCUOLA SECONDARIA II GRADO,3,3,3,0,0,0
202223,NOPSUI500C,SCUOLA SECONDARIA II GRADO,5,11,11,0,0,0
202223,RMPS4A500Z,SCUOLA SECONDARIA II GRADO,1,24,24,0,0,0
202223,RM1E09000Q,SCUOLA PRIMARIA,5,49,49,0,0,0
202223,BOPS05500C,SCUOLA SECONDARIA II GRADO,5,26,26,0,0,0
202223,TO1E020001,SCUOLA PRIMARIA,4,21,21,0,0,0
202223,RM1E06900A,SCUOLA PRIMARIA,1,22,22,0,0,0
202223,SA1E01500D,SCUOLA PRIMARIA,3,14,14,0,0,0
202223,LTPM02500Q,SCUOLA SECONDARIA II GRADO,5,23,22,1,1,0
202223,RO1E0L5003,SCUOLA PRIMARIA,5,16,14,2,0,2
202223,RM1E21400X,SCUOLA PRIMARIA,5,9,9,0,0,0
202223,RM1E14100B,SCUOLA PRIMARIA,1,27,27,0,0,0
202223,NATD8F500U,SCUOLA SECONDARIA II GRADO,3,6,6,0,0,0
202223,TS1E001006,SCUOLA PRIMARIA,4,20,20,0,0,0
202223,MI1E05700G,SCUOLA PRIMARIA,2,48,47,1,0,1
202223,SAPMP9500T,SCUOLA SECONDARIA II GRADO,2,1,1,0,0,0
202223,LI1E005009,SCUOLA PRIMARIA,5,43,43,0,0,0
202223,SAPL65500L,SCUOLA SECONDARIA II GRADO,4,5,4,1,1,0
202223,LO1E00400P,SCUOLA PRIMARIA,5,47,46,1,0,1
202223,PZ1E002007,SCUOLA PRIMARIA,2,12,12,0,0,0
202223,RMPSE55000,SCUOLA SECONDARIA II GRADO,1,49,45,4,3,1
202223,NA1E1M500R,SCUOLA PRIMARIA,2,13,0,13,0,13
202223,TO1E05800B,SCUOLA PRIMARIA,4,23,20,3,1,2
202223,NA1E015003,SCUOLA PRIMARIA,1,10,10,0,0,0
202223,PT1E00300A,SCUOLA PRIMARIA,3,17,15,2,0,2
202223,BOPS3D500P,SCUOLA SECONDARIA II GRADO,4,9,9,0,0,0
202223,BS1M01600C,SCUOLA SECONDARIA I GRADO,2,44,42,2,0,2
202223,VAPM04500D,SCUOLA SECONDARIA II GRADO,1,20,19,1,0,1
202223,MIPC04500B,SCUOLA SECONDARIA II GRADO,2,17,17,0,0,0
202223,COTD105001,SCUOLA SECONDARIA II GRADO,1,13,11,2,2,0
202223,COTL045001,SCUOLA SECONDARIA II GRADO,5,7,7,0,0,0
202223,RM1E130001,SCUOLA PRIMARIA,3,12,11,1,0,1
202223,PATDEE500L,SCUOLA SECONDARIA II GRADO,2,2,2,0,0,0
202223,MBPSLD5004,SCUOLA SECONDARIA II GRADO,3,10,9,1,0,1
202223,BG1E02500D,SCUOLA PRIMARIA,4,47,46,1,0,1
202223,SATF6U5006,SCUOLA SECONDARIA II GRADO,3,1,1,0,0,0
202223,SAPMFG500M,SCUOLA SECONDARIA II GRADO,1,7,4,3,0,3
202223,MOPS0N500H,SCUOLA SECONDARIA II GRADO,5,25,25,0,0,0
202223,RMPS08500D,SCUOLA SECONDARIA II GRADO,4,32,30,2,1,1
202223,MO1E00200L,SCUOLA PRIMARIA,4,20,18,2,0,2
202223,CHPMVZ5007,SCUOLA SECONDARIA II GRADO,1,3,3,0,0,0
202223,RA1E00200G,SCUOLA PRIMARIA,3,30,30,0,0,0
202223,MI1M00200L,SCUOLA SECONDARIA I GRADO,2,30,30,0,0,0
202223,NAPL19500R,SCUOLA SECONDARIA II GRADO,1,19,19,0,0,0
202223,RM1E05300R,SCUOLA PRIMARIA,5,41,41,0,0,0
202223,CETF8R5001,SCUOLA SECONDARIA II GRADO,5,67,67,0,0,0
202223,BS1M005002,SCUOLA SECONDARIA I GRADO,3,77,77,0,0,0
202223,NATF37500L,SCUOLA SECONDARIA II GRADO,4,10,10,0,0,0
202223,MIPC18500P,SCUOLA SECONDARIA II GRADO,4,15,15,0,0,0
202223,PATL095008,SCUOLA SECONDARIA II GRADO,4,3,3,0,0,0
202223,VRPS01500P,SCUOLA SECONDARIA II GRADO,3,52,48,4,0,4
202223,MB1M01600B,SCUOLA SECONDARIA I GRADO,3,30,30,0,0,0
202223,BS1E01400G,SCUOLA PRIMARIA,4,23,23,0,0,0
202223,NATANI5007,SCUOLA SECONDARIA II GRADO,3,3,3,0,0,0
202223,RE1M008006,SCUOLA SECONDARIA I GRADO,2,24,23,1,1,0
202223,VT1M00500P,SCUOLA SECONDARIA I GRADO,2,11,11,0,0,0
202223,CETF01500C,SCUOLA SECONDARIA II GRADO,4,18,18,0,0,0
202223,TO1M02900L,SCUOLA SECONDARIA I GRADO,3,16,14,2,0,2
202223,BSPS075008,SCUOLA SECONDARIA II GRADO,2,45,45,0,0,0
202223,VE1E01000P,SCUOLA PRIMARIA,4,25,24,1,1,0
202223,BGPMVO500T,SCUOLA SECONDARIA II GRADO,1,22,21,1,1,0
202223,RMPLUU500N,SCUOLA SECONDARIA II GRADO,4,17,17,0,0,0
202223,RMPL48500Q,SCUOLA SECONDARIA II GRADO,5,54,50,4,1,3
202223,BG1E02400N,SCUOLA PRIMARIA,1,17,16,1,0,1
202223,RMTD00500C,SCUOLA SECONDARIA II GRADO,5,5,4,1,0,1
202223,MB1M02300E,SCUOLA SECONDARIA I GRADO,1,26,23,3,1,2
202223,RM1E043006,SCUOLA PRIMARIA,2,35,34,1,0,1
202223,GE1E01100C,SCUOLA PRIMARIA,3,23,23,0,0,0
202223,REPM3F5001,SCUOLA SECONDARIA II GRADO,5,23,22,1,0,1
202223,RM1E065003,SCUOLA PRIMARIA,1,18,17,1,0,1
202223,PAPS05500G,SCUOLA SECONDARIA II GRADO,1,6,6,0,0,0
202223,NARFRT500R,SCUOLA SECONDARIA II GRADO,3,9,9,0,0,0
202223,VA1E004001,SCUOLA PRIMARIA,2,20,18,2,0,2
202223,LU1EM35005,SCUOLA PRIMARIA,2,24,17,7,3,4
202223,BSPLMR500P,SCUOLA SECONDARIA II GRADO,1,30,28,2,1,1
202223,RM1E06100Q,SCUOLA PRIMARIA,1,42,40,2,1,1
202223,PAPM25500A,SCUOLA SECONDARIA II GRADO,1,5,5,0,0,0
202223,CO1E00700P,SCUOLA PRIMARIA,1,27,25,2,1,1
202223,BN1E002002,SCUOLA PRIMARIA,1,20,20,0,0,0
202223,VASLAA500P,SCUOLA SECONDARIA II GRADO,3,13,13,0,0,0
202223,MCPM505001,SCUOLA SECONDARIA II GRADO,4,12,10,2,0,2
202223,NA1E10200T,SCUOLA PRIMARIA,1,20,19,1,0,1
202223,MITF035002,SCUOLA SECONDARIA II GRADO,5,25,25,0,0,0
202223,CR1E00400A,SCUOLA PRIMARIA,1,21,21,0,0,0
202223,NA1E00300R,SCUOLA PRIMARIA,4,10,5,5,0,5
202223,BG1E00700X,SCUOLA PRIMARIA,2,62,54,8,1,7
202223,CA1M01100L,SCUOLA SECONDARIA I GRADO,3,22,22,0,0,0
202223,CLTD9T500A,SCUOLA SECONDARIA II GRADO,4,3,3,0,0,0
202223,NA1E17500G,SCUOLA PRIMARIA,2,9,6,3,1,2
202223,MB1E040003,SCUOLA PRIMARIA,5,33,33,0,0,0
202223,SSPS00500N,SCUOLA SECONDARIA II GRADO,4,2,2,0,0,0
202223,IM1E003001,SCUOLA PRIMARIA,2,21,18,3,3,0
202223,RMPC33500X,SCUOLA SECONDARIA II GRADO,1,5,4,1,1,0
202223,BS1M6C500D,SCUOLA SECONDARIA I GRADO,2,47,46,1,0,1
202223,AVTLU25001,SCUOLA SECONDARIA II GRADO,5,61,59,2,0,2
202223,VRPC04500B,SCUOLA SECONDARIA II GRADO,2,23,23,0,0,0
202223,VARH00500Q,SCUOLA SECONDARIA II GRADO,2,18,18,0,0,0
202223,FIPS08500A,SCUOLA SECONDARIA II GRADO,1,19,19,0,0,0
202223,RMPSQP500D,SCUOLA SECONDARIA II GRADO,5,29,29,0,0,0
202223,PD1E006001,SCUOLA PRIMARIA,1,20,19,1,0,1
202223,CE1ECZ5004,SCUOLA PRIMARIA,1,10,10,0,0,0
202223,MITL035006,SCUOLA SECONDARIA II GRADO,4,1,0,1,0,1
202223,MI1E06000B,SCUOLA PRIMARIA,4,33,25,8,0,8
202223,NA1E16000T,SCUOLA PRIMARIA,4,15,15,0,0,0
202223,CE1E03900N,SCUOLA PRIMARIA,3,14,14,0,0,0
202223,MB1E052009,SCUOLA PRIMARIA,4,43,41,2,0,2
202223,CE1E05600B,SCUOLA PRIMARIA,1,9,9,0,0,0
202223,NAPMEF500M,SCUOLA SECONDARIA II GRADO,5,59,58,1,0,1
202223,VT1E006009,SCUOLA PRIMARIA,1,23,23,0,0,0
202223,VRSL01500G,SCUOLA SECONDARIA II GRADO,2,7,7,0,0,0
202223,RM1E11200B,SCUOLA PRIMARIA,2,24,24,0,0,0
202223,AT1E00200G,SCUOLA PRIMARIA,4,20,18,2,0,2
202223,BS1E002009,SCUOLA PRIMARIA,2,26,25,1,0,1
202223,MBPQ035002,SCUOLA SECONDARIA II GRADO,1,23,23,0,0,0
202223,TO1E00500V,SCUOLA PRIMARIA,1,23,11,12,2,10
202223,RM1E193004,SCUOLA PRIMARIA,3,48,45,3,2,1
202223,NA1E17300X,SCUOLA PRIMARIA,4,10,10,0,0,0
202223,NA1E08200T,SCUOLA PRIMARIA,3,13,13,0,0,0
202223,CS1E010005,SCUOLA PRIMARIA,5,5,5,0,0,0
202223,CSPM04500A,SCUOLA SECONDARIA II GRADO,1,11,11,0,0,0
202223,SO1E00100E,SCUOLA PRIMARIA,1,12,12,0,0,0
202223,FRPC02500X,SCUOLA SECONDARIA II GRADO,4,11,10,1,1,0
202223,PR1E001004,SCUOLA PRIMARIA,1,50,50,0,0,0
202223,RMPM7V500G,SCUOLA SECONDARIA II GRADO,5,25,24,1,1,0
202223,PA1E01000R,SCUOLA PRIMARIA,4,16,16,0,0,0
202223,NA1E20700T,SCUOLA PRIMARIA,2,18,18,0,0,0
202223,NA1E227003,SCUOLA PRIMARIA,4,8,8,0,0,0
202223,MI1M085001,SCUOLA SECONDARIA I GRADO,1,109,106,3,0,3
202223,RM1E02000D,SCUOLA PRIMARIA,2,22,21,1,0,1
202223,MI1M06100C,SCUOLA SECONDARIA I GRADO,1,59,56,3,1,2
202223,SASD00500E,SCUOLA SECONDARIA II GRADO,3,2,2,0,0,0
202223,SRPL005001,SCUOLA SECONDARIA II GRADO,5,13,12,1,0,1
202223,AN1E00500L,SCUOLA PRIMARIA,4,3,3,0,0,0
202223,VA1E01800V,SCUOLA PRIMARIA,1,18,17,1,0,1
202223,PG1MB2500Q,SCUOLA SECONDARIA I GRADO,1,22,19,3,0,3
202223,RM1E21100C,SCUOLA PRIMARIA,1,19,16,3,0,3
202223,NARHR7500Q,SCUOLA SECONDARIA II GRADO,1,15,15,0,0,0
202223,BG1EUA5004,SCUOLA PRIMARIA,3,34,32,2,0,2
202223,NA1E052002,SCUOLA PRIMARIA,4,15,15,0,0,0
202223,BGPMNC5002,SCUOLA SECONDARIA II GRADO,5,21,21,0,0,0
202223,NA1E247008,SCUOLA PRIMARIA,1,10,8,2,0,2
202223,NA1E12000B,SCUOLA PRIMARIA,1,10,10,0,0,0
202223,NATD59500D,SCUOLA SECONDARIA II GRADO,2,10,10,0,0,0
202223,BNPC015006,SCUOLA SECONDARIA II GRADO,1,16,16,0,0,0
202223,CE1E06800N,SCUOLA PRIMARIA,1,6,6,0,0,0
202223,RM1M101006,SCUOLA SECONDARIA I GRADO,2,10,9,1,0,1
202223,BAPLS4500L,SCUOLA SECONDARIA II GRADO,2,15,15,0,0,0
202223,NATLSN5005,SCUOLA SECONDARIA II GRADO,4,2,2,0,0,0
202223,LO1E002003,SCUOLA PRIMARIA,3,30,28,2,0,2
202223,RM1E01700N,SCUOLA PRIMARIA,1,11,5,6,0,6
202223,APPSZ65005,SCUOLA SECONDARIA II GRADO,2,19,16,3,0,3
202223,TO1E07500P,SCUOLA PRIMARIA,3,40,38,2,1,1
202223,TO1E04200T,SCUOLA PRIMARIA,3,34,31,3,2,1
202223,RMTDOO500A,SCUOLA SECONDARIA II GRADO,4,5,5,0,0,0
202223,AGTDE45003,SCUOLA SECONDARIA II GRADO,5,75,75,0,0,0
202223,PT1E00600T,SCUOLA PRIMARIA,5,25,25,0,0,0
202223,METD065008,SCUOLA SECONDARIA II GRADO,1,2,2,0,0,0
202223,NA1E023002,SCUOLA PRIMARIA,5,10,8,2,0,2
202223,MI1E076001,SCUOLA PRIMARIA,2,23,21,2,1,1
202223,MIPC10500T,SCUOLA SECONDARIA II GRADO,2,24,23,1,0,1
202223,NA1E11700G,SCUOLA PRIMARIA,5,33,33,0,0,0
202223,NATD53500N,SCUOLA SECONDARIA II GRADO,1,12,12,0,0,0
202223,RMPC00500D,SCUOLA SECONDARIA II GRADO,3,12,12,0,0,0
202223,NAPSAV500Q,SCUOLA SECONDARIA II GRADO,1,6,6,0,0,0
202223,RN1E00800R,SCUOLA PRIMARIA,1,72,71,1,0,1
202223,VR1E00600P,SCUOLA PRIMARIA,5,46,45,1,0,1
202223,CE1E06200P,SCUOLA PRIMARIA,4,14,14,0,0,0
202223,CTTD92500V,SCUOLA SECONDARIA II GRADO,2,4,4,0,0,0
202223,BGSLQP500D,SCUOLA SECONDARIA II GRADO,1,6,5,1,0,1
202223,BSPS0H500D,SCUOLA SECONDARIA II GRADO,2,23,23,0,0,0
202223,CETFQ95001,SCUOLA SECONDARIA II GRADO,3,8,3,5,0,5
202223,SSPSNU500Q,SCUOLA SECONDARIA II GRADO,2,4,4,0,0,0
202223,TVPMRQ500V,SCUOLA SECONDARIA II GRADO,1,21,21,0,0,0
202223,PR1M008004,SCUOLA SECONDARIA I GRADO,2,51,51,0,0,0
202223,NATF32500G,SCUOLA SECONDARIA II GRADO,4,4,4,0,0,0
202223,RM1E122002,SCUOLA PRIMARIA,1,8,8,0,0,0
202223,NA1E134009,SCUOLA PRIMARIA,3,14,12,2,0,2
202223,RM1M06200R,SCUOLA SECONDARIA I GRADO,3,10,10,0,0,0
202223,MIPSO8500I,SCUOLA SECONDARIA II GRADO,2,23,22,1,0,1
202223,RN1E005009,SCUOLA PRIMARIA,5,36,36,0,0,0
202223,RE1E00500D,SCUOLA PRIMARIA,2,32,29,3,0,3
202223,NA1MUL500P,SCUOLA SECONDARIA I GRADO,1,19,18,1,0,1
202223,MI1E020001,SCUOLA PRIMARIA,4,51,49,2,0,2
202223,CSRH5I5000,SCUOLA SECONDARIA II GRADO,3,5,4,1,1,0
202223,ALPLVD500U,SCUOLA SECONDARIA II GRADO,5,8,6,2,0,2
202223,TV1E01000P,SCUOLA PRIMARIA,1,46,44,2,1,1
202223,RMPL07500N,SCUOLA SECONDARIA II GRADO,2,44,40,4,1,3
202223,RGRHH6500Z,SCUOLA SECONDARIA II GRADO,4,8,8,0,0,0
202223,RM1E001004,SCUOLA PRIMARIA,1,28,26,2,1,1
202223,TAPS02500A,SCUOLA SECONDARIA II GRADO,4,9,9,0,0,0
202223,BSPMVC500O,SCUOLA SECONDARIA II GRADO,5,10,10,0,0,0
202223,PO1E00300L,SCUOLA PRIMARIA,2,49,34,15,0,15
202223,SATL04500R,SCUOLA SECONDARIA II GRADO,5,59,56,3,0,3
202223,BO1E012009,SCUOLA PRIMARIA,2,47,41,6,0,6
202223,GE1E03600R,SCUOLA PRIMARIA,2,19,17,2,0,2
202223,SATFPG500G,SCUOLA SECONDARIA II GRADO,5,69,67,2,0,2
202223,UDTF00500V,SCUOLA SECONDARIA II GRADO,2,22,21,1,1,0
202223,UD1E008003,SCUOLA PRIMARIA,5,24,24,0,0,0
202223,MIPS20500T,SCUOLA SECONDARIA II GRADO,1,25,25,0,0,0
202223,NA1E214001,SCUOLA PRIMARIA,1,15,5,10,1,9
202223,BG1E01000Q,SCUOLA PRIMARIA,2,21,21,0,0,0
202223,VI1E00400P,SCUOLA PRIMARIA,2,16,13,3,1,2
202223,NA1E057005,SCUOLA PRIMARIA,3,25,25,0,0,0
202223,NA1E200003,SCUOLA PRIMARIA,5,10,10,0,0,0
202223,NARFA35009,SCUOLA SECONDARIA II GRADO,2,3,3,0,0,0
202223,RM1EM25008,SCUOLA PRIMARIA,5,17,13,4,0,4
202223,RM1EGU500T,SCUOLA PRIMARIA,1,32,31,1,0,1
202223,PAPM72500D,SCUOLA SECONDARIA II GRADO,5,15,15,0,0,0
202223,GE1E03700L,SCUOLA PRIMARIA,1,23,23,0,0,0
202223,TO1MSF500T,SCUOLA SECONDARIA I GRADO,2,17,17,0,0,0
202223,MBPSFH500F,SCUOLA SECONDARIA II GRADO,1,20,19,1,1,0
202223,FG1E01200P,SCUOLA PRIMARIA,1,14,14,0,0,0
202223,FIPS02500P,SCUOLA SECONDARIA II GRADO,1,3,3,0,0,0
202223,AR1E00300R,SCUOLA PRIMARIA,5,11,11,0,0,0
202223,CERH325008,SCUOLA SECONDARIA II GRADO,3,9,9,0,0,0
202223,SA1E02900B,SCUOLA PRIMARIA,4,25,24,1,0,1
202223,PGPMCG500I,SCUOLA SECONDARIA II GRADO,4,13,11,2,1,1
202223,RMPS8Q500R,SCUOLA SECONDARIA II GRADO,3,14,14,0,0,0
202223,MI1E004003,SCUOLA PRIMARIA,5,43,38,5,0,5
202223,FI1ECP5008,SCUOLA PRIMARIA,3,17,7,10,2,8
202223,BOPSVN5005,SCUOLA SECONDARIA II GRADO,4,5,5,0,0,0
202223,SATDH85000,SCUOLA SECONDARIA II GRADO,3,9,9,0,0,0
202223,TVPC035005,SCUOLA SECONDARIA II GRADO,2,4,4,0,0,0
202223,PD1E018007,SCUOLA PRIMARIA,5,51,50,1,0,1
202223,TOPS19500C,SCUOLA SECONDARIA II GRADO,3,18,18,0,0,0
202223,CORH005002,SCUOLA SECONDARIA II GRADO,1,22,19,3,0,3
202223,NA1E24900X,SCUOLA PRIMARIA,5,8,8,0,0,0
202223,NATDGC5003,SCUOLA SECONDARIA II GRADO,5,105,102,3,0,3
202223,NA1E270009,SCUOLA PRIMARIA,4,11,11,0,0,0
202223,NATF25500E,SCUOLA SECONDARIA II GRADO,2,14,14,0,0,0
202223,BGTD1D5000,SCUOLA SECONDARIA II GRADO,5,10,9,1,0,1
202223,RMPSRP5006,SCUOLA SECONDARIA II GRADO,5,16,15,1,0,1
202223,FG1E00500G,SCUOLA PRIMARIA,5,24,24,0,0,0
202223,MS1E002007,SCUOLA PRIMARIA,5,18,18,0,0,0
202223,MITNUQ500H,SCUOLA SECONDARIA II GRADO,3,32,25,7,0,7
202223,MI1M03600Q,SCUOLA SECONDARIA I GRADO,2,19,17,2,0,2
202223,CE1E044005,SCUOLA PRIMARIA,1,11,11,0,0,0
202223,FR1E010004,SCUOLA PRIMARIA,3,10,10,0,0,0
202223,FRTDI4500L,SCUOLA SECONDARIA II GRADO,5,67,63,4,1,3
202223,VI1M011003,SCUOLA SECONDARIA I GRADO,2,33,32,1,0,1
202223,FI1E019006,SCUOLA PRIMARIA,1,25,20,5,0,5
202223,SATFHU5008,SCUOLA SECONDARIA II GRADO,3,7,7,0,0,0
202223,RM1E14500P,SCUOLA PRIMARIA,5,13,13,0,0,0
202223,GE1M03300E,SCUOLA SECONDARIA I GRADO,3,49,46,3,1,2
202223,TOPS07500A,SCUOLA SECONDARIA II GRADO,3,23,21,2,2,0
202223,SATFCA5002,SCUOLA SECONDARIA II GRADO,4,2,2,0,0,0
202223,MIPS79500P,SCUOLA SECONDARIA II GRADO,2,7,7,0,0,0
202223,RMSL3M5001,SCUOLA SECONDARIA II GRADO,5,6,6,0,0,0
202223,RMPS165005,SCUOLA SECONDARIA II GRADO,2,6,6,0,0,0
202223,PV1MF4500I,SCUOLA SECONDARIA I GRADO,2,28,26,2,0,2
202223,PVPSTA500Q,SCUOLA SECONDARIA II GRADO,5,26,26,0,0,0
202223,LCPSG9500D,SCUOLA SECONDARIA II GRADO,5,25,25,0,0,0
202223,TV1E019005,SCUOLA PRIMARIA,5,17,16,1,0,1
202223,NAPM015009,SCUOLA SECONDARIA II GRADO,4,10,10,0,0,0
202223,VE1E00400B,SCUOLA PRIMARIA,4,63,47,16,2,14
202223,VAPS5H500H,SCUOLA SECONDARIA II GRADO,3,25,25,0,0,0
202223,PAPS8N500C,SCUOLA SECONDARIA II GRADO,5,24,22,2,0,2
202223,VAPLB6500A,SCUOLA SECONDARIA II GRADO,4,11,11,0,0,0
202223,TO1M01100B,SCUOLA SECONDARIA I GRADO,3,8,8,0,0,0
202223,RM1E00900P,SCUOLA PRIMARIA,4,23,23,0,0,0
202223,LU1E00400X,SCUOLA PRIMARIA,5,14,13,1,0,1
202223,CETFAV500R,SCUOLA SECONDARIA II GRADO,5,36,33,3,0,3
202223,NA1M032002,SCUOLA SECONDARIA I GRADO,3,15,15,0,0,0
202223,BSPS3I500U,SCUOLA SECONDARIA II GRADO,3,14,13,1,1,0
202223,FI1E00200R,SCUOLA PRIMARIA,4,24,22,2,0,2
202223,CTPSQC5001,SCUOLA SECONDARIA II GRADO,2,2,2,0,0,0
202223,FI1E014003,SCUOLA PRIMARIA,5,25,23,2,0,2
202223,PA1E006005,SCUOLA PRIMARIA,5,15,11,4,0,4
202223,MI1E124005,SCUOLA PRIMARIA,3,16,16,0,0,0
202223,VE1M01000X,SCUOLA SECONDARIA I GRADO,1,26,26,0,0,0
202223,LCPS01500L,SCUOLA SECONDARIA II GRADO,4,9,9,0,0,0
202223,RM1E09700E,SCUOLA PRIMARIA,3,44,44,0,0,0
202223,AL1M00800P,SCUOLA SECONDARIA I GRADO,3,54,54,0,0,0
202223,MIPMZS500F,SCUOLA SECONDARIA II GRADO,2,27,27,0,0,0
202223,SA1E00700E,SCUOLA PRIMARIA,2,6,5,1,0,1
202223,MB1E02800C,SCUOLA PRIMARIA,5,50,50,0,0,0
202223,PD1E01700B,SCUOLA PRIMARIA,3,25,24,1,0,1
202223,PA1EC8500U,SCUOLA PRIMARIA,4,13,13,0,0,0
202223,RMPMPL5008,SCUOLA SECONDARIA II GRADO,3,5,5,0,0,0
202223,PDPM00500B,SCUOLA SECONDARIA II GRADO,2,39,39,0,0,0
202223,AVTF765001,SCUOLA SECONDARIA II GRADO,5,70,68,2,0,2
202223,APTFI65001,SCUOLA SECONDARIA II GRADO,2,4,3,1,0,1
202223,VAPSDE500S,SCUOLA SECONDARIA II GRADO,4,17,16,1,0,1
202223,RMTD665009,SCUOLA SECONDARIA II GRADO,5,29,28,1,1,0
202223,RM1E03100X,SCUOLA PRIMARIA,2,12,11,1,0,1
202223,NO1M01200Q,SCUOLA SECONDARIA I GRADO,2,20,16,4,0,4
202223,FI1E027005,SCUOLA PRIMARIA,2,20,17,3,0,3
202223,PT1E00600T,SCUOLA PRIMARIA,1,15,12,3,0,3
202223,VI1M01300P,SCUOLA SECONDARIA I GRADO,3,30,30,0,0,0
202223,BOPMNL500M,SCUOLA SECONDARIA II GRADO,5,30,29,1,0,1
202223,MIPS055005,SCUOLA SECONDARIA II GRADO,1,12,12,0,0,0
202223,NARF5I500H,SCUOLA SECONDARIA II GRADO,3,17,17,0,0,0
202223,SATDBD5007,SCUOLA SECONDARIA II GRADO,3,1,1,0,0,0
202223,AVTFTA500S,SCUOLA SECONDARIA II GRADO,5,70,66,4,0,4
202223,AVTF1Q5009,SCUOLA SECONDARIA II GRADO,2,8,8,0,0,0
202223,VRPS01500P,SCUOLA SECONDARIA II GRADO,2,43,35,8,1,7
202223,ENRHA05008,SCUOLA SECONDARIA II GRADO,2,6,6,0,0,0
202223,VATD12500X,SCUOLA SECONDARIA II GRADO,1,10,9,1,0,1
202223,BLPMMN5000,SCUOLA SECONDARIA II GRADO,5,19,18,1,0,1
202223,NA1E122003,SCUOLA PRIMARIA,2,24,24,0,0,0
202223,PD1E01400X,SCUOLA PRIMARIA,1,23,22,1,0,1
202223,NAPS405005,SCUOLA SECONDARIA II GRADO,5,43,42,1,1,0
202223,NA1E08900L,SCUOLA PRIMARIA,1,19,19,0,0,0
202223,TVTB205003,SCUOLA SECONDARIA II GRADO,2,45,40,5,2,3
202223,MI1E13300X,SCUOLA PRIMARIA,3,26,26,0,0,0
202223,MI1EGH5005,SCUOLA PRIMARIA,3,25,25,0,0,0
202223,MB1E032004,SCUOLA PRIMARIA,2,24,24,0,0,0
202223,SAPS975006,SCUOLA SECONDARIA II GRADO,2,2,2,0,0,0
202223,NAPLZL5002,SCUOLA SECONDARIA II GRADO,2,11,11,0,0,0
202223,FI1E02300T,SCUOLA PRIMARIA,3,25,20,5,0,5
202223,NAPMTL5004,SCUOLA SECONDARIA II GRADO,4,5,5,0,0,0
202223,MCTD00500B,SCUOLA SECONDARIA II GRADO,1,3,2,1,0,1
202223,PR1M00500L,SCUOLA SECONDARIA I GRADO,3,66,66,0,0,0
202223,PCPSD7500T,SCUOLA SECONDARIA II GRADO,3,45,44,1,0,1
202223,RM1M04600V,SCUOLA SECONDARIA I GRADO,3,43,41,2,0,2
202223,NA1E22300Q,SCUOLA PRIMARIA,4,48,48,0,0,0
202223,NA1E156006,SCUOLA PRIMARIA,1,13,11,2,2,0
202223,NATD33500X,SCUOLA SECONDARIA II GRADO,1,15,14,1,0,1
202223,TV1E00200Q,SCUOLA PRIMARIA,4,51,50,1,1,0
202223,CERIPM5008,SCUOLA SECONDARIA II GRADO,4,10,10,0,0,0
202223,LU1E00600G,SCUOLA PRIMARIA,5,22,21,1,0,1
202223,TO1M050002,SCUOLA SECONDARIA I GRADO,2,56,46,10,1,9
202223,BGPM15500V,SCUOLA SECONDARIA II GRADO,4,9,7,2,0,2
202223,BO1E01000N,SCUOLA PRIMARIA,1,23,20,3,0,3
202223,CO1E00200G,SCUOLA PRIMARIA,3,20,20,0,0,0
202223,RM1M08900R,SCUOLA SECONDARIA I GRADO,1,16,15,1,0,1
202223,LITD02500G,SCUOLA SECONDARIA II GRADO,2,12,11,1,0,1
202223,NARHZL500O,SCUOLA SECONDARIA II GRADO,3,3,3,0,0,0
202223,SATD125002,SCUOLA SECONDARIA II GRADO,3,3,3,0,0,0
202223,TO1E02600X,SCUOLA PRIMARIA,4,59,55,4,2,2
202223,GE1E012008,SCUOLA PRIMARIA,3,17,17,0,0,0
202223,RM1E07400T,SCUOLA PRIMARIA,1,9,7,2,0,2
202223,SA1E020001,SCUOLA PRIMARIA,4,13,13,0,0,0
202223,SA1E00100G,SCUOLA PRIMARIA,2,19,19,0,0,0
202223,RN1M010002,SCUOLA SECONDARIA I GRADO,2,23,20,3,0,3
202223,LU1E002008,SCUOLA PRIMARIA,1,15,15,0,0,0
202223,PO1E006004,SCUOLA PRIMARIA,4,37,30,7,1,6
202223,NA1E02100A,SCUOLA PRIMARIA,3,15,15,0,0,0
202223,NA1E03900G,SCUOLA PRIMARIA,2,40,35,5,0,5
202223,BGPL06500X,SCUOLA SECONDARIA II GRADO,2,9,9,0,0,0
202223,PDPS00500A,SCUOLA SECONDARIA II GRADO,2,25,25,0,0,0
202223,BLPM01500Q,SCUOLA SECONDARIA II GRADO,3,22,22,0,0,0
202223,NA1E099007,SCUOLA PRIMARIA,1,11,8,3,0,3
202223,CR1M00500B,SCUOLA SECONDARIA I GRADO,1,57,55,2,1,1
202223,MI1M10000T,SCUOLA SECONDARIA I GRADO,1,11,11,0,0,0
202223,BATD665005,SCUOLA SECONDARIA II GRADO,1,4,4,0,0,0
202223,CA1M4N500E,SCUOLA SECONDARIA I GRADO,3,8,8,0,0,0
202223,RMTL395001,SCUOLA SECONDARIA II GRADO,1,2,2,0,0,0
202223,AL1E005002,SCUOLA PRIMARIA,4,33,30,3,1,2
202223,BOPL02500B,SCUOLA SECONDARIA II GRADO,3,21,20,1,0,1
202223,RMPC26500V,SCUOLA SECONDARIA II GRADO,5,32,32,0,0,0
202223,COPSI65000,SCUOLA SECONDARIA II GRADO,4,15,15,0,0,0
202223,RM1E11200B,SCUOLA PRIMARIA,1,17,17,0,0,0
202223,MIPL0Z500D,SCUOLA SECONDARIA II GRADO,1,18,17,1,0,1
202223,NATD48500T,SCUOLA SECONDARIA II GRADO,3,7,7,0,0,0
202223,FIPL8A500L,SCUOLA SECONDARIA II GRADO,2,5,4,1,0,1
202223,MBPSIE500B,SCUOLA SECONDARIA II GRADO,4,11,11,0,0,0
202223,MI1E053008,SCUOLA PRIMARIA,3,77,74,3,0,3
202223,TO1E004003,SCUOLA PRIMARIA,5,14,12,2,2,0
202223,CA1E00700Q,SCUOLA PRIMARIA,5,26,26,0,0,0
202223,RMPS305007,SCUOLA SECONDARIA II GRADO,3,3,3,0,0,0
202223,CA1EUL5004,SCUOLA PRIMARIA,1,8,8,0,0,0
202223,MI1M004008,SCUOLA SECONDARIA I GRADO,3,77,76,1,0,1
202223,RN1E001002,SCUOLA PRIMARIA,1,17,17,0,0,0
202223,RMTF145002,SCUOLA SECONDARIA II GRADO,5,69,60,9,2,7
202223,PDPS77500P,SCUOLA SECONDARIA II GRADO,3,21,21,0,0,0
202223,MB1E09100X,SCUOLA PRIMARIA,3,16,15,1,0,1
202223,RGPM05500B,SCUOLA SECONDARIA II GRADO,2,5,5,0,0,0
202223,VI1M017002,SCUOLA SECONDARIA I GRADO,2,28,28,0,0,0
202223,PG1E001003,SCUOLA PRIMARIA,1,24,24,0,0,0
202223,MEPS01500B,SCUOLA SECONDARIA II GRADO,2,1,1,0,0,0
202223,TA1E00700G,SCUOLA PRIMARIA,3,25,25,0,0,0
202223,BSPC12500Q,SCUOLA SECONDARIA II GRADO,3,18,18,0,0,0
202223,NATF6F5005,SCUOLA SECONDARIA II GRADO,3,7,6,1,0,1
202223,NATFI55003,SCUOLA SECONDARIA II GRADO,4,5,5,0,0,0
202223,NA1E241009,SCUOLA PRIMARIA,2,10,10,0,0,0
202223,GEPMN4500Z,SCUOLA SECONDARIA II GRADO,1,17,16,1,1,0
202223,BNTF2A500Q,SCUOLA SECONDARIA II GRADO,2,3,3,0,0,0
202223,UD1M002009,SCUOLA SECONDARIA I GRADO,2,25,24,1,0,1
202223,CT1E004001,SCUOLA PRIMARIA,5,29,27,2,0,2
202223,VRPM01500Q,SCUOLA SECONDARIA II GRADO,4,63,62,1,1,0
202223,MIPS72500B,SCUOLA SECONDARIA II GRADO,5,14,13,1,0,1
202223,SATF5C5002,SCUOLA SECONDARIA II GRADO,3,3,3,0,0,0
202223,MBPL315001,SCUOLA SECONDARIA II GRADO,4,19,19,0,0,0
202223,BSSL01500D,SCUOLA SECONDARIA II GRADO,2,40,40,0,0,0
202223,NA1E064008,SCUOLA PRIMARIA,4,20,11,9,0,9
202223,RMTN8V500Q,SCUOLA SECONDARIA II GRADO,4,3,3,0,0,0
202223,RGPMSZ500N,SCUOLA SECONDARIA II GRADO,4,1,1,0,0,0
202223,CERIN35009,SCUOLA SECONDARIA II GRADO,5,107,106,1,0,1
202223,MIPSZS500P,SCUOLA SECONDARIA II GRADO,1,5,5,0,0,0
202223,CETF6B500H,SCUOLA SECONDARIA II GRADO,4,13,13,0,0,0
202223,VAPS785001,SCUOLA SECONDARIA II GRADO,4,23,23,0,0,0
202223,MI1E08100C,SCUOLA PRIMARIA,2,15,15,0,0,0
202223,SATFH8500N,SCUOLA SECONDARIA II GRADO,4,8,8,0,0,0
202223,COPM02500E,SCUOLA SECONDARIA II GRADO,3,24,23,1,0,1
202223,UD1M008008,SCUOLA SECONDARIA I GRADO,1,31,31,0,0,0
202223,MI1E090007,SCUOLA PRIMARIA,2,5,4,1,0,1
202223,PA1E00400D,SCUOLA PRIMARIA,3,26,26,0,0,0
202223,MIPS16500L,SCUOLA SECONDARIA II GRADO,5,74,72,2,0,2
202223,RCTD5M5009,SCUOLA SECONDARIA II GRADO,1,4,4,0,0,0
202223,RMTD55500T,SCUOLA SECONDARIA II GRADO,5,20,18,2,0,2
202223,MIPSEN500E,SCUOLA SECONDARIA II GRADO,4,64,63,1,1,0
202223,PN1E001008,SCUOLA PRIMARIA,2,54,53,1,0,1
202223,MI1E017005,SCUOLA PRIMARIA,3,71,69,2,0,2
202223,VA1E41500F,SCUOLA PRIMARIA,3,13,11,2,0,2
202223,FIPC04500R,SCUOLA SECONDARIA II GRADO,3,5,5,0,0,0
202223,VA1E008008,SCUOLA PRIMARIA,2,39,38,1,1,0
202223,NARH05500C,SCUOLA SECONDARIA II GRADO,2,1,1,0,0,0
202223,CTPC605004,SCUOLA SECONDARIA II GRADO,5,5,5,0,0,0
202223,MI1E076001,SCUOLA PRIMARIA,3,22,21,1,0,1
202223,NA1E04600P,SCUOLA PRIMARIA,2,32,25,7,1,6
202223,NA1E25800P,SCUOLA PRIMARIA,2,18,9,9,3,6
202223,COPCCE5008,SCUOLA SECONDARIA II GRADO,1,18,16,2,0,2
202223,GE1M00800T,SCUOLA SECONDARIA I GRADO,2,24,24,0,0,0
202223,CE1E008002,SCUOLA PRIMARIA,1,15,14,1,0,1
202223,FE1ME9500R,SCUOLA SECONDARIA I GRADO,1,32,26,6,1,5
202223,CN1EN55004,SCUOLA PRIMARIA,2,17,17,0,0,0
202223,MC1EMU5009,SCUOLA PRIMARIA,3,19,19,0,0,0
202223,RM1M09100R,SCUOLA SECONDARIA I GRADO,3,41,40,1,0,1
202223,MB1M01000C,SCUOLA SECONDARIA I GRADO,3,51,50,1,0,1
202223,MN1M002005,SCUOLA SECONDARIA I GRADO,3,23,19,4,0,4
202223,RMPS575007,SCUOLA SECONDARIA II GRADO,1,4,4,0,0,0
202223,RM1ERP500L,SCUOLA PRIMARIA,2,11,11,0,0,0
202223,MI1M104005,SCUOLA SECONDARIA I GRADO,1,21,21,0,0,0
202223,RMRF9P500F,SCUOLA SECONDARIA II GRADO,2,4,4,0,0,0
202223,FG1E00300X,SCUOLA PRIMARIA,1,18,18,0,0,0
202223,APPS3R5004,SCUOLA SECONDARIA II GRADO,3,2,2,0,0,0
202223,NA1E185006,SCUOLA PRIMARIA,1,20,20,0,0,0
202223,NA1E085009,SCUOLA PRIMARIA,3,16,16,0,0,0
202223,NA1MUL500P,SCUOLA SECONDARIA I GRADO,2,19,16,3,0,3
202223,TV1E00700V,SCUOLA PRIMARIA,2,20,20,0,0,0
202223,RMPL00500B,SCUOLA SECONDARIA II GRADO,4,4,4,0,0,0
202223,CE1E06400A,SCUOLA PRIMARIA,2,10,10,0,0,0
202223,CTTD215006,SCUOLA SECONDARIA II GRADO,2,2,2,0,0,0
202223,BSPS125004,SCUOLA SECONDARIA II GRADO,1,11,11,0,0,0
202223,BS1M012005,SCUOLA SECONDARIA I GRADO,1,10,10,0,0,0
202223,RM1E119006,SCUOLA PRIMARIA,3,31,31,0,0,0
202223,VRPM27500E,SCUOLA SECONDARIA II GRADO,3,23,23,0,0,0
202223,RM1M057009,SCUOLA SECONDARIA I GRADO,1,88,86,2,1,1
202223,AV1EE5500E,SCUOLA PRIMARIA,3,15,15,0,0,0
202223,MB1M02100V,SCUOLA SECONDARIA I GRADO,1,82,82,0,0,0
202223,MOTD04500G,SCUOLA SECONDARIA II GRADO,4,12,12,0,0,0
202223,RMPMTS5005,SCUOLA SECONDARIA II GRADO,1,9,8,1,0,1
202223,CHTD07500E,SCUOLA SECONDARIA II GRADO,1,2,2,0,0,0
202223,MI1M077002,SCUOLA SECONDARIA I GRADO,3,32,31,1,0,1
202223,RA1M001001,SCUOLA SECONDARIA I GRADO,2,31,30,1,0,1
202223,MI1M01400V,SCUOLA SECONDARIA I GRADO,3,59,59,0,0,0
202223,NAPC08500B,SCUOLA SECONDARIA II GRADO,2,15,15,0,0,0
202223,LCPC00500V,SCUOLA SECONDARIA II GRADO,1,12,12,0,0,0
202223,RMPL135004,SCUOLA SECONDARIA II GRADO,1,14,14,0,0,0
202223,RGRIAG500E,SCUOLA SECONDARIA II GRADO,2,21,18,3,0,3
202223,PASD005001,SCUOLA SECONDARIA II GRADO,3,62,62,0,0,0
202223,VA1M00600T,SCUOLA SECONDARIA I GRADO,3,22,20,2,0,2
202223,NARHA8500Q,SCUOLA SECONDARIA II GRADO,1,8,8,0,0,0
202223,SATFVU500C,SCUOLA SECONDARIA II GRADO,1,9,8,1,0,1
202223,AR1E002001,SCUOLA PRIMARIA,3,15,15,0,0,0
202223,TOSL01500G,SCUOLA SECONDARIA II GRADO,1,40,40,0,0,0
202223,PGPMCG500I,SCUOLA SECONDARIA II GRADO,5,10,8,2,2,0
202223,RM1E04500T,SCUOLA PRIMARIA,5,16,15,1,0,1
202223,MI1E00500V,SCUOLA PRIMARIA,1,24,21,3,2,1
202223,SR1E00600R,SCUOLA PRIMARIA,4,20,20,0,0,0
202223,AL1E004006,SCUOLA PRIMARIA,1,31,30,1,0,1
202223,FR1E00600C,SCUOLA PRIMARIA,2,23,22,1,0,1
202223,MIPS085001,SCUOLA SECONDARIA II GRADO,5,34,33,1,0,1
202223,CERHZ85003,SCUOLA SECONDARIA II GRADO,2,11,11,0,0,0
202223,CTTD045008,SCUOLA SECONDARIA II GRADO,3,4,4,0,0,0
202223,SATD22500V,SCUOLA SECONDARIA II GRADO,1,1,1,0,0,0
202223,NA1E028005,SCUOLA PRIMARIA,1,13,13,0,0,0
202223,NARHV2500V,SCUOLA SECONDARIA II GRADO,4,8,8,0,0,0
202223,TO1M018006,SCUOLA SECONDARIA I GRADO,2,37,36,1,1,0
202223,CTPS075008,SCUOLA SECONDARIA II GRADO,5,23,22,1,0,1
202223,RC1M00400N,SCUOLA SECONDARIA I GRADO,2,9,9,0,0,0
202223,AQ1E00600N,SCUOLA PRIMARIA,2,12,12,0,0,0
202223,VEPMLV5000,SCUOLA SECONDARIA II GRADO,2,14,14,0,0,0
202223,SR1E3H5006,SCUOLA PRIMARIA,5,18,17,1,0,1
202223,NA1E19700C,SCUOLA PRIMARIA,2,11,11,0,0,0
202223,MIPM58500Q,SCUOLA SECONDARIA II GRADO,4,21,21,0,0,0
202223,MIPMN45001,SCUOLA SECONDARIA II GRADO,1,12,11,1,0,1
202223,SATDG0500E,SCUOLA SECONDARIA II GRADO,2,11,11,0,0,0
202223,AGPC4A5009,SCUOLA SECONDARIA II GRADO,1,2,2,0,0,0
202223,NA1E25700V,SCUOLA PRIMARIA,2,13,13,0,0,0
202223,NATF2C500R,SCUOLA SECONDARIA II GRADO,2,3,3,0,0,0
202223,RM1E12900R,SCUOLA PRIMARIA,2,8,7,1,0,1
202223,TOPC06500L,SCUOLA SECONDARIA II GRADO,5,20,19,1,1,0
202223,BO1E00400A,SCUOLA PRIMARIA,5,35,34,1,1,0
202223,BLPS54500H,SCUOLA SECONDARIA II GRADO,5,21,21,0,0,0
202223,VARH025001,SCUOLA SECONDARIA II GRADO,5,16,16,0,0,0
202223,NAPMUF500A,SCUOLA SECONDARIA II GRADO,4,6,6,0,0,0
202223,BA1E00400B,SCUOLA PRIMARIA,5,45,43,2,0,2
202223,CS1E002006,SCUOLA PRIMARIA,3,8,7,1,0,1
202223,CHRFQQ5004,SCUOLA SECONDARIA II GRADO,4,1,1,0,0,0
202223,CA1E01100B,SCUOLA PRIMARIA,5,16,15,1,1,0
202223,MB1E07100P,SCUOLA PRIMARIA,1,25,25,0,0,0
202223,NA1E01000X,SCUOLA PRIMARIA,3,16,7,9,1,8
202223,VIPLVN5005,SCUOLA SECONDARIA II GRADO,5,10,10,0,0,0
202223,CZ1E00400N,SCUOLA PRIMARIA,1,11,9,2,0,2
202223,SSTF00500Q,SCUOLA SECONDARIA II GRADO,2,2,2,0,0,0
202223,MITDOT5002,SCUOLA SECONDARIA II GRADO,3,8,8,0,0,0
202223,PA1E03800L,SCUOLA PRIMARIA,5,16,16,0,0,0
202223,AVTD06500A,SCUOLA SECONDARIA II GRADO,2,4,4,0,0,0
202223,TOPS20500T,SCUOLA SECONDARIA II GRADO,5,16,16,0,0,0
202223,TOPM09500L,SCUOLA SECONDARIA II GRADO,4,16,16,0,0,0
202223,NA1E10800R,SCUOLA PRIMARIA,1,23,23,0,0,0
202223,MIPS8E5005,SCUOLA SECONDARIA II GRADO,5,14,14,0,0,0
202223,GEPMUO500T,SCUOLA SECONDARIA II GRADO,4,18,18,0,0,0
202223,RMPS24500R,SCUOLA SECONDARIA II GRADO,1,39,38,1,0,1
202223,NATHE15007,SCUOLA SECONDARIA II GRADO,5,69,66,3,2,1
202223,PVPS03500N,SCUOLA SECONDARIA II GRADO,5,7,7,0,0,0
202223,MI1E8P5009,SCUOLA PRIMARIA,1,16,13,3,2,1
202223,SARHB65008,SCUOLA SECONDARIA II GRADO,2,3,3,0,0,0
202223,LCPS01500L,SCUOLA SECONDARIA II GRADO,5,14,14,0,0,0
202223,CE1E04100N,SCUOLA PRIMARIA,3,13,13,0,0,0
202223,RM1E01100P,SCUOLA PRIMARIA,2,20,20,0,0,0
202223,NA1M03900R,SCUOLA SECONDARIA I GRADO,1,15,11,4,0,4
202223,VE1E00900E,SCUOLA PRIMARIA,4,19,18,1,1,0
202223,FI1E00900G,SCUOLA PRIMARIA,4,24,18,6,0,6
202223,RM1E105008,SCUOLA PRIMARIA,3,20,19,1,1,0
202223,BGPQ235008,SCUOLA SECONDARIA II GRADO,1,19,17,2,0,2
202223,CE1E010002,SCUOLA PRIMARIA,1,23,22,1,0,1
202223,VT1E001006,SCUOLA PRIMARIA,2,19,19,0,0,0
202223,MI1E082008,SCUOLA PRIMARIA,5,29,28,1,0,1
202223,BO1E00300E,SCUOLA PRIMARIA,1,19,17,2,2,0
202223,MI1E088007,SCUOLA PRIMARIA,1,32,29,3,0,3
202223,NOTD035008,SCUOLA SECONDARIA II GRADO,1,2,2,0,0,0
202223,BS1E01500B,SCUOLA PRIMARIA,4,45,44,1,0,1
202223,RM1E18300D,SCUOLA PRIMARIA,4,12,10,2,0,2
202223,MI1E124005,SCUOLA PRIMARIA,4,19,18,1,0,1
202223,SARHE75006,SCUOLA SECONDARIA II GRADO,3,12,7,5,1,4
202223,CS1MUP500H,SCUOLA SECONDARIA I GRADO,2,26,25,1,0,1
202223,TO1E018001,SCUOLA PRIMARIA,4,55,54,1,1,0
202223,GE1E018007,SCUOLA PRIMARIA,4,20,20,0,0,0
202223,PAPMRG500C,SCUOLA SECONDARIA II GRADO,3,3,3,0,0,0
202223,VT1M00600E,SCUOLA SECONDARIA I GRADO,1,21,21,0,0,0
202223,LTRFGQ5000,SCUOLA SECONDARIA II GRADO,5,43,43,0,0,0
202223,CE1E002003,SCUOLA PRIMARIA,4,27,23,4,1,3
202223,FIPMP9500U,SCUOLA SECONDARIA II GRADO,1,9,9,0,0,0
202223,RMPLCV500U,SCUOLA SECONDARIA II GRADO,3,14,12,2,2,0
202223,NATDBQ500Q,SCUOLA SECONDARIA II GRADO,4,10,10,0,0,0
202223,NOPSUI500C,SCUOLA SECONDARIA II GRADO,3,5,5,0,0,0
202223,BSTL01500V,SCUOLA SECONDARIA II GRADO,5,7,7,0,0,0
202223,TOPSA6500N,SCUOLA SECONDARIA II GRADO,4,6,5,1,0,1
202223,NO1E00500B,SCUOLA PRIMARIA,3,10,10,0,0,0
202223,FI1E022002,SCUOLA PRIMARIA,1,27,27,0,0,0
202223,FI1E02400N,SCUOLA PRIMARIA,3,22,22,0,0,0
202223,TO1E024008,SCUOLA PRIMARIA,4,38,36,2,1,1
202223,VR1M02200T,SCUOLA SECONDARIA I GRADO,2,28,28,0,0,0
202223,NA1E24000D,SCUOLA PRIMARIA,2,10,10,0,0,0
202223,RM1E143003,SCUOLA PRIMARIA,5,39,37,2,0,2
202223,RM1E14100B,SCUOLA PRIMARIA,3,22,22,0,0,0
202223,CZ1M00100B,SCUOLA SECONDARIA I GRADO,3,13,12,1,0,1
202223,NA1E148007,SCUOLA PRIMARIA,2,10,10,0,0,0
202223,CE1ELC500C,SCUOLA PRIMARIA,4,22,21,1,0,1
202223,NA1E09100L,SCUOLA PRIMARIA,3,18,18,0,0,0
202223,GO1EUT5002,SCUOLA PRIMARIA,2,5,5,0,0,0
202223,RM1M14800B,SCUOLA SECONDARIA I GRADO,1,22,19,3,1,2
202223,LI1E005009,SCUOLA PRIMARIA,3,43,40,3,2,1
202223,BATD07500E,SCUOLA SECONDARIA II GRADO,1,12,12,0,0,0
202223,APPMOI500F,SCUOLA SECONDARIA II GRADO,1,2,2,0,0,0
202223,TO1E03600E,SCUOLA PRIMARIA,4,47,33,14,3,11
202223,PDRHMH500P,SCUOLA SECONDARIA II GRADO,5,19,19,0,0,0
202223,MCTFL85000,SCUOLA SECONDARIA II GRADO,1,3,3,0,0,0
202223,PE1E00400X,SCUOLA PRIMARIA,5,49,49,0,0,0
202223,PT1E00300A,SCUOLA PRIMARIA,1,7,7,0,0,0
202223,MI1E00100G,SCUOLA PRIMARIA,1,39,25,14,1,13
202223,RM1E15400D,SCUOLA PRIMARIA,5,18,17,1,0,1
202223,SATF9L500V,SCUOLA SECONDARIA II GRADO,3,3,2,1,0,1
202223,NA1E14600G,SCUOLA PRIMARIA,1,21,21,0,0,0
202223,UD1E00500G,SCUOLA PRIMARIA,5,46,43,3,0,3
202223,VRPS055005,SCUOLA SECONDARIA II GRADO,2,54,52,2,1,1
202223,CT1E031009,SCUOLA PRIMARIA,3,14,14,0,0,0
202223,UD1E002004,SCUOLA PRIMARIA,4,17,13,4,0,4
202223,PV1E00900X,SCUOLA PRIMARIA,3,23,23,0,0,0
202223,RM1E05300R,SCUOLA PRIMARIA,4,45,44,1,1,0
202223,BGRF2Q5004,SCUOLA SECONDARIA II GRADO,4,29,26,3,1,2
202223,CETD135008,SCUOLA SECONDARIA II GRADO,2,9,9,0,0,0
202223,NA1EM9500T,SCUOLA PRIMARIA,3,10,10,0,0,0
202223,VAPS6M5003,SCUOLA SECONDARIA II GRADO,2,41,41,0,0,0
202223,VAPS025007,SCUOLA SECONDARIA II GRADO,4,12,12,0,0,0
202223,VATN01500A,SCUOLA SECONDARIA II GRADO,5,14,11,3,0,3
202223,NA1E12900T,SCUOLA PRIMARIA,4,21,21,0,0,0
202223,SAPL025004,SCUOLA SECONDARIA II GRADO,2,3,3,0,0,0
202223,MBPC27500T,SCUOLA SECONDARIA II GRADO,4,15,15,0,0,0
202223,MO1MSQ500N,SCUOLA SECONDARIA I GRADO,2,23,23,0,0,0
202223,TO1E009006,SCUOLA PRIMARIA,4,48,47,1,1,0
202223,SATAIC500V,SCUOLA SECONDARIA II GRADO,5,30,29,1,0,1
202223,BGPS02500P,SCUOLA SECONDARIA II GRADO,4,30,30,0,0,0
202223,NA1E06100R,SCUOLA PRIMARIA,2,12,10,2,0,2
202223,RMPS41500P,SCUOLA SECONDARIA II GRADO,1,7,6,1,0,1
202223,RM1E08300L,SCUOLA PRIMARIA,2,35,34,1,0,1
202223,REPSQE5008,SCUOLA SECONDARIA II GRADO,5,9,8,1,0,1
202223,GE1E01400X,SCUOLA PRIMARIA,1,11,11,0,0,0
202223,GE1E01600G,SCUOLA PRIMARIA,5,21,19,2,0,2
202223,PD1M01100N,SCUOLA SECONDARIA I GRADO,2,49,49,0,0,0
202223,BG1MVN5002,SCUOLA SECONDARIA I GRADO,3,17,15,2,0,2
202223,SATLCL500F,SCUOLA SECONDARIA II GRADO,5,70,69,1,0,1
202223,CAPS02500E,SCUOLA SECONDARIA II GRADO,2,9,9,0,0,0
202223,UDPS0G500U,SCUOLA SECONDARIA II GRADO,3,20,18,2,1,1
202223,NATD48500T,SCUOLA SECONDARIA II GRADO,4,8,8,0,0,0
202223,FG1E024001,SCUOLA PRIMARIA,4,14,10,4,4,0
202223,BA1E005007,SCUOLA PRIMARIA,1,22,22,0,0,0
202223,MO1E004008,SCUOLA PRIMARIA,4,27,27,0,0,0
202223,MO1E013003,SCUOLA PRIMARIA,3,18,17,1,0,1
202223,CA1EUL5004,SCUOLA PRIMARIA,2,9,9,0,0,0
202223,TOPST1500C,SCUOLA SECONDARIA II GRADO,2,9,9,0,0,0
202223,TO1E05000R,SCUOLA PRIMARIA,4,15,14,1,0,1
202223,BO1E01600L,SCUOLA PRIMARIA,4,39,38,1,1,0
202223,RM1E09800A,SCUOLA PRIMARIA,5,12,11,1,0,1
202223,RM1E086004,SCUOLA PRIMARIA,3,8,6,2,0,2
202223,VI1M00400X,SCUOLA SECONDARIA I GRADO,3,26,26,0,0,0
202223,VA1E02100P,SCUOLA PRIMARIA,2,88,86,2,0,2
202223,MEPM12500X,SCUOLA SECONDARIA II GRADO,3,2,2,0,0,0
202223,VI1E007006,SCUOLA PRIMARIA,3,23,22,1,0,1
202223,LTRF05500R,SCUOLA SECONDARIA II GRADO,5,19,16,3,0,3
202223,RM1EBQ5007,SCUOLA PRIMARIA,1,13,12,1,0,1
202223,CT1ELO5000,SCUOLA PRIMARIA,1,32,31,1,0,1
202223,PD1M006006,SCUOLA SECONDARIA I GRADO,3,38,37,1,0,1
202223,MIPC15500V,SCUOLA SECONDARIA II GRADO,2,25,25,0,0,0
202223,TOPC075007,SCUOLA SECONDARIA II GRADO,5,38,38,0,0,0
202223,RM1E10700X,SCUOLA PRIMARIA,4,19,19,0,0,0
202223,PC1E002003,SCUOLA PRIMARIA,4,10,9,1,1,0
202223,PD1E00900C,SCUOLA PRIMARIA,1,12,12,0,0,0
202223,MBPSUD500O,SCUOLA SECONDARIA II GRADO,3,19,19,0,0,0
202223,RMPC185007,SCUOLA SECONDARIA II GRADO,5,28,28,0,0,0
202223,BG1E03200L,SCUOLA PRIMARIA,4,27,27,0,0,0
202223,MI1E04400D,SCUOLA PRIMARIA,2,23,22,1,0,1
202223,RM1M08500D,SCUOLA SECONDARIA I GRADO,1,26,25,1,0,1
202223,BA1E01100E,SCUOLA PRIMARIA,5,13,12,1,0,1
202223,TATD08500T,SCUOLA SECONDARIA II GRADO,5,96,94,2,0,2
202223,RA1E004007,SCUOLA PRIMARIA,1,45,41,4,2,2
202223,RMPSAD500D,SCUOLA SECONDARIA II GRADO,2,17,17,0,0,0
202223,NAPLVR500O,SCUOLA SECONDARIA II GRADO,3,21,20,1,0,1
202223,NAPMRM500O,SCUOLA SECONDARIA II GRADO,3,9,8,1,0,1
202223,CTTL07500E,SCUOLA SECONDARIA II GRADO,4,7,7,0,0,0
202223,VA1M01500L,SCUOLA SECONDARIA I GRADO,2,61,61,0,0,0
202223,MITD5V500H,SCUOLA SECONDARIA II GRADO,5,39,34,5,0,5
202223,SATDST500C,SCUOLA SECONDARIA II GRADO,1,4,4,0,0,0
202223,VB1E00300Q,SCUOLA PRIMARIA,2,23,22,1,0,1
202223,TVPS02500N,SCUOLA SECONDARIA II GRADO,4,25,25,0,0,0
202223,PA1E034009,SCUOLA PRIMARIA,4,15,15,0,0,0
202223,BS1M025007,SCUOLA SECONDARIA I GRADO,3,35,35,0,0,0
202223,PATD91500R,SCUOLA SECONDARIA II GRADO,1,12,11,1,0,1
202223,MBRC6C500E,SCUOLA SECONDARIA II GRADO,4,18,18,0,0,0
202223,NAPS065009,SCUOLA SECONDARIA II GRADO,1,8,7,1,0,1
202223,BG1E02900R,SCUOLA PRIMARIA,3,100,94,6,3,3
202223,NA1E164005,SCUOLA PRIMARIA,5,18,18,0,0,0
202223,LCTF66500Z,SCUOLA SECONDARIA II GRADO,3,17,15,2,0,2
202223,VR1E00200B,SCUOLA PRIMARIA,1,17,14,3,0,3
202223,CERHU1500P,SCUOLA SECONDARIA II GRADO,3,36,35,1,0,1
202223,MIRC1N500Z,SCUOLA SECONDARIA II GRADO,4,4,4,0,0,0
202223,NARHSC500S,SCUOLA SECONDARIA II GRADO,1,3,3,0,0,0
202223,CETFS0500N,SCUOLA SECONDARIA II GRADO,4,9,9,0,0,0
202223,PATD33500R,SCUOLA SECONDARIA II GRADO,3,4,4,0,0,0
202223,NA1E150007,SCUOLA PRIMARIA,1,14,14,0,0,0
202223,BG1E01800A,SCUOLA PRIMARIA,1,35,33,2,0,2
202223,BS1E01800V,SCUOLA PRIMARIA,3,34,34,0,0,0
202223,RMSL02500P,SCUOLA SECONDARIA II GRADO,1,9,9,0,0,0
202223,VEPS015003,SCUOLA SECONDARIA II GRADO,4,11,11,0,0,0
202223,RM1E177006,SCUOLA PRIMARIA,4,14,13,1,0,1
202223,PNPS9G5000,SCUOLA SECONDARIA II GRADO,3,11,11,0,0,0
202223,BOPLMA500N,SCUOLA SECONDARIA II GRADO,4,9,9,0,0,0
202223,FIPCI25001,SCUOLA SECONDARIA II GRADO,1,12,11,1,1,0
202223,MIPSVC500V,SCUOLA SECONDARIA II GRADO,4,25,23,2,0,2
202223,RM1E20200N,SCUOLA PRIMARIA,3,22,22,0,0,0
202223,CTPL145004,SCUOLA SECONDARIA II GRADO,4,3,3,0,0,0
202223,FG1E00300X,SCUOLA PRIMARIA,2,19,19,0,0,0
202223,UD1E00400Q,SCUOLA PRIMARIA,1,13,13,0,0,0
202223,BNPS12500Z,SCUOLA SECONDARIA II GRADO,1,24,23,1,1,0
202223,VARFR75004,SCUOLA SECONDARIA II GRADO,2,4,4,0,0,0
202223,CEPS875001,SCUOLA SECONDARIA II GRADO,4,23,23,0,0,0
202223,NA1E21000N,SCUOLA PRIMARIA,2,16,16,0,0,0
202223,MI1M06000L,SCUOLA SECONDARIA I GRADO,2,75,72,3,0,3
202223,MB1E058008,SCUOLA PRIMARIA,5,27,27,0,0,0
202223,SA1E01900R,SCUOLA PRIMARIA,3,12,12,0,0,0
202223,PG1M00500G,SCUOLA SECONDARIA I GRADO,3,4,3,1,0,1
202223,LT1E00400C,SCUOLA PRIMARIA,3,10,9,1,0,1
202223,SA1E01000A,SCUOLA PRIMARIA,3,14,13,1,0,1
202223,SS1E00400L,SCUOLA PRIMARIA,3,10,9,1,0,1
202223,ISPM1I500P,SCUOLA SECONDARIA II GRADO,4,1,1,0,0,0
202223,PA1M01800L,SCUOLA SECONDARIA I GRADO,1,8,8,0,0,0
202223,BG1M3M5006,SCUOLA SECONDARIA I GRADO,3,15,15,0,0,0
202223,PAPM25500A,SCUOLA SECONDARIA II GRADO,5,23,23,0,0,0
202223,MIPM01500Q,SCUOLA SECONDARIA II GRADO,4,23,23,0,0,0
202223,NA1E119007,SCUOLA PRIMARIA,5,27,27,0,0,0
202223,RMPSLS5006,SCUOLA SECONDARIA II GRADO,4,13,13,0,0,0
202223,BN1M4D5009,SCUOLA SECONDARIA I GRADO,2,23,22,1,0,1
202223,CE1MOT500D,SCUOLA SECONDARIA I GRADO,2,1,1,0,0,0
202223,MI1E02600X,SCUOLA PRIMARIA,1,23,20,3,1,2
202223,RM1M12400V,SCUOLA SECONDARIA I GRADO,3,33,31,2,1,1
202223,NATFUA500M,SCUOLA SECONDARIA II GRADO,5,67,65,2,0,2
202223,MI1E06600A,SCUOLA PRIMARIA,4,59,55,4,1,3
202223,APPSL05000,SCUOLA SECONDARIA II GRADO,1,12,10,2,2,0
202223,NA1E18200P,SCUOLA PRIMARIA,1,20,20,0,0,0
202223,SRTD06500N,SCUOLA SECONDARIA II GRADO,3,10,10,0,0,0
202223,PE1E00400X,SCUOLA PRIMARIA,1,36,34,2,2,0
202223,PERFNA5005,SCUOLA SECONDARIA II GRADO,5,9,9,0,0,0
202223,FI1E03200L,SCUOLA PRIMARIA,3,21,21,0,0,0
202223,CTTD34500V,SCUOLA SECONDARIA II GRADO,2,3,3,0,0,0
202223,ME1MU5500F,SCUOLA SECONDARIA I GRADO,3,27,22,5,1,4
202223,MIRFHT500U,SCUOLA SECONDARIA II GRADO,3,24,23,1,0,1
202223,BS1M01400R,SCUOLA SECONDARIA I GRADO,3,50,50,0,0,0
202223,VRPS09500G,SCUOLA SECONDARIA II GRADO,1,11,11,0,0,0
202223,MI1E08500Q,SCUOLA PRIMARIA,4,25,24,1,0,1
202223,BNTLN2500A,SCUOLA SECONDARIA II GRADO,5,70,65,5,0,5
202223,BL1M00200L,SCUOLA SECONDARIA I GRADO,3,44,42,2,1,1
202223,CT1E004001,SCUOLA PRIMARIA,1,21,20,1,0,1
202223,CT1E054002,SCUOLA PRIMARIA,1,16,12,4,0,4
202223,NATHA4500E,SCUOLA SECONDARIA II GRADO,3,3,3,0,0,0
202223,MS1E002007,SCUOLA PRIMARIA,2,18,16,2,0,2
202223,CH1E006003,SCUOLA PRIMARIA,4,13,13,0,0,0
202223,AP1E006003,SCUOLA PRIMARIA,3,19,16,3,0,3
202223,MI1M07300P,SCUOLA SECONDARIA I GRADO,1,89,87,2,0,2
202223,MI1EMR500E,SCUOLA PRIMARIA,5,35,31,4,1,3
202223,LCPMEE500S,SCUOLA SECONDARIA II GRADO,1,25,24,1,1,0
202223,RN1E00800R,SCUOLA PRIMARIA,2,60,55,5,1,4
202223,TV1E01100E,SCUOLA PRIMARIA,5,19,19,0,0,0
202223,CE1E06200P,SCUOLA PRIMARIA,2,17,17,0,0,0
202223,PO1E00900G,SCUOLA PRIMARIA,5,23,18,5,0,5
202223,PRPS015007,SCUOLA SECONDARIA II GRADO,5,17,17,0,0,0
202223,NATF32500G,SCUOLA SECONDARIA II GRADO,3,9,9,0,0,0
202223,MI1E089003,SCUOLA PRIMARIA,3,8,7,1,0,1
202223,PA1E02600A,SCUOLA PRIMARIA,2,14,14,0,0,0
202223,BS1E00600L,SCUOLA PRIMARIA,1,59,56,3,0,3
202223,RMTAZI500E,SCUOLA SECONDARIA II GRADO,2,8,8,0,0,0
202223,PGPSVU500T,SCUOLA SECONDARIA II GRADO,4,3,3,0,0,0
202223,AGTDE45003,SCUOLA SECONDARIA II GRADO,1,2,2,0,0,0
202223,CSRH5I5000,SCUOLA SECONDARIA II GRADO,2,4,4,0,0,0
202223,FI1M02100B,SCUOLA SECONDARIA I GRADO,3,24,23,1,0,1
202223,CERIDA500F,SCUOLA SECONDARIA II GRADO,1,8,6,2,1,1
202223,BR1E001002,SCUOLA PRIMARIA,1,10,9,1,0,1
202223,VR1E020001,SCUOLA PRIMARIA,5,49,46,3,2,1
202223,CO1E01100A,SCUOLA PRIMARIA,2,25,25,0,0,0
202223,RMPMFO500A,SCUOLA SECONDARIA II GRADO,4,14,12,2,0,2
202223,RC1E00800Q,SCUOLA PRIMARIA,2,15,14,1,0,1
202223,NA1E25700V,SCUOLA PRIMARIA,3,11,11,0,0,0
202223,UDPSMD500L,SCUOLA SECONDARIA II GRADO,4,13,12,1,1,0
202223,NA1E285003,SCUOLA PRIMARIA,2,17,17,0,0,0
202223,FIPS04500X,SCUOLA SECONDARIA II GRADO,1,39,33,6,1,5
202223,BLPSD7500D,SCUOLA SECONDARIA II GRADO,1,24,24,0,0,0
202223,MI1M09300X,SCUOLA SECONDARIA I GRADO,2,48,44,4,1,3
202223,MB1M018003,SCUOLA SECONDARIA I GRADO,3,78,78,0,0,0
202223,LO1E00400P,SCUOLA PRIMARIA,1,31,26,5,0,5
202223,RMPS95500D,SCUOLA SECONDARIA II GRADO,3,11,11,0,0,0
202223,RM1E02500L,SCUOLA PRIMARIA,1,23,22,1,0,1
202223,RM1E04100E,SCUOLA PRIMARIA,1,20,19,1,0,1
202223,PV1E00400R,SCUOLA PRIMARIA,3,17,16,1,0,1
202223,COPS04500P,SCUOLA SECONDARIA II GRADO,4,13,12,1,0,1
202223,TV1M014007,SCUOLA SECONDARIA I GRADO,3,25,23,2,0,2
202223,RM1E15200T,SCUOLA PRIMARIA,1,24,22,2,1,1
202223,NATDI75001,SCUOLA SECONDARIA II GRADO,5,70,70,0,0,0
202223,TO1MSF500T,SCUOLA SECONDARIA I GRADO,3,11,11,0,0,0
202223,NA1E27400L,SCUOLA PRIMARIA,2,49,49,0,0,0
202223,FEPLDM500L,SCUOLA SECONDARIA II GRADO,3,8,8,0,0,0
202223,NA1E12300V,SCUOLA PRIMARIA,5,38,38,0,0,0
202223,MI1E05700G,SCUOLA PRIMARIA,1,32,31,1,0,1
202223,MO1E012007,SCUOLA PRIMARIA,2,16,16,0,0,0
202223,NATN7V500I,SCUOLA SECONDARIA II GRADO,4,7,5,2,0,2
202223,RA1E00100Q,SCUOLA PRIMARIA,4,25,24,1,0,1
202223,RMPS8Q500R,SCUOLA SECONDARIA II GRADO,4,17,17,0,0,0
202223,TO1E05800B,SCUOLA PRIMARIA,5,14,12,2,1,1
202223,NA1E01200G,SCUOLA PRIMARIA,5,9,1,8,0,8
202223,BGPS505007,SCUOLA SECONDARIA II GRADO,2,24,24,0,0,0
202223,BGPSQZ500T,SCUOLA SECONDARIA II GRADO,3,18,18,0,0,0
202223,GRPS005002,SCUOLA SECONDARIA II GRADO,1,8,8,0,0,0
202223,RM1E105008,SCUOLA PRIMARIA,2,23,23,0,0,0
202223,RM1E14600E,SCUOLA PRIMARIA,2,14,14,0,0,0
202223,COTL045001,SCUOLA SECONDARIA II GRADO,4,10,8,2,0,2
202223,PATDEE500L,SCUOLA SECONDARIA II GRADO,1,3,3,0,0,0
202223,MIPS375001,SCUOLA SECONDARIA II GRADO,1,55,55,0,0,0
202223,RMPS18500A,SCUOLA SECONDARIA II GRADO,3,15,15,0,0,0
202223,NATNHS5003,SCUOLA SECONDARIA II GRADO,5,70,60,10,2,8
202223,MI1E124005,SCUOLA PRIMARIA,5,10,9,1,0,1
202223,NA1E07600E,SCUOLA PRIMARIA,2,32,31,1,0,1
202223,LCTAB3500P,SCUOLA SECONDARIA II GRADO,4,15,15,0,0,0
202223,FRRFL1500I,SCUOLA SECONDARIA II GRADO,3,3,3,0,0,0
202223,BS1E01900P,SCUOLA PRIMARIA,2,27,26,1,0,1
202223,NA1M023007,SCUOLA SECONDARIA I GRADO,1,28,24,4,0,4
202223,FI1E00400C,SCUOLA PRIMARIA,3,27,25,2,0,2
202223,BSPSB05000,SCUOLA SECONDARIA II GRADO,2,4,4,0,0,0
202223,RM1E16000R,SCUOLA PRIMARIA,3,14,14,0,0,0
202223,NATF41500Q,SCUOLA SECONDARIA II GRADO,5,101,97,4,0,4
202223,CE1E010002,SCUOLA PRIMARIA,2,16,14,2,0,2
202223,CE1E02100C,SCUOLA PRIMARIA,5,13,13,0,0,0
202223,CSTDDC500C,SCUOLA SECONDARIA II GRADO,1,3,2,1,1,0
202223,AR1E00500C,SCUOLA PRIMARIA,5,12,11,1,1,0
202223,ATPS715002,SCUOLA SECONDARIA II GRADO,5,24,23,1,0,1
202223,MB1M01600B,SCUOLA SECONDARIA I GRADO,2,28,28,0,0,0
202223,MBPMM55007,SCUOLA SECONDARIA II GRADO,4,30,30,0,0,0
202223,RM1E18200N,SCUOLA PRIMARIA,1,12,10,2,0,2
202223,VETF015005,SCUOLA SECONDARIA II GRADO,2,30,29,1,0,1
202223,SARHV4500U,SCUOLA SECONDARIA II GRADO,4,10,9,1,1,0
202223,RMPS4A500Z,SCUOLA SECONDARIA II GRADO,2,15,13,2,0,2
202223,CSPM03500Q,SCUOLA SECONDARIA II GRADO,3,12,10,2,0,2
202223,NA1E06800G,SCUOLA PRIMARIA,3,10,6,4,0,4
202223,RM1E09100G,SCUOLA PRIMARIA,2,12,12,0,0,0
202223,ALRH01500G,SCUOLA SECONDARIA II GRADO,4,16,15,1,0,1
202223,MIPS01500P,SCUOLA SECONDARIA II GRADO,5,44,44,0,0,0
202223,LTPM02500Q,SCUOLA SECONDARIA II GRADO,4,11,11,0,0,0
202223,CETF01500C,SCUOLA SECONDARIA II GRADO,3,21,21,0,0,0
202223,RM1E21500Q,SCUOLA PRIMARIA,1,12,9,3,1,2
202223,PDPS02500G,SCUOLA SECONDARIA II GRADO,2,39,39,0,0,0
202223,SATFU9500P,SCUOLA SECONDARIA II GRADO,5,17,17,0,0,0
202223,NATF15500N,SCUOLA SECONDARIA II GRADO,2,13,13,0,0,0
202223,RMPLUU500N,SCUOLA SECONDARIA II GRADO,5,16,15,1,1,0
202223,RMPSNS500T,SCUOLA SECONDARIA II GRADO,3,4,4,0,0,0
202223,PA1E006005,SCUOLA PRIMARIA,4,10,8,2,0,2
202223,AT1E00300B,SCUOLA PRIMARIA,5,20,18,2,0,2
202223,BAPSV85002,SCUOLA SECONDARIA II GRADO,4,86,86,0,0,0
202223,SAPL65500L,SCUOLA SECONDARIA II GRADO,5,50,48,2,1,1
202223,NA1E1M500R,SCUOLA PRIMARIA,1,12,1,11,0,11
202223,MI1E011006,SCUOLA PRIMARIA,5,13,11,2,1,1
202223,RM1E09700E,SCUOLA PRIMARIA,4,40,40,0,0,0
202223,PT1E00300A,SCUOLA PRIMARIA,2,18,17,1,0,1
202223,BOPS3D500P,SCUOLA SECONDARIA II GRADO,3,8,8,0,0,0
202223,VA1E004001,SCUOLA PRIMARIA,3,19,19,0,0,0
202223,NARFZO500E,SCUOLA SECONDARIA II GRADO,1,8,8,0,0,0
202223,SATD9H500H,SCUOLA SECONDARIA II GRADO,3,8,8,0,0,0
202223,PAPLE05003,SCUOLA SECONDARIA II GRADO,5,17,17,0,0,0
202223,COTD06500Q,SCUOLA SECONDARIA II GRADO,5,12,11,1,1,0
202223,AVPM10500T,SCUOLA SECONDARIA II GRADO,4,9,9,0,0,0
202223,CO1E005003,SCUOLA PRIMARIA,5,28,27,1,0,1
202223,AVTF765001,SCUOLA SECONDARIA II GRADO,4,5,5,0,0,0
202223,MIPC04500B,SCUOLA SECONDARIA II GRADO,1,7,7,0,0,0
202223,TOPS01500P,SCUOLA SECONDARIA II GRADO,2,34,34,0,0,0
202223,VAPSE5500O,SCUOLA SECONDARIA II GRADO,5,23,23,0,0,0
202223,MCPM505001,SCUOLA SECONDARIA II GRADO,3,16,15,1,0,1
202223,SATF6U5006,SCUOLA SECONDARIA II GRADO,4,4,4,0,0,0
202223,RM1M02100E,SCUOLA SECONDARIA I GRADO,2,69,69,0,0,0
202223,CR1E00300E,SCUOLA PRIMARIA,5,52,52,0,0,0
202223,MOPS0N500H,SCUOLA SECONDARIA II GRADO,4,18,18,0,0,0
202223,SAPMFG500M,SCUOLA SECONDARIA II GRADO,2,8,7,1,0,1
202223,MNPL02500L,SCUOLA SECONDARIA II GRADO,4,11,11,0,0,0
202223,MO1E00200L,SCUOLA PRIMARIA,3,28,26,2,0,2
202223,PVPS5H500G,SCUOLA SECONDARIA II GRADO,4,17,16,1,1,0
202223,RMPSII500C,SCUOLA SECONDARIA II GRADO,5,17,17,0,0,0
202223,NAPL00500C,SCUOLA SECONDARIA II GRADO,5,15,15,0,0,0
202223,MB1E040003,SCUOLA PRIMARIA,4,18,17,1,1,0
202223,RM1E10200R,SCUOLA PRIMARIA,4,44,44,0,0,0
202223,CETF8R5001,SCUOLA SECONDARIA II GRADO,4,9,9,0,0,0
202223,SATDBD5007,SCUOLA SECONDARIA II GRADO,4,1,0,1,0,1
202223,PRTD02500N,SCUOLA SECONDARIA II GRADO,1,1,1,0,0,0
202223,NATF37500L,SCUOLA SECONDARIA II GRADO,3,6,6,0,0,0
202223,MI1MN45001,SCUOLA SECONDARIA I GRADO,2,55,53,2,0,2
202223,MIPC18500P,SCUOLA SECONDARIA II GRADO,3,24,24,0,0,0
202223,NA1E14700B,SCUOLA PRIMARIA,4,17,17,0,0,0
202223,NAPS3S500N,SCUOLA SECONDARIA II GRADO,5,70,68,2,0,2
202223,SATF1D500C,SCUOLA SECONDARIA II GRADO,5,70,67,3,0,3
202223,BS1E01400G,SCUOLA PRIMARIA,3,16,16,0,0,0
202223,NARI11500A,SCUOLA SECONDARIA II GRADO,4,1,1,0,0,0
202223,NA1E18800N,SCUOLA PRIMARIA,5,4,4,0,0,0
202223,RE1M008006,SCUOLA SECONDARIA I GRADO,1,17,13,4,0,4
202223,TV1E01200A,SCUOLA PRIMARIA,5,20,20,0,0,0
202223,CE1E04800C,SCUOLA PRIMARIA,5,19,19,0,0,0
202223,VA1M8O500Z,SCUOLA SECONDARIA I GRADO,1,21,21,0,0,0
202223,TO1M03200C,SCUOLA SECONDARIA I GRADO,1,76,72,4,0,4
202223,RMPL50500Q,SCUOLA SECONDARIA II GRADO,2,5,5,0,0,0
202223,PATDAH500E,SCUOLA SECONDARIA II GRADO,2,3,2,1,0,1
202223,BG1E02300T,SCUOLA PRIMARIA,5,50,48,2,0,2
202223,MBPMZF5000,SCUOLA SECONDARIA II GRADO,4,6,6,0,0,0
202223,RM1E043006,SCUOLA PRIMARIA,1,29,27,2,0,2
202223,NAPCFD500P,SCUOLA SECONDARIA II GRADO,2,4,4,0,0,0
202223,SO1E00100E,SCUOLA PRIMARIA,2,10,10,0,0,0
202223,REPM3F5001,SCUOLA SECONDARIA II GRADO,4,25,25,0,0,0
202223,VR1E017005,SCUOLA PRIMARIA,1,24,24,0,0,0
202223,PARI025001,SCUOLA SECONDARIA II GRADO,1,2,2,0,0,0
202223,RO1E00300A,SCUOLA PRIMARIA,5,11,10,1,1,0
202223,LTRFGQ5000,SCUOLA SECONDARIA II GRADO,1,4,4,0,0,0
202223,CT1EG5500S,SCUOLA PRIMARIA,1,21,19,2,0,2
202223,LU1EM35005,SCUOLA PRIMARIA,1,24,18,6,2,4
202223,TO1M04600A,SCUOLA SECONDARIA I GRADO,2,54,53,1,0,1
202223,BG1M02400V,SCUOLA SECONDARIA I GRADO,3,59,58,1,0,1
202223,PD1M007002,SCUOLA SECONDARIA I GRADO,1,20,20,0,0,0
202223,BGPM15500V,SCUOLA SECONDARIA II GRADO,3,20,18,2,0,2
202223,SI1E001009,SCUOLA PRIMARIA,4,19,18,1,0,1
202223,SATFTV500U,SCUOLA SECONDARIA II GRADO,5,95,95,0,0,0
202223,NA1E100006,SCUOLA PRIMARIA,5,32,29,3,0,3
202223,MI1M084005,SCUOLA SECONDARIA I GRADO,3,30,28,2,0,2
202223,CA1M01100L,SCUOLA SECONDARIA I GRADO,2,32,30,2,1,1
202223,TOTB005001,SCUOLA SECONDARIA II GRADO,5,10,9,1,1,0
202223,TO1E04400D,SCUOLA PRIMARIA,2,29,29,0,0,0
202223,RM1E09100G,SCUOLA PRIMARIA,4,15,14,1,0,1
202223,GE1E012008,SCUOLA PRIMARIA,2,13,13,0,0,0
202223,CTTL07500E,SCUOLA SECONDARIA II GRADO,5,49,49,0,0,0
202223,SA1E00100G,SCUOLA PRIMARIA,3,17,16,1,0,1
202223,CTSD015003,SCUOLA SECONDARIA II GRADO,3,36,35,1,1,0
202223,BG1EUA5004,SCUOLA PRIMARIA,2,28,27,1,1,0
202223,RMPC33500X,SCUOLA SECONDARIA II GRADO,2,6,6,0,0,0
202223,PD1E021003,SCUOLA PRIMARIA,2,17,11,6,2,4
202223,RMPMBG500A,SCUOLA SECONDARIA II GRADO,3,14,12,2,1,1
202223,AVTLU25001,SCUOLA SECONDARIA II GRADO,4,3,3,0,0,0
202223,VARH00500Q,SCUOLA SECONDARIA II GRADO,3,19,19,0,0,0
202223,RMPSRP5006,SCUOLA SECONDARIA II GRADO,1,22,15,7,2,5
202223,FIPS065005,SCUOLA SECONDARIA II GRADO,5,7,7,0,0,0
202223,MBRC6C500E,SCUOLA SECONDARIA II GRADO,5,19,17,2,0,2
202223,CE1E06700T,SCUOLA PRIMARIA,5,3,1,2,1,1
202223,CE1E0L5004,SCUOLA PRIMARIA,2,8,6,2,0,2
202223,RM1M101006,SCUOLA SECONDARIA I GRADO,3,11,9,2,0,2
202223,NATLSN5005,SCUOLA SECONDARIA II GRADO,3,2,2,0,0,0
202223,CA1E00900B,SCUOLA PRIMARIA,4,19,19,0,0,0
202223,RM1E01600T,SCUOLA PRIMARIA,5,10,9,1,1,0
202223,CE1E03900N,SCUOLA PRIMARIA,2,19,18,1,0,1
202223,PDPS77500P,SCUOLA SECONDARIA II GRADO,1,24,23,1,1,0
202223,BGPSDM500A,SCUOLA SECONDARIA II GRADO,3,19,19,0,0,0
202223,PG1E4Q500B,SCUOLA PRIMARIA,3,2,2,0,0,0
202223,CE1E028007,SCUOLA PRIMARIA,3,24,24,0,0,0
202223,VAPL06500C,SCUOLA SECONDARIA II GRADO,4,5,4,1,1,0
202223,PA1E043004,SCUOLA PRIMARIA,3,20,13,7,1,6
202223,RMPC24500N,SCUOLA SECONDARIA II GRADO,5,5,5,0,0,0
202223,BO1E00100V,SCUOLA PRIMARIA,5,19,19,0,0,0
202223,RM1E11200B,SCUOLA PRIMARIA,3,26,26,0,0,0
202223,NA1E11700G,SCUOLA PRIMARIA,4,24,24,0,0,0
202223,VRPM055006,SCUOLA SECONDARIA II GRADO,1,48,48,0,0,0
202223,NA1E22900P,SCUOLA PRIMARIA,4,14,14,0,0,0
202223,TO1E00500V,SCUOLA PRIMARIA,2,21,16,5,0,5
202223,RM1E193004,SCUOLA PRIMARIA,4,43,43,0,0,0
202223,NA1E17300X,SCUOLA PRIMARIA,3,10,10,0,0,0
202223,LI1E00400D,SCUOLA PRIMARIA,4,23,20,3,0,3
202223,VR1E00700E,SCUOLA PRIMARIA,1,18,16,2,0,2
202223,LCRF085005,SCUOLA SECONDARIA II GRADO,2,13,13,0,0,0
202223,MB1E037007,SCUOLA PRIMARIA,1,31,29,2,1,1
202223,NAPM29500X,SCUOLA SECONDARIA II GRADO,3,9,9,0,0,0
202223,MB1E09100X,SCUOLA PRIMARIA,2,21,21,0,0,0
202223,RGPM05500B,SCUOLA SECONDARIA II GRADO,1,6,6,0,0,0
202223,CTTD92500V,SCUOLA SECONDARIA II GRADO,1,6,6,0,0,0
202223,BGPSRR5006,SCUOLA SECONDARIA II GRADO,5,20,20,0,0,0
202223,SSPSNU500Q,SCUOLA SECONDARIA II GRADO,3,2,2,0,0,0
202223,POPS9T5004,SCUOLA SECONDARIA II GRADO,5,40,27,13,0,13
202223,GE1M027007,SCUOLA SECONDARIA I GRADO,3,26,26,0,0,0
202223,UDTFI2500I,SCUOLA SECONDARIA II GRADO,1,27,25,2,1,1
202223,NA1E134009,SCUOLA PRIMARIA,2,18,18,0,0,0
202223,UD1M002009,SCUOLA SECONDARIA I GRADO,3,24,24,0,0,0
202223,PA1E01000R,SCUOLA PRIMARIA,3,26,26,0,0,0
202223,SATF5C5002,SCUOLA SECONDARIA II GRADO,5,69,67,2,1,1
202223,GEPMAH500O,SCUOLA SECONDARIA II GRADO,3,39,34,5,0,5
202223,NA1E227003,SCUOLA PRIMARIA,3,10,10,0,0,0
202223,MI1M06000L,SCUOLA SECONDARIA I GRADO,3,78,78,0,0,0
202223,RE1E00500D,SCUOLA PRIMARIA,1,32,29,3,0,3
202223,MI1E01400N,SCUOLA PRIMARIA,5,32,31,1,0,1
202223,AN1E00500L,SCUOLA PRIMARIA,3,4,4,0,0,0
202223,VA1E01800V,SCUOLA PRIMARIA,2,18,18,0,0,0
202223,RM1E21100C,SCUOLA PRIMARIA,2,17,12,5,0,5
202223,BG1M006009,SCUOLA SECONDARIA I GRADO,2,44,44,0,0,0
202223,BO1E012009,SCUOLA PRIMARIA,1,39,35,4,0,4
202223,NA1E052002,SCUOLA PRIMARIA,3,20,20,0,0,0
202223,BGPMNC5002,SCUOLA SECONDARIA II GRADO,4,16,16,0,0,0
202223,UD1MD8500H,SCUOLA SECONDARIA I GRADO,2,16,15,1,0,1
202223,NATD59500D,SCUOLA SECONDARIA II GRADO,1,15,15,0,0,0
202223,NA1E212009,SCUOLA PRIMARIA,5,10,10,0,0,0
202223,BA1MDT500L,SCUOLA SECONDARIA I GRADO,3,23,22,1,1,0
202223,LO1E002003,SCUOLA PRIMARIA,2,24,24,0,0,0
202223,PN1E001008,SCUOLA PRIMARIA,1,40,40,0,0,0
202223,TO1E07500P,SCUOLA PRIMARIA,4,38,37,1,0,1
202223,RMTDOO500A,SCUOLA SECONDARIA II GRADO,5,29,29,0,0,0
202223,TO1E020001,SCUOLA PRIMARIA,5,23,23,0,0,0
202223,SA1E01500D,SCUOLA PRIMARIA,4,20,20,0,0,0
202223,RM1E06900A,SCUOLA PRIMARIA,2,21,21,0,0,0
202223,RM1M016003,SCUOLA SECONDARIA I GRADO,1,13,13,0,0,0
202223,METD045003,SCUOLA SECONDARIA II GRADO,5,34,33,1,0,1
202223,KR1E002001,SCUOLA PRIMARIA,3,19,18,1,1,0
202223,LC1E002009,SCUOLA PRIMARIA,4,54,54,0,0,0
202223,RM1E204009,SCUOLA PRIMARIA,3,20,20,0,0,0
202223,NA1E023002,SCUOLA PRIMARIA,4,9,9,0,0,0
202223,RM1E06200G,SCUOLA PRIMARIA,3,16,16,0,0,0
202223,PAPM72500D,SCUOLA SECONDARIA II GRADO,4,2,2,0,0,0
202223,ENTDID500H,SCUOLA SECONDARIA II GRADO,5,22,21,1,1,0
202223,NATD8F500U,SCUOLA SECONDARIA II GRADO,2,12,12,0,0,0
202223,NATD51500C,SCUOLA SECONDARIA II GRADO,5,68,68,0,0,0
202223,BLPSMD500A,SCUOLA SECONDARIA II GRADO,4,4,4,0,0,0
202223,NATHA4500E,SCUOLA SECONDARIA II GRADO,4,3,3,0,0,0
202223,SAPMP9500T,SCUOLA SECONDARIA II GRADO,3,1,1,0,0,0
202223,FI1E02500D,SCUOLA PRIMARIA,5,26,17,9,1,8
202223,CE1E06200P,SCUOLA PRIMARIA,3,9,9,0,0,0
202223,BGSLN6500G,SCUOLA SECONDARIA II GRADO,5,17,17,0,0,0
202223,BS1E02600T,SCUOLA PRIMARIA,2,13,13,0,0,0
202223,BS1M01600C,SCUOLA SECONDARIA I GRADO,1,38,36,2,0,2
202223,VATFMQ5008,SCUOLA SECONDARIA II GRADO,1,5,5,0,0,0
202223,TVPMRQ500V,SCUOLA SECONDARIA II GRADO,2,28,28,0,0,0
202223,TVPC035005,SCUOLA SECONDARIA II GRADO,3,3,3,0,0,0
202223,CZPM00500Q,SCUOLA SECONDARIA II GRADO,5,8,8,0,0,0
202223,BGTD1D5000,SCUOLA SECONDARIA II GRADO,4,17,17,0,0,0
202223,RM1M06300L,SCUOLA SECONDARIA I GRADO,1,23,22,1,0,1
202223,MOTD01500Q,SCUOLA SECONDARIA II GRADO,1,11,11,0,0,0
202223,VR1E003007,SCUOLA PRIMARIA,1,20,20,0,0,0
202223,RN1E006005,SCUOLA PRIMARIA,1,24,15,9,2,7
202223,RMPL07500N,SCUOLA SECONDARIA II GRADO,3,38,36,2,0,2
202223,MI1E020001,SCUOLA PRIMARIA,3,52,49,3,0,3
202223,RI1E00100D,SCUOLA PRIMARIA,5,23,22,1,0,1
202223,PE1E002008,SCUOLA PRIMARIA,1,19,17,2,1,1
202223,FR1E010004,SCUOLA PRIMARIA,2,9,9,0,0,0
202223,FR1M00200A,SCUOLA SECONDARIA I GRADO,1,49,47,2,0,2
202223,RGRHH6500Z,SCUOLA SECONDARIA II GRADO,3,6,5,1,1,0
202223,ME1E00400Q,SCUOLA PRIMARIA,1,7,7,0,0,0
202223,VI1M011003,SCUOLA SECONDARIA I GRADO,3,21,21,0,0,0
202223,TAPS02500A,SCUOLA SECONDARIA II GRADO,5,19,19,0,0,0
202223,BSPMVC500O,SCUOLA SECONDARIA II GRADO,4,15,14,1,0,1
202223,SATFRP500A,SCUOLA SECONDARIA II GRADO,1,9,9,0,0,0
202223,GE1M03300E,SCUOLA SECONDARIA I GRADO,2,50,40,10,0,10
202223,PATD87500G,SCUOLA SECONDARIA II GRADO,1,3,3,0,0,0
202223,UD1E00900V,SCUOLA PRIMARIA,1,10,10,0,0,0
202223,MIPS1R500A,SCUOLA SECONDARIA II GRADO,3,25,22,3,1,2
202223,AV1EE5500E,SCUOLA PRIMARIA,2,8,8,0,0,0
202223,NATANI5007,SCUOLA SECONDARIA II GRADO,2,3,3,0,0,0
202223,VI1E00400P,SCUOLA PRIMARIA,3,25,24,1,0,1
202223,TV1EAE500L,SCUOLA PRIMARIA,1,19,18,1,0,1
202223,RGTD105002,SCUOLA SECONDARIA II GRADO,1,2,2,0,0,0
202223,VAPLB6500A,SCUOLA SECONDARIA II GRADO,5,10,10,0,0,0
202223,RM1EQM5004,SCUOLA PRIMARIA,1,23,22,1,0,1
202223,LU1E00400X,SCUOLA PRIMARIA,4,12,11,1,0,1
202223,CETFAV500R,SCUOLA SECONDARIA II GRADO,4,10,10,0,0,0
202223,VE1E00400B,SCUOLA PRIMARIA,5,39,28,11,1,10
202223,FI1E00200R,SCUOLA PRIMARIA,3,34,33,1,0,1
202223,GE1E03600R,SCUOLA PRIMARIA,5,14,14,0,0,0
202223,AR1E00300R,SCUOLA PRIMARIA,4,14,14,0,0,0
202223,RMTD325008,SCUOLA SECONDARIA II GRADO,1,6,6,0,0,0
202223,MI1E076001,SCUOLA PRIMARIA,1,26,25,1,0,1
202223,SA1E02900B,SCUOLA PRIMARIA,5,22,22,0,0,0
202223,TOSL01500G,SCUOLA SECONDARIA II GRADO,2,28,27,1,1,0
202223,VETN745000,SCUOLA SECONDARIA II GRADO,3,17,17,0,0,0
202223,RM1E04500T,SCUOLA PRIMARIA,3,13,13,0,0,0
202223,SR1E009008,SCUOLA PRIMARIA,1,11,11,0,0,0
202223,GE1E01100C,SCUOLA PRIMARIA,2,46,46,0,0,0
202223,PV1E008004,SCUOLA PRIMARIA,5,20,20,0,0,0
202223,SATDH85000,SCUOLA SECONDARIA II GRADO,4,6,6,0,0,0
202223,NARH3Z5008,SCUOLA SECONDARIA II GRADO,1,5,5,0,0,0
202223,NARHV2500V,SCUOLA SECONDARIA II GRADO,2,15,13,2,0,2
202223,PA1EC8500U,SCUOLA PRIMARIA,3,9,9,0,0,0
202223,PD1E018007,SCUOLA PRIMARIA,4,48,44,4,1,3
202223,NA1E270009,SCUOLA PRIMARIA,3,16,16,0,0,0
202223,RMPSRQ500V,SCUOLA SECONDARIA II GRADO,1,40,40,0,0,0
202223,FG1E00500G,SCUOLA PRIMARIA,4,26,26,0,0,0
202223,MS1E002007,SCUOLA PRIMARIA,4,25,25,0,0,0
202223,MITNUQ500H,SCUOLA SECONDARIA II GRADO,2,31,25,6,0,6
202223,NA1E00300R,SCUOLA PRIMARIA,3,10,4,6,0,6
202223,CLTD9T500A,SCUOLA SECONDARIA II GRADO,3,4,4,0,0,0
202223,VI1E00600A,SCUOLA PRIMARIA,1,18,17,1,1,0
202223,NA1E19600L,SCUOLA PRIMARIA,2,10,9,1,0,1
202223,LETD075009,SCUOLA SECONDARIA II GRADO,1,4,4,0,0,0
202223,BO1EL9500N,SCUOLA PRIMARIA,3,16,16,0,0,0
202223,MIPM58500Q,SCUOLA SECONDARIA II GRADO,2,24,24,0,0,0
202223,BOPMNL500M,SCUOLA SECONDARIA II GRADO,4,29,28,1,0,1
202223,NARF5I500H,SCUOLA SECONDARIA II GRADO,2,24,24,0,0,0
202223,SATDG0500E,SCUOLA SECONDARIA II GRADO,3,5,5,0,0,0
202223,PA1E4O500T,SCUOLA PRIMARIA,2,14,12,2,0,2
202223,TOPS07500A,SCUOLA SECONDARIA II GRADO,4,24,23,1,0,1
202223,RM1E16000R,SCUOLA PRIMARIA,2,14,13,1,1,0
202223,RM1E14600E,SCUOLA PRIMARIA,1,14,13,1,1,0
202223,RM1E113007,SCUOLA PRIMARIA,2,15,15,0,0,0
202223,RC1E005008,SCUOLA PRIMARIA,5,21,21,0,0,0
202223,ENRHA05008,SCUOLA SECONDARIA II GRADO,1,3,3,0,0,0
202223,BLPMMN5000,SCUOLA SECONDARIA II GRADO,4,8,8,0,0,0
202223,NAPMUF500A,SCUOLA SECONDARIA II GRADO,3,12,12,0,0,0
202223,PD1E013004,SCUOLA PRIMARIA,5,44,42,2,0,2
202223,RMSL5N500U,SCUOLA SECONDARIA II GRADO,1,4,4,0,0,0
202223,PV1M004002,SCUOLA SECONDARIA I GRADO,2,19,16,3,0,3
202223,MI1E13300X,SCUOLA PRIMARIA,2,26,25,1,0,1
202223,MI1M04900T,SCUOLA SECONDARIA I GRADO,3,49,49,0,0,0
202223,LCPSG9500D,SCUOLA SECONDARIA II GRADO,4,17,17,0,0,0
202223,NAPC135007,SCUOLA SECONDARIA II GRADO,1,5,5,0,0,0
202223,NAPM015009,SCUOLA SECONDARIA II GRADO,3,16,15,1,0,1
202223,TO1M012007,SCUOLA SECONDARIA I GRADO,1,45,43,2,0,2
202223,SATDR35003,SCUOLA SECONDARIA II GRADO,4,10,10,0,0,0
202223,RM1E00900P,SCUOLA PRIMARIA,3,36,34,2,0,2
202223,PR1M00500L,SCUOLA SECONDARIA I GRADO,2,45,45,0,0,0
202223,FI1E00700X,SCUOLA PRIMARIA,1,8,8,0,0,0
202223,NA1M032002,SCUOLA SECONDARIA I GRADO,2,13,13,0,0,0
202223,BSPS3I500U,SCUOLA SECONDARIA II GRADO,2,16,14,2,0,2
202223,BSRF3E5000,SCUOLA SECONDARIA II GRADO,1,2,0,2,0,2
202223,TOPS76500T,SCUOLA SECONDARIA II GRADO,2,48,46,2,1,1
202223,RMPL26500R,SCUOLA SECONDARIA II GRADO,3,14,14,0,0,0
202223,AT1E00200G,SCUOLA PRIMARIA,3,24,22,2,1,1
202223,RCTDO0500U,SCUOLA SECONDARIA II GRADO,3,2,2,0,0,0
202223,MI1E124005,SCUOLA PRIMARIA,2,9,8,1,0,1
202223,LCPS01500L,SCUOLA SECONDARIA II GRADO,3,17,17,0,0,0
202223,SA1E00700E,SCUOLA PRIMARIA,3,9,9,0,0,0
202223,AL1M00800P,SCUOLA SECONDARIA I GRADO,2,57,55,2,1,1
202223,MIPMZS500F,SCUOLA SECONDARIA II GRADO,1,28,28,0,0,0
202223,FIPL06500X,SCUOLA SECONDARIA II GRADO,5,4,4,0,0,0
202223,FRPC02500X,SCUOLA SECONDARIA II GRADO,3,10,10,0,0,0
202223,PATD26500Q,SCUOLA SECONDARIA II GRADO,1,6,6,0,0,0
202223,LTPST2500E,SCUOLA SECONDARIA II GRADO,2,13,13,0,0,0
202223,CERIPM5008,SCUOLA SECONDARIA II GRADO,3,8,8,0,0,0
202223,PD1E01700B,SCUOLA PRIMARIA,2,23,23,0,0,0
202223,MB1E02800C,SCUOLA PRIMARIA,4,52,52,0,0,0
202223,PR1E01000V,SCUOLA PRIMARIA,5,42,41,1,0,1
202223,CO1E00200G,SCUOLA PRIMARIA,2,19,18,1,0,1
202223,NOTB12500G,SCUOLA SECONDARIA II GRADO,5,3,3,0,0,0
202223,VAPSDE500S,SCUOLA SECONDARIA II GRADO,5,25,25,0,0,0
202223,LITD02500G,SCUOLA SECONDARIA II GRADO,1,12,12,0,0,0
202223,NARHZL500O,SCUOLA SECONDARIA II GRADO,2,11,11,0,0,0
202223,TOPSA6500N,SCUOLA SECONDARIA II GRADO,5,4,4,0,0,0
202223,RMPS505001,SCUOLA SECONDARIA II GRADO,2,15,15,0,0,0
202223,SP1E00400X,SCUOLA PRIMARIA,3,26,26,0,0,0
202223,PT1E004006,SCUOLA PRIMARIA,5,17,14,3,0,3
202223,FIPC035006,SCUOLA SECONDARIA II GRADO,2,3,3,0,0,0
202223,MIPS04500E,SCUOLA SECONDARIA II GRADO,5,12,12,0,0,0
202223,NA1E02100A,SCUOLA PRIMARIA,2,13,13,0,0,0
202223,AVTFTA500S,SCUOLA SECONDARIA II GRADO,4,3,3,0,0,0
202223,NA1E24500L,SCUOLA PRIMARIA,5,22,22,0,0,0
202223,VATD12500X,SCUOLA SECONDARIA II GRADO,2,13,13,0,0,0
202223,TO1M054009,SCUOLA SECONDARIA I GRADO,1,59,57,2,1,1
202223,NA1E122003,SCUOLA PRIMARIA,1,39,39,0,0,0
202223,VAPSZ2500H,SCUOLA SECONDARIA II GRADO,1,20,19,1,0,1
202223,RMPC10500A,SCUOLA SECONDARIA II GRADO,2,25,25,0,0,0
202223,CR1M00300Q,SCUOLA SECONDARIA I GRADO,3,56,55,1,1,0
202223,TVTB205003,SCUOLA SECONDARIA II GRADO,3,23,21,2,0,2
202223,LIPL01500X,SCUOLA SECONDARIA II GRADO,5,6,6,0,0,0
202223,APPSZ65005,SCUOLA SECONDARIA II GRADO,1,9,9,0,0,0
202223,SAPS975006,SCUOLA SECONDARIA II GRADO,3,6,6,0,0,0
202223,FI1E02300T,SCUOLA PRIMARIA,2,22,16,6,0,6
202223,PT1E00600T,SCUOLA PRIMARIA,4,22,20,2,0,2
202223,RMPC285004,SCUOLA SECONDARIA II GRADO,1,20,20,0,0,0
202223,AVTF1Q5009,SCUOLA SECONDARIA II GRADO,4,9,9,0,0,0
202223,NA1E148007,SCUOLA PRIMARIA,1,10,10,0,0,0
202223,NAPS25500C,SCUOLA SECONDARIA II GRADO,4,6,6,0,0,0
202223,NAPSAT500N,SCUOLA SECONDARIA II GRADO,5,33,32,1,0,1
202223,MI1M004008,SCUOLA SECONDARIA I GRADO,2,74,71,3,1,2
202223,SAPSNV500C,SCUOLA SECONDARIA II GRADO,3,4,4,0,0,0
202223,VVPS2U500I,SCUOLA SECONDARIA II GRADO,4,16,16,0,0,0
202223,TA1E00700G,SCUOLA PRIMARIA,4,15,14,1,0,1
202223,BSPS0H500D,SCUOLA SECONDARIA II GRADO,1,21,18,3,1,2
202223,BO1E00900D,SCUOLA PRIMARIA,5,62,62,0,0,0
202223,RMPLNG500S,SCUOLA SECONDARIA II GRADO,5,10,10,0,0,0
202223,BNTF2A500Q,SCUOLA SECONDARIA II GRADO,1,7,7,0,0,0
202223,GEPSC85001,SCUOLA SECONDARIA II GRADO,2,9,8,1,0,1
202223,MBPL315001,SCUOLA SECONDARIA II GRADO,3,22,22,0,0,0
202223,NO1M001009,SCUOLA SECONDARIA I GRADO,1,98,96,2,1,1
202223,SARFMI5004,SCUOLA SECONDARIA II GRADO,3,4,3,1,0,1
202223,TO1E02600X,SCUOLA PRIMARIA,5,42,35,7,1,6
202223,RM1E07400T,SCUOLA PRIMARIA,2,16,16,0,0,0
202223,SA1E020001,SCUOLA PRIMARIA,5,20,20,0,0,0
202223,PAPS5E500M,SCUOLA SECONDARIA II GRADO,3,3,3,0,0,0
202223,LTTN125009,SCUOLA SECONDARIA II GRADO,5,27,25,2,0,2
202223,SATL09500T,SCUOLA SECONDARIA II GRADO,1,6,6,0,0,0
202223,CE1E01800L,SCUOLA PRIMARIA,5,10,10,0,0,0
202223,MI1E08600G,SCUOLA PRIMARIA,4,50,40,10,1,9
202223,PA1E005009,SCUOLA PRIMARIA,4,38,38,0,0,0
202223,RCTD1B500I,SCUOLA SECONDARIA II GRADO,5,15,15,0,0,0
202223,MBPC27500T,SCUOLA SECONDARIA II GRADO,2,19,19,0,0,0
202223,BATD65500E,SCUOLA SECONDARIA II GRADO,5,14,14,0,0,0
202223,BG1E01000Q,SCUOLA PRIMARIA,1,16,15,1,0,1
202223,MO1MSQ500N,SCUOLA SECONDARIA I GRADO,1,17,17,0,0,0
202223,CA1E00900B,SCUOLA PRIMARIA,5,26,26,0,0,0
202223,BGPS02500P,SCUOLA SECONDARIA II GRADO,2,35,34,1,1,0
202223,GE1E013004,SCUOLA PRIMARIA,5,10,10,0,0,0
202223,TO1E02200L,SCUOLA PRIMARIA,4,21,21,0,0,0
202223,VA1E41500F,SCUOLA PRIMARIA,4,13,13,0,0,0
202223,NA1E200003,SCUOLA PRIMARIA,4,10,10,0,0,0
202223,VR1M00800G,SCUOLA SECONDARIA I GRADO,2,81,77,4,1,3
202223,COPSI65000,SCUOLA SECONDARIA II GRADO,3,19,19,0,0,0
202223,NA1E04600P,SCUOLA PRIMARIA,1,15,15,0,0,0
202223,RM1E13200L,SCUOLA PRIMARIA,3,27,26,1,0,1
202223,MIPL08500Q,SCUOLA SECONDARIA II GRADO,5,17,17,0,0,0
202223,CO1MCB500P,SCUOLA SECONDARIA I GRADO,3,19,17,2,0,2
202223,FIPL8A500L,SCUOLA SECONDARIA II GRADO,1,7,3,4,1,3
202223,CE1E00600A,SCUOLA PRIMARIA,5,18,14,4,0,4
202223,FIPS00500D,SCUOLA SECONDARIA II GRADO,5,40,40,0,0,0
202223,MBPSIE500B,SCUOLA SECONDARIA II GRADO,3,8,8,0,0,0
202223,RM1M11900B,SCUOLA SECONDARIA I GRADO,1,62,60,2,0,2
202223,MI1E053008,SCUOLA PRIMARIA,2,71,70,1,0,1
202223,RMPMPL5008,SCUOLA SECONDARIA II GRADO,5,39,37,2,1,1
202223,CRPS00500B,SCUOLA SECONDARIA II GRADO,5,17,15,2,1,1
202223,CA1E00700Q,SCUOLA PRIMARIA,4,22,22,0,0,0
202223,NAPSZI500L,SCUOLA SECONDARIA II GRADO,4,22,22,0,0,0
202223,RMTF18500C,SCUOLA SECONDARIA II GRADO,1,10,8,2,1,1
202223,TO1E02900B,SCUOLA PRIMARIA,3,21,20,1,0,1
202223,PEPMDE500O,SCUOLA SECONDARIA II GRADO,5,7,7,0,0,0
202223,VI1M017002,SCUOLA SECONDARIA I GRADO,3,34,32,2,0,2
202223,BSPC12500Q,SCUOLA SECONDARIA II GRADO,2,7,7,0,0,0
202223,MI1M103009,SCUOLA SECONDARIA I GRADO,3,26,25,1,0,1
202223,NATFI55003,SCUOLA SECONDARIA II GRADO,3,4,4,0,0,0
202223,NATDGC5003,SCUOLA SECONDARIA II GRADO,4,31,31,0,0,0
202223,MIPL265008,SCUOLA SECONDARIA II GRADO,3,14,14,0,0,0
202223,NA1E15300P,SCUOLA PRIMARIA,2,12,12,0,0,0
202223,PD1E012008,SCUOLA PRIMARIA,5,23,23,0,0,0
202223,BG1E03200L,SCUOLA PRIMARIA,3,36,36,0,0,0
202223,MIPS72500B,SCUOLA SECONDARIA II GRADO,4,6,6,0,0,0
202223,SATF5C5002,SCUOLA SECONDARIA II GRADO,4,3,3,0,0,0
202223,MTTD01500D,SCUOLA SECONDARIA II GRADO,3,3,3,0,0,0
202223,BSSL01500D,SCUOLA SECONDARIA II GRADO,1,50,48,2,1,1
202223,TO1E012002,SCUOLA PRIMARIA,3,23,23,0,0,0
202223,ANTD03500D,SCUOLA SECONDARIA II GRADO,5,30,28,2,1,1
202223,TATDI4500D,SCUOLA SECONDARIA II GRADO,1,6,5,1,1,0
202223,APPMOI500F,SCUOLA SECONDARIA II GRADO,5,20,19,1,0,1
202223,NA1E064008,SCUOLA PRIMARIA,3,20,11,9,0,9
202223,RMTN8V500Q,SCUOLA SECONDARIA II GRADO,5,52,42,10,2,8
202223,REPMPU500Q,SCUOLA SECONDARIA II GRADO,4,14,14,0,0,0
202223,NAPLVR500O,SCUOLA SECONDARIA II GRADO,1,15,13,2,0,2
202223,RGPMSZ500N,SCUOLA SECONDARIA II GRADO,3,2,2,0,0,0
202223,CTTD215006,SCUOLA SECONDARIA II GRADO,1,2,2,0,0,0
202223,RM1E007003,SCUOLA PRIMARIA,1,18,14,4,2,2
202223,FITD01500X,SCUOLA SECONDARIA II GRADO,5,14,14,0,0,0
202223,MIPSZR500P,SCUOLA SECONDARIA II GRADO,1,35,33,2,0,2
202223,BS1E02200E,SCUOLA PRIMARIA,1,59,50,9,1,8
202223,SATFH8500N,SCUOLA SECONDARIA II GRADO,5,66,62,4,2,2
202223,COPM02500E,SCUOLA SECONDARIA II GRADO,2,26,26,0,0,0
202223,VRTD04500A,SCUOLA SECONDARIA II GRADO,5,14,13,1,0,1
202223,MIPS16500L,SCUOLA SECONDARIA II GRADO,4,80,80,0,0,0
202223,PA1E00400D,SCUOLA PRIMARIA,2,22,21,1,1,0
202223,CT1E016007,SCUOLA PRIMARIA,3,65,63,2,1,1
202223,SATFCA5002,SCUOLA SECONDARIA II GRADO,5,53,51,2,1,1
202223,RMTD58500N,SCUOLA SECONDARIA II GRADO,1,30,30,0,0,0
202223,MIPSEN500E,SCUOLA SECONDARIA II GRADO,3,55,55,0,0,0
202223,NA1E22900P,SCUOLA PRIMARIA,1,15,15,0,0,0
202223,PV1MF4500I,SCUOLA SECONDARIA I GRADO,1,21,17,4,0,4
202223,NATD2T5008,SCUOLA SECONDARIA II GRADO,1,1,1,0,0,0
202223,MI1E017005,SCUOLA PRIMARIA,2,70,66,4,3,1
202223,GE1E02500A,SCUOLA PRIMARIA,1,17,13,4,0,4
202223,NARH05500C,SCUOLA SECONDARIA II GRADO,1,3,3,0,0,0
202223,NARH9B500E,SCUOLA SECONDARIA II GRADO,5,136,132,4,1,3
202223,CT1M00100P,SCUOLA SECONDARIA I GRADO,2,4,4,0,0,0
202223,FGTDO25007,SCUOLA SECONDARIA II GRADO,4,6,6,0,0,0
202223,CTPC605004,SCUOLA SECONDARIA II GRADO,4,4,4,0,0,0
202223,GE1M00800T,SCUOLA SECONDARIA I GRADO,1,14,11,3,0,3
202223,CN1EN55004,SCUOLA PRIMARIA,1,17,15,2,2,0
202223,MC1EMU5009,SCUOLA PRIMARIA,2,15,14,1,1,0
202223,RMTD72500Q,SCUOLA SECONDARIA II GRADO,3,10,9,1,1,0
202223,RM1M09300C,SCUOLA SECONDARIA I GRADO,1,13,12,1,0,1
202223,RM1E198007,SCUOLA PRIMARIA,1,15,13,2,2,0
202223,CAPQ00500E,SCUOLA SECONDARIA II GRADO,1,21,21,0,0,0
202223,RE1E00300T,SCUOLA PRIMARIA,1,38,37,1,0,1
202223,GE1E018007,SCUOLA PRIMARIA,1,12,10,2,0,2
202223,SA1E02200L,SCUOLA PRIMARIA,5,17,17,0,0,0
202223,MIPS085001,SCUOLA SECONDARIA II GRADO,4,38,37,1,0,1
202223,MERHFN500I,SCUOLA SECONDARIA II GRADO,2,5,5,0,0,0
202223,SATD22500V,SCUOLA SECONDARIA II GRADO,2,2,2,0,0,0
202223,RM1E21000L,SCUOLA PRIMARIA,1,23,23,0,0,0
202223,PA1MB95007,SCUOLA SECONDARIA I GRADO,2,38,36,2,0,2
202223,PDPM00500B,SCUOLA SECONDARIA II GRADO,1,50,50,0,0,0
202223,RC1M00400N,SCUOLA SECONDARIA I GRADO,1,21,20,1,0,1
202223,CZPL925000,SCUOLA SECONDARIA II GRADO,2,10,9,1,0,1
202223,FGTD095004,SCUOLA SECONDARIA II GRADO,3,4,4,0,0,0
202223,BNPC02500R,SCUOLA SECONDARIA II GRADO,5,14,14,0,0,0
202223,MBSL05500V,SCUOLA SECONDARIA II GRADO,3,81,79,2,1,1
202223,NO1E006007,SCUOLA PRIMARIA,1,46,41,5,0,5
202223,NA1E18300E,SCUOLA PRIMARIA,5,42,42,0,0,0
202223,NO1M01200Q,SCUOLA SECONDARIA I GRADO,1,23,22,1,0,1
202223,CE1E06400A,SCUOLA PRIMARIA,1,11,11,0,0,0
202223,CTTE01500X,SCUOLA SECONDARIA II GRADO,4,28,28,0,0,0
202223,VI1E01100T,SCUOLA PRIMARIA,2,22,18,4,1,3
202223,ISPM1I500P,SCUOLA SECONDARIA II GRADO,3,7,7,0,0,0
202223,RM1E119006,SCUOLA PRIMARIA,4,18,18,0,0,0
202223,BGTF1A500N,SCUOLA SECONDARIA II GRADO,2,5,5,0,0,0
202223,TOPMP2500E,SCUOLA SECONDARIA II GRADO,3,16,16,0,0,0
202223,MBTD37500N,SCUOLA SECONDARIA II GRADO,4,24,24,0,0,0
202223,RM1M057009,SCUOLA SECONDARIA I GRADO,2,74,74,0,0,0
202223,RMPC00500D,SCUOLA SECONDARIA II GRADO,5,31,31,0,0,0
202223,MIPSQV500F,SCUOLA SECONDARIA II GRADO,3,26,26,0,0,0
202223,MOTD04500G,SCUOLA SECONDARIA II GRADO,3,12,10,2,1,1
202223,RMPMTS5005,SCUOLA SECONDARIA II GRADO,2,12,12,0,0,0
202223,CHRFQQ5004,SCUOLA SECONDARIA II GRADO,3,4,4,0,0,0
202223,CHTD035004,SCUOLA SECONDARIA II GRADO,5,22,18,4,4,0
202223,CA1E01100B,SCUOLA PRIMARIA,4,21,20,1,0,1
202223,VIPM01500B,SCUOLA SECONDARIA II GRADO,1,16,14,2,0,2
202223,RA1M001001,SCUOLA SECONDARIA I GRADO,1,16,15,1,0,1
202223,RGRIAG500E,SCUOLA SECONDARIA II GRADO,1,22,19,3,2,1
202223,MI1M01400V,SCUOLA SECONDARIA I GRADO,2,66,66,0,0,0
202223,NAPC08500B,SCUOLA SECONDARIA II GRADO,1,7,7,0,0,0
202223,NAPC24500P,SCUOLA SECONDARIA II GRADO,1,9,9,0,0,0
202223,PE1E003004,SCUOLA PRIMARIA,4,21,21,0,0,0
202223,LE1E00800D,SCUOLA PRIMARIA,5,20,19,1,1,0
202223,FR1E00500L,SCUOLA PRIMARIA,3,15,15,0,0,0
202223,MCRHOE500M,SCUOLA SECONDARIA II GRADO,5,9,9,0,0,0
202223,NAPMTL5004,SCUOLA SECONDARIA II GRADO,3,4,4,0,0,0
202223,CTTD365004,SCUOLA SECONDARIA II GRADO,5,52,50,2,2,0
202223,PASD005001,SCUOLA SECONDARIA II GRADO,2,91,91,0,0,0
202223,CZ1E002002,SCUOLA PRIMARIA,5,22,22,0,0,0
202223,VA1M00800D,SCUOLA SECONDARIA I GRADO,1,94,91,3,0,3
202223,PO1E00900G,SCUOLA PRIMARIA,3,21,14,7,0,7
202223,PA1E03800L,SCUOLA PRIMARIA,4,12,12,0,0,0
202223,PS1E00500V,SCUOLA PRIMARIA,1,17,17,0,0,0
202223,SATFVU500C,SCUOLA SECONDARIA II GRADO,2,4,2,2,0,2
202223,UD1E00600B,SCUOLA PRIMARIA,3,32,30,2,1,1
202223,PATDL85002,SCUOLA SECONDARIA II GRADO,5,15,14,1,0,1
202223,MIPS8E5005,SCUOLA SECONDARIA II GRADO,4,12,12,0,0,0
202223,NA1E22300Q,SCUOLA PRIMARIA,3,50,49,1,1,0
202223,BS1E011004,SCUOLA PRIMARIA,4,25,24,1,1,0
202223,TVRA3C5009,SCUOLA SECONDARIA II GRADO,3,27,26,1,0,1
202223,RMSLR1500M,SCUOLA SECONDARIA II GRADO,2,7,6,1,1,0
202223,NARHZ8500V,SCUOLA SECONDARIA II GRADO,4,9,9,0,0,0
202223,CH1E006003,SCUOLA PRIMARIA,2,13,13,0,0,0
202223,RM1E04500T,SCUOLA PRIMARIA,4,17,17,0,0,0
202223,SR1E00600R,SCUOLA PRIMARIA,5,17,17,0,0,0
202223,MISL025006,SCUOLA SECONDARIA II GRADO,2,52,52,0,0,0
202223,NA1ED8500Q,SCUOLA PRIMARIA,4,3,3,0,0,0
202223,VE1E00900E,SCUOLA PRIMARIA,5,23,23,0,0,0
202223,NARHV2500V,SCUOLA SECONDARIA II GRADO,3,2,2,0,0,0
202223,NA1E027009,SCUOLA PRIMARIA,5,20,19,1,0,1
202223,TO1M018006,SCUOLA SECONDARIA I GRADO,3,22,22,0,0,0
202223,FI1E00900G,SCUOLA PRIMARIA,3,21,16,5,0,5
202223,CTPS075008,SCUOLA SECONDARIA II GRADO,4,32,29,3,0,3
202223,GE1M00300P,SCUOLA SECONDARIA I GRADO,2,43,41,2,1,1
202223,RMPM17500R,SCUOLA SECONDARIA II GRADO,3,21,21,0,0,0
202223,AQ1E00600N,SCUOLA PRIMARIA,1,8,6,2,1,1
202223,NA1E21700C,SCUOLA PRIMARIA,3,27,27,0,0,0
202223,BS1E01500B,SCUOLA PRIMARIA,3,39,37,2,0,2
202223,LO1M010007,SCUOLA SECONDARIA I GRADO,1,26,26,0,0,0
202223,RM1E04000P,SCUOLA PRIMARIA,2,19,12,7,0,7
202223,VEPMLV5000,SCUOLA SECONDARIA II GRADO,3,18,18,0,0,0
202223,SATD075006,SCUOLA SECONDARIA II GRADO,1,15,14,1,1,0
202223,SR1M00200P,SCUOLA SECONDARIA I GRADO,1,18,15,3,0,3
202223,FI1E034008,SCUOLA PRIMARIA,4,24,24,0,0,0
202223,MIPM58500Q,SCUOLA SECONDARIA II GRADO,3,21,21,0,0,0
202223,AG1EVA500E,SCUOLA PRIMARIA,5,12,12,0,0,0
202223,TVPM4Q500B,SCUOLA SECONDARIA II GRADO,2,10,10,0,0,0
202223,NATF2C500R,SCUOLA SECONDARIA II GRADO,1,4,4,0,0,0
202223,NA1E25700V,SCUOLA PRIMARIA,1,12,12,0,0,0
202223,RM1E12900R,SCUOLA PRIMARIA,3,12,12,0,0,0
202223,BGTFMP5003,SCUOLA SECONDARIA II GRADO,2,11,10,1,0,1
202223,TOPC075007,SCUOLA SECONDARIA II GRADO,1,36,36,0,0,0
202223,NOPSUI500C,SCUOLA SECONDARIA II GRADO,2,3,3,0,0,0
202223,BNRHZS500C,SCUOLA SECONDARIA II GRADO,3,13,12,1,0,1
202223,MI1E039002,SCUOLA PRIMARIA,4,48,47,1,0,1
202223,NATL0L500Q,SCUOLA SECONDARIA II GRADO,5,70,62,8,4,4
202223,BA1E00400B,SCUOLA PRIMARIA,4,36,36,0,0,0
202223,CS1E002006,SCUOLA PRIMARIA,2,24,24,0,0,0
202223,RM1E044002,SCUOLA PRIMARIA,1,25,24,1,1,0
202223,MB1E06900P,SCUOLA PRIMARIA,5,24,23,1,0,1
202223,FI1E063008,SCUOLA PRIMARIA,3,14,14,0,0,0
202223,PV1E00400R,SCUOLA PRIMARIA,2,20,20,0,0,0
202223,TA1E009007,SCUOLA PRIMARIA,3,12,12,0,0,0
202223,MITD13500L,SCUOLA SECONDARIA II GRADO,3,20,19,1,0,1
202223,SSTF00500Q,SCUOLA SECONDARIA II GRADO,3,2,2,0,0,0
202223,SRTD08500V,SCUOLA SECONDARIA II GRADO,1,6,6,0,0,0
202223,TOPS76500T,SCUOLA SECONDARIA II GRADO,1,42,39,3,1,2
202223,CORC43500S,SCUOLA SECONDARIA II GRADO,3,8,8,0,0,0
202223,NA1E24000D,SCUOLA PRIMARIA,1,10,10,0,0,0
202223,RM1E14100B,SCUOLA PRIMARIA,4,25,25,0,0,0
202223,RC1E00200R,SCUOLA PRIMARIA,1,11,10,1,0,1
202223,CZ1M00100B,SCUOLA SECONDARIA I GRADO,2,11,11,0,0,0
202223,NA1E106005,SCUOLA PRIMARIA,5,15,15,0,0,0
202223,MI1E02700Q,SCUOLA PRIMARIA,4,12,12,0,0,0
202223,GEPMUO500T,SCUOLA SECONDARIA II GRADO,3,24,24,0,0,0
202223,GO1EUT5002,SCUOLA PRIMARIA,1,3,3,0,0,0
202223,NATL25500P,SCUOLA SECONDARIA II GRADO,1,13,12,1,0,1
202223,NATHE15007,SCUOLA SECONDARIA II GRADO,4,5,5,0,0,0
202223,LI1E005009,SCUOLA PRIMARIA,2,21,18,3,1,2
202223,APPM04500X,SCUOLA SECONDARIA II GRADO,5,25,25,0,0,0
202223,RMPS305007,SCUOLA SECONDARIA II GRADO,4,15,15,0,0,0
202223,SARHB65008,SCUOLA SECONDARIA II GRADO,3,3,3,0,0,0
202223,SAPSM3500V,SCUOLA SECONDARIA II GRADO,3,8,8,0,0,0
202223,RN1E001002,SCUOLA PRIMARIA,2,28,28,0,0,0
202223,PETN015009,SCUOLA SECONDARIA II GRADO,5,10,9,1,0,1
202223,MEPMEB500L,SCUOLA SECONDARIA II GRADO,5,8,7,1,0,1
202223,BSPS88500T,SCUOLA SECONDARIA II GRADO,1,12,12,0,0,0
202223,NA1M26500L,SCUOLA SECONDARIA I GRADO,1,25,2,23,15,8
202223,VBRH155008,SCUOLA SECONDARIA II GRADO,2,8,8,0,0,0
202223,SATF9L500V,SCUOLA SECONDARIA II GRADO,4,2,2,0,0,0
202223,MI1E082008,SCUOLA PRIMARIA,4,33,32,1,0,1
202223,BO1E00200P,SCUOLA PRIMARIA,5,45,43,2,0,2
202223,NA1E14500Q,SCUOLA PRIMARIA,5,28,28,0,0,0
202223,CT1E031009,SCUOLA PRIMARIA,2,16,16,0,0,0
202223,MBPQ035002,SCUOLA SECONDARIA II GRADO,5,33,33,0,0,0
202223,RM1E18300D,SCUOLA PRIMARIA,5,20,18,2,1,1
202223,LC1M070005,SCUOLA SECONDARIA I GRADO,3,53,53,0,0,0
202223,SARHE75006,SCUOLA SECONDARIA II GRADO,4,7,2,5,0,5
202223,TV1EAE500L,SCUOLA PRIMARIA,5,23,23,0,0,0
202223,TO1E018001,SCUOLA PRIMARIA,5,56,54,2,2,0
202223,RM1E064007,SCUOLA PRIMARIA,1,25,25,0,0,0
202223,FIPC035006,SCUOLA SECONDARIA II GRADO,3,9,9,0,0,0
202223,PAPMRG500C,SCUOLA SECONDARIA II GRADO,2,1,1,0,0,0
202223,VA1M9G500V,SCUOLA SECONDARIA I GRADO,1,99,96,3,0,3
202223,PO1EHR500Z,SCUOLA PRIMARIA,4,3,1,2,0,2
202223,VB1E001004,SCUOLA PRIMARIA,1,10,9,1,0,1
202223,CE1E002003,SCUOLA PRIMARIA,3,18,17,1,0,1
202223,NATDBQ500Q,SCUOLA SECONDARIA II GRADO,3,10,10,0,0,0
202223,SAPS005004,SCUOLA SECONDARIA II GRADO,5,12,12,0,0,0
202223,SAPL025004,SCUOLA SECONDARIA II GRADO,3,4,4,0,0,0
202223,NO1E00500B,SCUOLA PRIMARIA,2,14,13,1,1,0
202223,BOPS05500C,SCUOLA SECONDARIA II GRADO,4,29,29,0,0,0
202223,FIPC04500R,SCUOLA SECONDARIA II GRADO,2,3,2,1,0,1
202223,CERIOH500S,SCUOLA SECONDARIA II GRADO,5,13,13,0,0,0
202223,BG1MVN5002,SCUOLA SECONDARIA I GRADO,2,8,8,0,0,0
202223,VR1M02200T,SCUOLA SECONDARIA I GRADO,3,25,25,0,0,0
202223,SATLGF500Z,SCUOLA SECONDARIA II GRADO,1,11,11,0,0,0
202223,RM1E14400V,SCUOLA PRIMARIA,1,10,8,2,0,2
202223,RMPM9A500G,SCUOLA SECONDARIA II GRADO,4,12,12,0,0,0
202223,FIPS15500B,SCUOLA SECONDARIA II GRADO,5,20,19,1,0,1
202223,MO1E004008,SCUOLA PRIMARIA,3,27,27,0,0,0
202223,BATD01500V,SCUOLA SECONDARIA II GRADO,5,52,52,0,0,0
202223,RMPS575007,SCUOLA SECONDARIA II GRADO,3,5,4,1,0,1
202223,TO1E05000R,SCUOLA PRIMARIA,5,24,24,0,0,0
202223,TO1E03600E,SCUOLA PRIMARIA,5,48,32,16,9,7
202223,FI1E02900R,SCUOLA PRIMARIA,3,10,10,0,0,0
202223,PT1E00200E,SCUOLA PRIMARIA,5,15,15,0,0,0
202223,MEPM12500X,SCUOLA SECONDARIA II GRADO,2,1,1,0,0,0
202223,SATD9H500H,SCUOLA SECONDARIA II GRADO,5,69,66,3,1,2
202223,METL98500P,SCUOLA SECONDARIA II GRADO,5,33,33,0,0,0
202223,FR1E001009,SCUOLA PRIMARIA,1,17,17,0,0,0
202223,IS1MS7500N,SCUOLA SECONDARIA I GRADO,3,6,3,3,1,2
202223,PC1E002003,SCUOLA PRIMARIA,3,16,16,0,0,0
202223,PD1E00300D,SCUOLA PRIMARIA,4,24,24,0,0,0
202223,NATDAT500E,SCUOLA SECONDARIA II GRADO,5,65,64,1,0,1
202223,RMPS00500L,SCUOLA SECONDARIA II GRADO,1,1,1,0,0,0
202223,UD1E002004,SCUOLA PRIMARIA,5,22,21,1,0,1
202223,PVTD065009,SCUOLA SECONDARIA II GRADO,4,13,12,1,0,1
202223,RA1E00300B,SCUOLA PRIMARIA,5,43,41,2,0,2
202223,NA1E073003,SCUOLA PRIMARIA,3,22,22,0,0,0
202223,NA1E085009,SCUOLA PRIMARIA,2,16,16,0,0,0
202223,TV1E00700V,SCUOLA PRIMARIA,3,19,18,1,1,0
202223,NA1E00900Q,SCUOLA PRIMARIA,1,5,4,1,0,1
202223,CETD135008,SCUOLA SECONDARIA II GRADO,1,7,7,0,0,0
202223,NA1EM9500T,SCUOLA PRIMARIA,2,20,18,2,0,2
202223,BS1M025007,SCUOLA SECONDARIA I GRADO,2,37,37,0,0,0
202223,PATL095008,SCUOLA SECONDARIA II GRADO,3,4,4,0,0,0
202223,BG1E02900R,SCUOLA PRIMARIA,2,103,99,4,1,3
202223,MBPC27500T,SCUOLA SECONDARIA II GRADO,3,30,30,0,0,0
202223,NARI11500A,SCUOLA SECONDARIA II GRADO,3,8,8,0,0,0
202223,TO1E009006,SCUOLA PRIMARIA,5,25,24,1,1,0
202223,SATD01500E,SCUOLA SECONDARIA II GRADO,1,5,4,1,0,1
202223,BGPS02500P,SCUOLA SECONDARIA II GRADO,3,23,21,2,0,2
202223,RMPS41500P,SCUOLA SECONDARIA II GRADO,2,3,3,0,0,0
202223,GE1E01600G,SCUOLA PRIMARIA,4,21,19,2,0,2
202223,RMPL135004,SCUOLA SECONDARIA II GRADO,2,15,15,0,0,0
202223,CERHU1500P,SCUOLA SECONDARIA II GRADO,2,16,16,0,0,0
202223,RM1E00400G,SCUOLA PRIMARIA,4,14,14,0,0,0
202223,LTTD01500X,SCUOLA SECONDARIA II GRADO,1,5,5,0,0,0
202223,NARHRH500P,SCUOLA SECONDARIA II GRADO,5,105,104,1,1,0
202223,PD1M01100N,SCUOLA SECONDARIA I GRADO,1,52,51,1,0,1
202223,PAPMO7500Q,SCUOLA SECONDARIA II GRADO,3,20,17,3,0,3
202223,CE1E016001,SCUOLA PRIMARIA,1,15,14,1,0,1
202223,FG1E024001,SCUOLA PRIMARIA,3,11,9,2,1,1
202223,MB1M02200P,SCUOLA SECONDARIA I GRADO,3,49,47,2,1,1
202223,BG1E00400C,SCUOLA PRIMARIA,4,51,48,3,0,3
202223,MO1E013003,SCUOLA PRIMARIA,2,18,16,2,0,2
202223,VEPS015003,SCUOLA SECONDARIA II GRADO,5,13,13,0,0,0
202223,RE1E00400N,SCUOLA PRIMARIA,3,18,17,1,1,0
202223,BO1E01600L,SCUOLA PRIMARIA,3,41,40,1,0,1
202223,RM1E086004,SCUOLA PRIMARIA,5,7,7,0,0,0
202223,LTPSU65008,SCUOLA SECONDARIA II GRADO,4,4,4,0,0,0
202223,RM1EBQ5007,SCUOLA PRIMARIA,2,17,16,1,1,0
202223,CO1E012006,SCUOLA PRIMARIA,5,22,21,1,0,1
202223,MIPC15500V,SCUOLA SECONDARIA II GRADO,1,27,27,0,0,0
202223,TOPC10500T,SCUOLA SECONDARIA II GRADO,1,25,25,0,0,0
202223,RMPLLD5008,SCUOLA SECONDARIA II GRADO,2,15,15,0,0,0
202223,RM1E10700X,SCUOLA PRIMARIA,5,23,22,1,0,1
202223,CE1E06700T,SCUOLA PRIMARIA,3,10,10,0,0,0
202223,VARFR75004,SCUOLA SECONDARIA II GRADO,3,6,4,2,0,2
202223,RMPC19500T,SCUOLA SECONDARIA II GRADO,1,25,25,0,0,0
202223,MI1E04400D,SCUOLA PRIMARIA,1,17,17,0,0,0
202223,CR1M00200X,SCUOLA SECONDARIA I GRADO,2,52,48,4,0,4
202223,MO1E00900B,SCUOLA PRIMARIA,3,33,30,3,0,3
202223,RMPSAD500D,SCUOLA SECONDARIA II GRADO,3,11,11,0,0,0
202223,NAPLVR500O,SCUOLA SECONDARIA II GRADO,2,18,15,3,0,3
202223,MB1E058008,SCUOLA PRIMARIA,4,29,29,0,0,0
202223,SA1E01900R,SCUOLA PRIMARIA,4,6,6,0,0,0
202223,PERFNA5005,SCUOLA SECONDARIA II GRADO,1,2,2,0,0,0
202223,CTTL07500E,SCUOLA SECONDARIA II GRADO,3,11,11,0,0,0
202223,LT1E00400C,SCUOLA PRIMARIA,2,16,15,1,1,0
202223,CE1E030007,SCUOLA PRIMARIA,3,18,18,0,0,0
202223,MITD5V500H,SCUOLA SECONDARIA II GRADO,4,42,37,5,0,5
202223,PA1E034009,SCUOLA PRIMARIA,3,15,14,1,0,1
202223,VRPC04500B,SCUOLA SECONDARIA II GRADO,3,18,18,0,0,0
202223,MBRC6C500E,SCUOLA SECONDARIA II GRADO,3,17,16,1,0,1
202223,BN1M4D5009,SCUOLA SECONDARIA I GRADO,1,25,25,0,0,0
202223,VARH00500Q,SCUOLA SECONDARIA II GRADO,4,13,13,0,0,0
202223,MITL035006,SCUOLA SECONDARIA II GRADO,3,4,4,0,0,0
202223,NA1E18100V,SCUOLA PRIMARIA,5,27,9,18,16,2
202223,LCTF66500Z,SCUOLA SECONDARIA II GRADO,2,24,23,1,0,1
202223,MB1E052009,SCUOLA PRIMARIA,3,45,44,1,0,1
202223,CTTD34500V,SCUOLA SECONDARIA II GRADO,1,1,1,0,0,0
202223,MIRFHT500U,SCUOLA SECONDARIA II GRADO,2,25,25,0,0,0
202223,CETFS0500N,SCUOLA SECONDARIA II GRADO,3,8,8,0,0,0
202223,AVTD06500A,SCUOLA SECONDARIA II GRADO,1,8,8,0,0,0
202223,TOPS125006,SCUOLA SECONDARIA II GRADO,4,10,10,0,0,0
202223,PATD33500R,SCUOLA SECONDARIA II GRADO,2,3,3,0,0,0
202223,MI1E08500Q,SCUOLA PRIMARIA,3,18,18,0,0,0
202223,VR1M02900L,SCUOLA SECONDARIA I GRADO,3,44,44,0,0,0
202223,RMTD72500Q,SCUOLA SECONDARIA II GRADO,2,8,7,1,1,0
202223,NA1E22900P,SCUOLA PRIMARIA,3,14,13,1,0,1
202223,BS1E01800V,SCUOLA PRIMARIA,2,41,41,0,0,0
202223,RMSL02500P,SCUOLA SECONDARIA II GRADO,2,10,9,1,1,0
202223,PNPS9G5000,SCUOLA SECONDARIA II GRADO,2,25,25,0,0,0
202223,CS1E010005,SCUOLA PRIMARIA,4,14,13,1,1,0
202223,TV1M00800X,SCUOLA SECONDARIA I GRADO,1,63,61,2,2,0
202223,TV1E01200A,SCUOLA PRIMARIA,1,24,22,2,1,1
202223,MIPSVC500V,SCUOLA SECONDARIA II GRADO,3,25,25,0,0,0
202223,CT1M01600C,SCUOLA SECONDARIA I GRADO,2,17,17,0,0,0
202223,NA1E05000A,SCUOLA PRIMARIA,1,11,10,1,0,1
202223,VR1E02100R,SCUOLA PRIMARIA,4,25,25,0,0,0
202223,CE1E00900T,SCUOLA PRIMARIA,5,16,16,0,0,0
202223,VT1E001006,SCUOLA PRIMARIA,3,33,32,1,0,1
202223,UD1E00400Q,SCUOLA PRIMARIA,2,11,11,0,0,0
202223,NA1E21000N,SCUOLA PRIMARIA,1,27,27,0,0,0
202223,BS1E00500R,SCUOLA PRIMARIA,5,37,35,2,0,2
202223,RM1E04600N,SCUOLA PRIMARIA,5,18,17,1,0,1
202223,AGTD96500X,SCUOLA SECONDARIA II GRADO,5,27,26,1,1,0
202223,GE1E018007,SCUOLA PRIMARIA,3,22,22,0,0,0
202223,ALPS005007,SCUOLA SECONDARIA II GRADO,3,10,10,0,0,0
202223,PG1M00500G,SCUOLA SECONDARIA I GRADO,2,3,3,0,0,0
202223,SS1E00400L,SCUOLA PRIMARIA,4,12,7,5,2,3
202223,VR1M025009,SCUOLA SECONDARIA I GRADO,2,24,24,0,0,0
202223,CO1E01100A,SCUOLA PRIMARIA,1,38,38,0,0,0
202223,RC1E00800Q,SCUOLA PRIMARIA,1,15,15,0,0,0
202223,RMPM4G5004,SCUOLA SECONDARIA II GRADO,2,6,6,0,0,0
202223,MIPM01500Q,SCUOLA SECONDARIA II GRADO,3,26,26,0,0,0
202223,NATD575004,SCUOLA SECONDARIA II GRADO,5,68,67,1,0,1
202223,NA1E119007,SCUOLA PRIMARIA,4,24,24,0,0,0
202223,RMPSMF500G,SCUOLA SECONDARIA II GRADO,1,23,22,1,0,1
202223,CE1ME85005,SCUOLA SECONDARIA I GRADO,2,11,11,0,0,0
202223,MI1E025004,SCUOLA PRIMARIA,5,49,47,2,1,1
202223,NA1E212009,SCUOLA PRIMARIA,3,10,10,0,0,0
202223,MI1E06600A,SCUOLA PRIMARIA,3,56,52,4,2,2
202223,BSTL01500V,SCUOLA SECONDARIA II GRADO,4,4,4,0,0,0
202223,RM1E02400R,SCUOLA PRIMARIA,5,40,39,1,0,1
202223,SRTD06500N,SCUOLA SECONDARIA II GRADO,4,10,10,0,0,0
202223,PE1E003004,SCUOLA PRIMARIA,5,45,44,1,0,1
202223,FI1E03200L,SCUOLA PRIMARIA,2,13,12,1,0,1
202223,TVPS015003,SCUOLA SECONDARIA II GRADO,4,47,47,0,0,0
202223,SS1E01300B,SCUOLA PRIMARIA,3,12,12,0,0,0
202223,SRTHA6500C,SCUOLA SECONDARIA II GRADO,2,6,6,0,0,0
202223,KR1E002001,SCUOLA PRIMARIA,2,14,9,5,4,1
202223,BS1M01400R,SCUOLA SECONDARIA I GRADO,2,48,46,2,0,2
202223,BG1M00900R,SCUOLA SECONDARIA I GRADO,1,55,52,3,1,2
202223,COPS04500P,SCUOLA SECONDARIA II GRADO,2,10,10,0,0,0
202223,VRPS09500G,SCUOLA SECONDARIA II GRADO,2,22,21,1,0,1
202223,CT1E00100D,SCUOLA PRIMARIA,5,16,16,0,0,0
202223,NA1E12300V,SCUOLA PRIMARIA,4,24,24,0,0,0
202223,CE1ELC500C,SCUOLA PRIMARIA,3,12,12,0,0,0
202223,RMPC19500T,SCUOLA SECONDARIA II GRADO,2,22,21,1,0,1
202223,MIPSN6500B,SCUOLA SECONDARIA II GRADO,2,19,19,0,0,0
202223,NATHA4500E,SCUOLA SECONDARIA II GRADO,2,5,5,0,0,0
202223,MS1E002007,SCUOLA PRIMARIA,1,19,19,0,0,0
202223,CH1E006003,SCUOLA PRIMARIA,3,16,16,0,0,0
202223,BSTD355007,SCUOLA SECONDARIA II GRADO,5,17,14,3,1,2
202223,TATF035003,SCUOLA SECONDARIA II GRADO,1,12,12,0,0,0
202223,MI1EMR500E,SCUOLA PRIMARIA,4,64,61,3,0,3
202223,VR1E00100G,SCUOLA PRIMARIA,1,23,18,5,0,5
202223,MCTFBF5005,SCUOLA SECONDARIA II GRADO,5,27,23,4,2,2
202223,PDRHMH500P,SCUOLA SECONDARIA II GRADO,4,17,14,3,1,2
202223,CE1E043009,SCUOLA PRIMARIA,4,18,16,2,0,2
202223,PE1E00400X,SCUOLA PRIMARIA,4,49,49,0,0,0
202223,CE1E06200P,SCUOLA PRIMARIA,1,11,11,0,0,0
202223,BGPS505007,SCUOLA SECONDARIA II GRADO,1,21,21,0,0,0
202223,PG1EPF500P,SCUOLA PRIMARIA,2,21,20,1,1,0
202223,VA1M004006,SCUOLA SECONDARIA I GRADO,2,47,46,1,1,0
202223,MERHH5500F,SCUOLA SECONDARIA II GRADO,4,1,1,0,0,0
202223,PO1E00900G,SCUOLA PRIMARIA,4,22,15,7,0,7
202223,VB1M02000P,SCUOLA SECONDARIA I GRADO,3,18,18,0,0,0
202223,TVPS035008,SCUOLA SECONDARIA II GRADO,5,23,23,0,0,0
202223,GE1M00300P,SCUOLA SECONDARIA I GRADO,3,38,34,4,1,3
202223,MIPC18500P,SCUOLA SECONDARIA II GRADO,1,28,28,0,0,0
202223,BGTD1D5000,SCUOLA SECONDARIA II GRADO,2,24,21,3,0,3
202223,UD1E00600B,SCUOLA PRIMARIA,1,42,42,0,0,0
202223,MIPS295009,SCUOLA SECONDARIA II GRADO,5,42,40,2,0,2
202223,PA1E02600A,SCUOLA PRIMARIA,1,10,9,1,0,1
202223,RMTAZI500E,SCUOLA SECONDARIA II GRADO,3,9,9,0,0,0
202223,NATFTA500I,SCUOLA SECONDARIA II GRADO,4,3,3,0,0,0
202223,CSRFQA500F,SCUOLA SECONDARIA II GRADO,5,10,10,0,0,0
202223,VR1E003007,SCUOLA PRIMARIA,2,12,12,0,0,0
202223,RMPL07500N,SCUOLA SECONDARIA II GRADO,4,25,23,2,0,2
202223,CERI59500T,SCUOLA SECONDARIA II GRADO,5,59,59,0,0,0
202223,TO1M039007,SCUOLA SECONDARIA I GRADO,2,141,138,3,1,2
202223,NA1M015008,SCUOLA SECONDARIA I GRADO,3,34,34,0,0,0
202223,RM1E200002,SCUOLA PRIMARIA,3,6,6,0,0,0
202223,FI1E00400C,SCUOLA PRIMARIA,2,28,26,2,0,2
202223,BG1M01900B,SCUOLA SECONDARIA I GRADO,2,77,75,2,0,2
202223,CTPS10500V,SCUOLA SECONDARIA II GRADO,2,4,4,0,0,0
202223,NATF41500Q,SCUOLA SECONDARIA II GRADO,4,4,4,0,0,0
202223,GE1E03600R,SCUOLA PRIMARIA,1,23,22,1,0,1
202223,UDPSMD500L,SCUOLA SECONDARIA II GRADO,5,14,14,0,0,0
202223,FIPS035009,SCUOLA SECONDARIA II GRADO,5,17,16,1,0,1
202223,APTFOR5004,SCUOLA SECONDARIA II GRADO,3,15,14,1,0,1
202223,MIPS1R500A,SCUOLA SECONDARIA II GRADO,2,38,37,1,0,1
202223,MB1M018003,SCUOLA SECONDARIA I GRADO,2,77,77,0,0,0
202223,RMPS95500D,SCUOLA SECONDARIA II GRADO,4,15,15,0,0,0
202223,RE1E008001,SCUOLA PRIMARIA,5,37,37,0,0,0
202223,ALRH01500G,SCUOLA SECONDARIA II GRADO,3,29,29,0,0,0
202223,RM1E21500Q,SCUOLA PRIMARIA,2,21,18,3,0,3
202223,NARHTO500T,SCUOLA SECONDARIA II GRADO,5,122,111,11,4,7
202223,UDPS0G500U,SCUOLA SECONDARIA II GRADO,4,20,19,1,0,1
202223,TV1MRF500I,SCUOLA SECONDARIA I GRADO,1,21,20,1,0,1
202223,SATFUB5003,SCUOLA SECONDARIA II GRADO,1,3,3,0,0,0
202223,NATDI75001,SCUOLA SECONDARIA II GRADO,4,9,8,1,0,1
202223,NATF15500N,SCUOLA SECONDARIA II GRADO,1,15,15,0,0,0
202223,TO1MUU5007,SCUOLA SECONDARIA I GRADO,1,27,20,7,3,4
202223,NA1E27400L,SCUOLA PRIMARIA,1,58,58,0,0,0
202223,FEPLDM500L,SCUOLA SECONDARIA II GRADO,2,15,8,7,2,5
202223,RMPSNS500T,SCUOLA SECONDARIA II GRADO,4,8,8,0,0,0
202223,NATD9Z5006,SCUOLA SECONDARIA II GRADO,2,7,7,0,0,0
202223,CR1E005006,SCUOLA PRIMARIA,4,15,15,0,0,0
202223,MO1E012007,SCUOLA PRIMARIA,1,18,17,1,0,1
202223,RA1E00100Q,SCUOLA PRIMARIA,3,20,18,2,0,2
202223,RMPSCF500T,SCUOLA SECONDARIA II GRADO,5,52,51,1,0,1
202223,BO1M00300Q,SCUOLA SECONDARIA I GRADO,1,15,14,1,0,1
202223,NA1E206002,SCUOLA PRIMARIA,5,15,15,0,0,0
202223,GRPC64500E,SCUOLA SECONDARIA II GRADO,5,6,6,0,0,0
202223,RM1E5U5009,SCUOLA PRIMARIA,1,18,18,0,0,0
202223,CT1EH25008,SCUOLA PRIMARIA,2,18,17,1,1,0
202223,AVPM10500T,SCUOLA SECONDARIA II GRADO,3,9,9,0,0,0
202223,COTD06500Q,SCUOLA SECONDARIA II GRADO,4,4,4,0,0,0
202223,RMPSRQ500V,SCUOLA SECONDARIA II GRADO,2,48,48,0,0,0
202223,TO1M055005,SCUOLA SECONDARIA I GRADO,1,14,13,1,1,0
202223,MBPSUD500O,SCUOLA SECONDARIA II GRADO,2,14,14,0,0,0
202223,SATF6U5006,SCUOLA SECONDARIA II GRADO,5,66,61,5,0,5
202223,RM1M04200G,SCUOLA SECONDARIA I GRADO,3,70,67,3,0,3
202223,SAPMFG500M,SCUOLA SECONDARIA II GRADO,3,12,12,0,0,0
202223,PVPS5H500G,SCUOLA SECONDARIA II GRADO,3,12,12,0,0,0
202223,TV1E00100X,SCUOLA PRIMARIA,3,21,20,1,1,0
202223,FRRFL1500I,SCUOLA SECONDARIA II GRADO,2,3,3,0,0,0
202223,BSPS13500P,SCUOLA SECONDARIA II GRADO,2,23,20,3,1,2
202223,VB1E00300Q,SCUOLA PRIMARIA,3,27,27,0,0,0
202223,BSPSB05000,SCUOLA SECONDARIA II GRADO,1,9,7,2,0,2
202223,FI1E01200B,SCUOLA PRIMARIA,3,23,22,1,0,1
202223,RM1E16000R,SCUOLA PRIMARIA,4,12,12,0,0,0
202223,NA1E14700B,SCUOLA PRIMARIA,3,11,11,0,0,0
202223,RM1E18200N,SCUOLA PRIMARIA,2,7,7,0,0,0
202223,VETF015005,SCUOLA SECONDARIA II GRADO,3,85,81,4,0,4
202223,SARHV4500U,SCUOLA SECONDARIA II GRADO,5,203,200,3,2,1
202223,CSPM03500Q,SCUOLA SECONDARIA II GRADO,2,13,11,2,0,2
202223,NA1E06800G,SCUOLA PRIMARIA,2,9,7,2,0,2
202223,LCPSG9500D,SCUOLA SECONDARIA II GRADO,3,20,20,0,0,0
202223,TV1E013006,SCUOLA PRIMARIA,1,18,18,0,0,0
202223,CE1E04800C,SCUOLA PRIMARIA,4,23,23,0,0,0
202223,MIPS01500P,SCUOLA SECONDARIA II GRADO,4,26,26,0,0,0
202223,CERIPM5008,SCUOLA SECONDARIA II GRADO,1,5,5,0,0,0
202223,VA1M8O500Z,SCUOLA SECONDARIA I GRADO,2,30,29,1,0,1
202223,POPS00500D,SCUOLA SECONDARIA II GRADO,4,13,13,0,0,0
202223,VBSLCH500S,SCUOLA SECONDARIA II GRADO,4,7,7,0,0,0
202223,PDPS02500G,SCUOLA SECONDARIA II GRADO,1,47,47,0,0,0
202223,RMPM00500N,SCUOLA SECONDARIA II GRADO,1,16,16,0,0,0
202223,RMPL50500Q,SCUOLA SECONDARIA II GRADO,3,19,19,0,0,0
202223,PATDAH500E,SCUOLA SECONDARIA II GRADO,1,3,3,0,0,0
202223,AT1E00300B,SCUOLA PRIMARIA,4,16,15,1,0,1
202223,NA1E11000R,SCUOLA PRIMARIA,4,17,16,1,0,1
202223,BAPSV85002,SCUOLA SECONDARIA II GRADO,3,39,39,0,0,0
202223,RMPS455005,SCUOLA SECONDARIA II GRADO,3,22,22,0,0,0
202223,BOPLMA500N,SCUOLA SECONDARIA II GRADO,3,15,13,2,0,2
202223,FIPC05500B,SCUOLA SECONDARIA II GRADO,5,8,8,0,0,0
202223,VA1E004001,SCUOLA PRIMARIA,4,21,19,2,0,2
202223,SATD9H500H,SCUOLA SECONDARIA II GRADO,4,6,6,0,0,0
202223,NARFV15001,SCUOLA SECONDARIA II GRADO,5,140,128,12,2,10
202223,CT1E82801D,SCUOLA PRIMARIA,5,8,8,0,0,0
202223,BG1M02400V,SCUOLA SECONDARIA I GRADO,2,40,40,0,0,0
202223,SI1E001009,SCUOLA PRIMARIA,5,23,23,0,0,0
202223,PAPLE05003,SCUOLA SECONDARIA II GRADO,4,4,4,0,0,0
202223,CO1E005003,SCUOLA PRIMARIA,4,26,24,2,0,2
202223,TOPS01500P,SCUOLA SECONDARIA II GRADO,3,62,56,6,4,2
202223,FG1E015006,SCUOLA PRIMARIA,4,24,24,0,0,0
202223,MCPM505001,SCUOLA SECONDARIA II GRADO,2,9,8,1,0,1
202223,VAPSQ4500H,SCUOLA SECONDARIA II GRADO,1,24,23,1,1,0
202223,RM1M13400D,SCUOLA SECONDARIA I GRADO,1,49,48,1,1,0
202223,RM1M02100E,SCUOLA SECONDARIA I GRADO,3,82,81,1,0,1
202223,CR1E00300E,SCUOLA PRIMARIA,4,50,48,2,1,1
202223,BA1M01200G,SCUOLA SECONDARIA I GRADO,2,64,62,2,2,0
202223,RM1E10200R,SCUOLA PRIMARIA,5,42,42,0,0,0
202223,RM1E09100G,SCUOLA PRIMARIA,5,16,16,0,0,0
202223,SATDBD5007,SCUOLA SECONDARIA II GRADO,5,66,61,5,2,3
202223,RMPC33500X,SCUOLA SECONDARIA II GRADO,3,14,13,1,1,0
202223,PA1M01700R,SCUOLA SECONDARIA I GRADO,3,14,14,0,0,0
202223,AVTLU25001,SCUOLA SECONDARIA II GRADO,3,7,7,0,0,0
202223,NAPS3S500N,SCUOLA SECONDARIA II GRADO,4,6,5,1,0,1
202223,NATFUA500M,SCUOLA SECONDARIA II GRADO,4,1,1,0,0,0
202223,TVTB205003,SCUOLA SECONDARIA II GRADO,4,21,20,1,1,0
202223,NA1E18800N,SCUOLA PRIMARIA,4,5,5,0,0,0
202223,CE1E028007,SCUOLA PRIMARIA,2,22,21,1,1,0
202223,VAPL06500C,SCUOLA SECONDARIA II GRADO,5,12,12,0,0,0
202223,RM1E11200B,SCUOLA PRIMARIA,4,24,24,0,0,0
202223,VRPM055006,SCUOLA SECONDARIA II GRADO,2,48,48,0,0,0
202223,VRPL06500E,SCUOLA SECONDARIA II GRADO,5,14,14,0,0,0
202223,NAPS5P500P,SCUOLA SECONDARIA II GRADO,5,30,29,1,0,1
202223,TO1E00500V,SCUOLA PRIMARIA,3,22,14,8,4,4
202223,MI1M07500A,SCUOLA SECONDARIA I GRADO,1,74,69,5,0,5
202223,LI1E00400D,SCUOLA PRIMARIA,3,19,18,1,0,1
202223,MI1M00300C,SCUOLA SECONDARIA I GRADO,3,53,53,0,0,0
202223,NAPC7C5006,SCUOLA SECONDARIA II GRADO,5,16,16,0,0,0
202223,MB1E03600B,SCUOLA PRIMARIA,5,15,15,0,0,0
202223,LCRFHO5008,SCUOLA SECONDARIA II GRADO,3,13,10,3,1,2
202223,RMPL085008,SCUOLA SECONDARIA II GRADO,4,19,18,1,0,1
202223,RGTDCA500P,SCUOLA SECONDARIA II GRADO,3,3,3,0,0,0
202223,PARH8S500B,SCUOLA SECONDARIA II GRADO,5,9,9,0,0,0
202223,RO1E0L5003,SCUOLA PRIMARIA,1,22,19,3,0,3
202223,RN1M030007,SCUOLA SECONDARIA I GRADO,1,47,46,1,0,1
202223,PRPS015007,SCUOLA SECONDARIA II GRADO,4,16,16,0,0,0
202223,UDTFI2500I,SCUOLA SECONDARIA II GRADO,2,24,23,1,0,1
202223,MB1M012004,SCUOLA SECONDARIA I GRADO,2,66,65,1,0,1
202223,BS1E01200X,SCUOLA PRIMARIA,4,12,12,0,0,0
202223,NA1E227003,SCUOLA PRIMARIA,2,10,10,0,0,0
202223,TOTB025006,SCUOLA SECONDARIA II GRADO,1,27,24,3,0,3
202223,TO1E04400D,SCUOLA PRIMARIA,3,26,25,1,1,0
202223,BOTF2S5000,SCUOLA SECONDARIA II GRADO,5,32,32,0,0,0
202223,SA1E00100G,SCUOLA PRIMARIA,4,20,20,0,0,0
202223,CTSD015003,SCUOLA SECONDARIA II GRADO,2,44,41,3,1,2
202223,RM1E21100C,SCUOLA PRIMARIA,3,12,7,5,0,5
202223,BG1EUA5004,SCUOLA PRIMARIA,1,19,18,1,0,1
202223,BG1M006009,SCUOLA SECONDARIA I GRADO,1,50,50,0,0,0
202223,PD1E021003,SCUOLA PRIMARIA,1,13,10,3,1,2
202223,NA1E03200R,SCUOLA PRIMARIA,1,17,15,2,0,2
202223,NA1E052002,SCUOLA PRIMARIA,2,17,17,0,0,0
202223,BGPMNC5002,SCUOLA SECONDARIA II GRADO,3,13,13,0,0,0
202223,RMPMIO5006,SCUOLA SECONDARIA II GRADO,1,10,9,1,1,0
202223,RMPMDD500Q,SCUOLA SECONDARIA II GRADO,1,8,8,0,0,0
202223,CE1E06700T,SCUOLA PRIMARIA,4,15,15,0,0,0
202223,MI1M09300X,SCUOLA SECONDARIA I GRADO,1,36,27,9,1,8
202223,NATLL75008,SCUOLA SECONDARIA II GRADO,5,22,21,1,0,1
202223,CA1E00900B,SCUOLA PRIMARIA,3,22,22,0,0,0
202223,LO1E00300V,SCUOLA PRIMARIA,5,19,17,2,1,1
202223,TO1E07500P,SCUOLA PRIMARIA,5,32,31,1,0,1
202223,RMTDSN500S,SCUOLA SECONDARIA II GRADO,1,5,5,0,0,0
202223,TO1E03700A,SCUOLA PRIMARIA,4,49,48,1,0,1
202223,BGPSDM500A,SCUOLA SECONDARIA II GRADO,2,27,27,0,0,0
202223,MEPLZL500L,SCUOLA SECONDARIA II GRADO,3,15,14,1,1,0
202223,METD045003,SCUOLA SECONDARIA II GRADO,4,1,1,0,0,0
202223,BSPC01500D,SCUOLA SECONDARIA II GRADO,3,13,13,0,0,0
202223,NA1E027009,SCUOLA PRIMARIA,2,20,20,0,0,0
202223,RMPC255008,SCUOLA SECONDARIA II GRADO,1,8,8,0,0,0
202223,VR1M00900B,SCUOLA SECONDARIA I GRADO,1,26,25,1,0,1
202223,CO1E012006,SCUOLA PRIMARIA,2,23,21,2,1,1
202223,NATD51500C,SCUOLA SECONDARIA II GRADO,4,29,29,0,0,0
202223,BLPSMD500A,SCUOLA SECONDARIA II GRADO,3,8,8,0,0,0
202223,CRPS00500B,SCUOLA SECONDARIA II GRADO,3,15,15,0,0,0
202223,LCRF085005,SCUOLA SECONDARIA II GRADO,1,18,18,0,0,0
202223,RMTF18500C,SCUOLA SECONDARIA II GRADO,2,16,16,0,0,0
202223,NAPM115006,SCUOLA SECONDARIA II GRADO,5,16,14,2,0,2
202223,VR1E00700E,SCUOLA PRIMARIA,2,35,35,0,0,0
202223,BGPSRR5006,SCUOLA SECONDARIA II GRADO,4,39,38,1,0,1
202223,SV1M00200X,SCUOLA SECONDARIA I GRADO,3,30,29,1,0,1
202223,SSPSNU500Q,SCUOLA SECONDARIA II GRADO,4,3,3,0,0,0
202223,RMPC3Q500Z,SCUOLA SECONDARIA II GRADO,1,11,8,3,0,3
202223,NATF34500R,SCUOLA SECONDARIA II GRADO,5,46,45,1,0,1
202223,NATFGP5005,SCUOLA SECONDARIA II GRADO,5,48,45,3,0,3
202223,CSTD71500B,SCUOLA SECONDARIA II GRADO,1,6,6,0,0,0
202223,GEPMAH500O,SCUOLA SECONDARIA II GRADO,2,29,29,0,0,0
202223,RMPS18500A,SCUOLA SECONDARIA II GRADO,4,11,9,2,0,2
202223,RMSLBH500V,SCUOLA SECONDARIA II GRADO,2,12,12,0,0,0
202223,BSRF3E5000,SCUOLA SECONDARIA II GRADO,5,16,14,2,1,1
202223,PIPS02500D,SCUOLA SECONDARIA II GRADO,2,18,17,1,0,1
202223,MI1E00700E,SCUOLA PRIMARIA,1,53,52,1,0,1
202223,MI1E01400N,SCUOLA PRIMARIA,4,19,19,0,0,0
202223,RGPL025009,SCUOLA SECONDARIA II GRADO,3,6,5,1,0,1
202223,RGRHH6500Z,SCUOLA SECONDARIA II GRADO,2,6,5,1,0,1
202223,BSPMVC500O,SCUOLA SECONDARIA II GRADO,3,11,11,0,0,0
202223,BS1E01900P,SCUOLA PRIMARIA,1,28,25,3,0,3
202223,NA1MIM5003,SCUOLA SECONDARIA I GRADO,3,10,9,1,1,0
202223,BO1E01100D,SCUOLA PRIMARIA,5,43,42,1,0,1
202223,CO1M001001,SCUOLA SECONDARIA I GRADO,2,26,22,4,0,4
202223,NATFD05003,SCUOLA SECONDARIA II GRADO,1,3,3,0,0,0
202223,COPM02500E,SCUOLA SECONDARIA II GRADO,1,27,26,1,0,1
202223,UD1E00900V,SCUOLA PRIMARIA,2,16,16,0,0,0
202223,CSTD71500B,SCUOLA SECONDARIA II GRADO,5,23,21,2,1,1
202223,NA1E212009,SCUOLA PRIMARIA,4,10,10,0,0,0
202223,MBPMM55007,SCUOLA SECONDARIA II GRADO,3,30,30,0,0,0
202223,MI1E009006,SCUOLA PRIMARIA,2,113,109,4,1,3
202223,VA1E01200X,SCUOLA PRIMARIA,3,29,29,0,0,0
202223,PSPS005004,SCUOLA SECONDARIA II GRADO,4,8,8,0,0,0
202223,TO1E02100R,SCUOLA PRIMARIA,1,50,50,0,0,0
202223,SA1E016009,SCUOLA PRIMARIA,1,27,27,0,0,0
202223,RM1E06900A,SCUOLA PRIMARIA,3,17,17,0,0,0
202223,RM1M00900X,SCUOLA SECONDARIA I GRADO,3,29,28,1,0,1
202223,LTPM02500Q,SCUOLA SECONDARIA II GRADO,3,29,27,2,0,2
202223,LC1E002009,SCUOLA PRIMARIA,3,62,62,0,0,0
202223,RM1E204009,SCUOLA PRIMARIA,4,8,8,0,0,0
202223,PAPM72500D,SCUOLA SECONDARIA II GRADO,2,1,1,0,0,0
202223,NATF2S500C,SCUOLA SECONDARIA II GRADO,1,5,5,0,0,0
202223,NATD8F500U,SCUOLA SECONDARIA II GRADO,1,8,8,0,0,0
202223,RMTD77500R,SCUOLA SECONDARIA II GRADO,4,7,7,0,0,0
202223,RCTDPL500T,SCUOLA SECONDARIA II GRADO,4,3,2,1,0,1
202223,MI1E074009,SCUOLA PRIMARIA,5,30,29,1,0,1
202223,SAPMP9500T,SCUOLA SECONDARIA II GRADO,4,1,1,0,0,0
202223,FI1E02500D,SCUOLA PRIMARIA,4,25,24,1,0,1
202223,VA1E01800V,SCUOLA PRIMARIA,5,13,13,0,0,0
202223,BS1E02600T,SCUOLA PRIMARIA,1,15,15,0,0,0
202223,PD1E018007,SCUOLA PRIMARIA,3,47,44,3,0,3
202223,RM1E13900B,SCUOLA PRIMARIA,2,12,10,2,1,1
202223,NA1E270009,SCUOLA PRIMARIA,2,34,34,0,0,0
202223,BGTD1D5000,SCUOLA SECONDARIA II GRADO,3,15,14,1,0,1
202223,FG1E00500G,SCUOLA PRIMARIA,3,24,24,0,0,0
202223,MBRC4H500I,SCUOLA SECONDARIA II GRADO,4,2,1,1,1,0
202223,MBSL05500V,SCUOLA SECONDARIA II GRADO,2,99,94,5,2,3
202223,MIPSE7500I,SCUOLA SECONDARIA II GRADO,1,43,42,1,0,1
202223,MOPSMO5004,SCUOLA SECONDARIA II GRADO,5,8,8,0,0,0
202223,MITFDH5000,SCUOLA SECONDARIA II GRADO,4,29,29,0,0,0
202223,CHRFQQ5004,SCUOLA SECONDARIA II GRADO,1,6,5,1,0,1
202223,MO1E00200L,SCUOLA PRIMARIA,2,23,21,2,0,2
202223,PVSLMT5003,SCUOLA SECONDARIA II GRADO,5,4,3,1,0,1
202223,MI1EA8500G,SCUOLA PRIMARIA,4,53,48,5,1,4
202223,NA1E19600L,SCUOLA PRIMARIA,1,9,9,0,0,0
202223,PDTF015003,SCUOLA SECONDARIA II GRADO,5,17,17,0,0,0
202223,LEPS02500C,SCUOLA SECONDARIA II GRADO,5,11,11,0,0,0
202223,FR1E010004,SCUOLA PRIMARIA,1,2,2,0,0,0
202223,ME1E00300X,SCUOLA PRIMARIA,5,11,10,1,0,1
202223,FO1E00500D,SCUOLA PRIMARIA,5,40,37,3,0,3
202223,NATF37500L,SCUOLA SECONDARIA II GRADO,2,9,9,0,0,0
202223,FI1E021006,SCUOLA PRIMARIA,2,23,21,2,1,1
202223,MI1MN45001,SCUOLA SECONDARIA I GRADO,1,60,55,5,1,4
202223,NATFTA500I,SCUOLA SECONDARIA II GRADO,3,6,6,0,0,0
202223,PATD7N500Z,SCUOLA SECONDARIA II GRADO,5,11,11,0,0,0
202223,AV1EE5500E,SCUOLA PRIMARIA,1,8,7,1,1,0
202223,RMTD325008,SCUOLA SECONDARIA II GRADO,5,56,54,2,0,2
202223,BS1E01400G,SCUOLA PRIMARIA,2,23,23,0,0,0
202223,NATANI5007,SCUOLA SECONDARIA II GRADO,1,3,3,0,0,0
202223,MI1M084005,SCUOLA SECONDARIA I GRADO,2,36,34,2,0,2
202223,NAPC095002,SCUOLA SECONDARIA II GRADO,5,25,25,0,0,0
202223,RM1E07000E,SCUOLA PRIMARIA,5,25,25,0,0,0
202223,TV1E006003,SCUOLA PRIMARIA,3,12,12,0,0,0
202223,CTTD365004,SCUOLA SECONDARIA II GRADO,3,2,2,0,0,0
202223,VE1E005007,SCUOLA PRIMARIA,1,28,25,3,2,1
202223,TO1M012007,SCUOLA SECONDARIA I GRADO,2,43,40,3,2,1
202223,RM1E00900P,SCUOLA PRIMARIA,2,25,22,3,1,2
202223,LU1E00400X,SCUOLA PRIMARIA,3,10,9,1,0,1
202223,FI1E006004,SCUOLA PRIMARIA,5,20,19,1,1,0
202223,NA1M032002,SCUOLA SECONDARIA I GRADO,1,20,20,0,0,0
202223,BSPS3I500U,SCUOLA SECONDARIA II GRADO,1,10,10,0,0,0
202223,FI1E00200R,SCUOLA PRIMARIA,2,27,27,0,0,0
202223,NATF30500A,SCUOLA SECONDARIA II GRADO,1,13,13,0,0,0
202223,SATFVU500C,SCUOLA SECONDARIA II GRADO,3,5,5,0,0,0
202223,RMPL26500R,SCUOLA SECONDARIA II GRADO,4,16,15,1,1,0
202223,AQ1E00100E,SCUOLA PRIMARIA,5,24,24,0,0,0
202223,BG1E02300T,SCUOLA PRIMARIA,4,27,25,2,2,0
202223,RCTDO0500U,SCUOLA SECONDARIA II GRADO,2,5,3,2,0,2
202223,TOSL01500G,SCUOLA SECONDARIA II GRADO,3,22,22,0,0,0
202223,RMPSCF500T,SCUOLA SECONDARIA II GRADO,4,10,10,0,0,0
202223,MI1E124005,SCUOLA PRIMARIA,1,18,18,0,0,0
202223,RM1E030004,SCUOLA PRIMARIA,2,16,14,2,1,1
202223,VETN745000,SCUOLA SECONDARIA II GRADO,4,9,9,0,0,0
202223,LCPS01500L,SCUOLA SECONDARIA II GRADO,2,22,22,0,0,0
202223,GE1E01100C,SCUOLA PRIMARIA,1,37,32,5,0,5
202223,AL1M00800P,SCUOLA SECONDARIA I GRADO,1,53,51,2,0,2
202223,MIPMU4500Z,SCUOLA SECONDARIA II GRADO,5,14,12,2,0,2
202223,PV1E008004,SCUOLA PRIMARIA,4,19,17,2,0,2
202223,NARH25500E,SCUOLA SECONDARIA II GRADO,5,70,69,1,0,1
202223,PA1EC8500U,SCUOLA PRIMARIA,2,17,17,0,0,0
202223,AVTFRU5000,SCUOLA SECONDARIA II GRADO,5,23,22,1,0,1
202223,TOPM085002,SCUOLA SECONDARIA II GRADO,3,5,5,0,0,0
202223,VARHL7500G,SCUOLA SECONDARIA II GRADO,1,4,4,0,0,0
202223,NA1E21100D,SCUOLA PRIMARIA,4,12,12,0,0,0
202223,MI1E059007,SCUOLA PRIMARIA,3,44,42,2,0,2
202223,NA1E00300R,SCUOLA PRIMARIA,2,10,9,1,0,1
202223,RM1E015002,SCUOLA PRIMARIA,3,30,29,1,0,1
202223,CLTD9T500A,SCUOLA SECONDARIA II GRADO,2,4,4,0,0,0
202223,VI1E00600A,SCUOLA PRIMARIA,2,11,11,0,0,0
202223,TOPSQB5003,SCUOLA SECONDARIA II GRADO,1,32,25,7,2,5
202223,MB1EF5500A,SCUOLA PRIMARIA,2,9,7,2,0,2
202223,BO1EL9500N,SCUOLA PRIMARIA,2,18,18,0,0,0
202223,NARF5I500H,SCUOLA SECONDARIA II GRADO,1,24,24,0,0,0
202223,RM1M003001,SCUOLA SECONDARIA I GRADO,2,29,28,1,0,1
202223,LC1E004001,SCUOLA PRIMARIA,1,25,25,0,0,0
202223,RM1E113007,SCUOLA PRIMARIA,4,7,7,0,0,0
202223,MIPL08500Q,SCUOLA SECONDARIA II GRADO,3,16,15,1,0,1
202223,PD1E013004,SCUOLA PRIMARIA,4,41,40,1,0,1
202223,RM1M03900Q,SCUOLA SECONDARIA I GRADO,1,56,55,1,1,0
202223,RM1M029005,SCUOLA SECONDARIA I GRADO,2,20,20,0,0,0
202223,MI1E039002,SCUOLA PRIMARIA,2,49,44,5,0,5
202223,NATFZE5004,SCUOLA SECONDARIA II GRADO,5,138,131,7,2,5
202223,NATL0L500Q,SCUOLA SECONDARIA II GRADO,4,3,3,0,0,0
202223,MSPC01500B,SCUOLA SECONDARIA II GRADO,3,10,10,0,0,0
202223,AP1E005007,SCUOLA PRIMARIA,3,22,21,1,0,1
202223,CL1E00500Q,SCUOLA PRIMARIA,1,8,8,0,0,0
202223,MI1E13300X,SCUOLA PRIMARIA,1,29,29,0,0,0
202223,TPSD015003,SCUOLA SECONDARIA II GRADO,5,46,42,4,1,3
202223,MI1M04900T,SCUOLA SECONDARIA I GRADO,2,66,66,0,0,0
202223,CE1E03900N,SCUOLA PRIMARIA,1,24,23,1,0,1
202223,SATDR35003,SCUOLA SECONDARIA II GRADO,5,69,67,2,1,1
202223,POPS00500D,SCUOLA SECONDARIA II GRADO,5,15,12,3,0,3
202223,TOPS76500T,SCUOLA SECONDARIA II GRADO,3,51,48,3,1,2
202223,NA1E130002,SCUOLA PRIMARIA,4,23,23,0,0,0
202223,CSTF6C500B,SCUOLA SECONDARIA II GRADO,1,7,7,0,0,0
202223,AT1E00200G,SCUOLA PRIMARIA,2,20,18,2,0,2
202223,NAPS25500C,SCUOLA SECONDARIA II GRADO,3,6,6,0,0,0
202223,NAPS355009,SCUOLA SECONDARIA II GRADO,5,15,15,0,0,0
202223,CHTF00500E,SCUOLA SECONDARIA II GRADO,3,9,9,0,0,0
202223,SATABS5008,SCUOLA SECONDARIA II GRADO,4,12,12,0,0,0
202223,NA1E07000G,SCUOLA PRIMARIA,5,22,21,1,0,1
202223,FRPC02500X,SCUOLA SECONDARIA II GRADO,2,11,11,0,0,0
202223,VVPS2U500I,SCUOLA SECONDARIA II GRADO,5,7,7,0,0,0
202223,PATD205004,SCUOLA SECONDARIA II GRADO,5,100,100,0,0,0
202223,CERIPM5008,SCUOLA SECONDARIA II GRADO,2,6,6,0,0,0
202223,PO1E013007,SCUOLA PRIMARIA,1,17,13,4,0,4
202223,POPS9T5004,SCUOLA SECONDARIA II GRADO,4,12,9,3,0,3
202223,TO1EPI500H,SCUOLA PRIMARIA,5,16,15,1,1,0
202223,BO1E00900D,SCUOLA PRIMARIA,4,61,60,1,0,1
202223,SATFCA5002,SCUOLA SECONDARIA II GRADO,1,3,3,0,0,0
202223,GE1M027007,SCUOLA SECONDARIA I GRADO,2,18,18,0,0,0
202223,RMPLO35009,SCUOLA SECONDARIA II GRADO,1,2,2,0,0,0
202223,RMPLCV500U,SCUOLA SECONDARIA II GRADO,4,5,5,0,0,0
202223,CO1E00200G,SCUOLA PRIMARIA,1,16,16,0,0,0
202223,NOTB12500G,SCUOLA SECONDARIA II GRADO,3,5,5,0,0,0
202223,MIPSEN500E,SCUOLA SECONDARIA II GRADO,1,63,61,2,0,2
202223,LISL00500B,SCUOLA SECONDARIA II GRADO,5,11,11,0,0,0
202223,RMPS505001,SCUOLA SECONDARIA II GRADO,3,13,13,0,0,0
202223,NO1E00800V,SCUOLA PRIMARIA,5,21,21,0,0,0
202223,SP1E00400X,SCUOLA PRIMARIA,4,24,23,1,1,0
202223,FIPC035006,SCUOLA SECONDARIA II GRADO,1,8,8,0,0,0
202223,VA1M9G500V,SCUOLA SECONDARIA I GRADO,2,114,114,0,0,0
202223,NA1E02100A,SCUOLA PRIMARIA,1,11,11,0,0,0
202223,VE1E006003,SCUOLA PRIMARIA,1,25,22,3,0,3
202223,CN1E00200V,SCUOLA PRIMARIA,5,14,14,0,0,0
202223,TO1M054009,SCUOLA SECONDARIA I GRADO,2,59,59,0,0,0
202223,PA1E005009,SCUOLA PRIMARIA,3,20,20,0,0,0
202223,SAPS06500Q,SCUOLA SECONDARIA II GRADO,1,4,4,0,0,0
202223,MO1E004008,SCUOLA PRIMARIA,2,26,26,0,0,0
202223,LO1E002003,SCUOLA PRIMARIA,1,23,22,1,0,1
202223,APPSR5500N,SCUOLA SECONDARIA II GRADO,5,21,21,0,0,0
202223,TO1E05200C,SCUOLA PRIMARIA,1,20,18,2,1,1
202223,NO1E00500B,SCUOLA PRIMARIA,1,25,25,0,0,0
202223,RMPC285004,SCUOLA SECONDARIA II GRADO,2,26,26,0,0,0
202223,COPSI65000,SCUOLA SECONDARIA II GRADO,2,14,13,1,0,1
202223,RM1E13200L,SCUOLA PRIMARIA,4,17,16,1,0,1
202223,MIPL08500Q,SCUOLA SECONDARIA II GRADO,4,14,14,0,0,0
202223,FIPL085005,SCUOLA SECONDARIA II GRADO,5,3,3,0,0,0
202223,NA1E14700B,SCUOLA PRIMARIA,5,17,16,1,1,0
202223,NA1E09100L,SCUOLA PRIMARIA,2,22,22,0,0,0
202223,RMPMQB5004,SCUOLA SECONDARIA II GRADO,1,18,18,0,0,0
202223,PVSL015009,SCUOLA SECONDARIA II GRADO,1,5,5,0,0,0
202223,LIPL035005,SCUOLA SECONDARIA II GRADO,2,9,9,0,0,0
202223,CA1E00700Q,SCUOLA PRIMARIA,3,18,17,1,0,1
202223,MI1M004008,SCUOLA SECONDARIA I GRADO,1,70,69,1,0,1
202223,FI1E02900R,SCUOLA PRIMARIA,2,9,9,0,0,0
202223,RGPM0A500T,SCUOLA SECONDARIA II GRADO,3,9,9,0,0,0
202223,VIPL015005,SCUOLA SECONDARIA II GRADO,1,9,6,3,1,2
202223,TA1E00700G,SCUOLA PRIMARIA,5,18,18,0,0,0
202223,BSPS08500V,SCUOLA SECONDARIA II GRADO,5,16,15,1,0,1
202223,VAPS2O5006,SCUOLA SECONDARIA II GRADO,3,4,4,0,0,0
202223,BSPC12500Q,SCUOLA SECONDARIA II GRADO,1,25,25,0,0,0
202223,NA1E24400R,SCUOLA PRIMARIA,1,20,19,1,0,1
202223,RM1E134008,SCUOLA PRIMARIA,5,33,32,1,0,1
202223,CZPM00500Q,SCUOLA SECONDARIA II GRADO,4,10,10,0,0,0
202223,NA1E151003,SCUOLA PRIMARIA,5,27,27,0,0,0
202223,BG1E019006,SCUOLA PRIMARIA,1,17,17,0,0,0
202223,VRPS005004,SCUOLA SECONDARIA II GRADO,3,16,15,1,0,1
202223,MIPS54500V,SCUOLA SECONDARIA II GRADO,5,22,22,0,0,0
202223,GEPSC85001,SCUOLA SECONDARIA II GRADO,1,26,25,1,0,1
202223,MB1M012004,SCUOLA SECONDARIA I GRADO,3,61,60,1,1,0
202223,RMPS00500L,SCUOLA SECONDARIA II GRADO,2,1,1,0,0,0
202223,MBPL315001,SCUOLA SECONDARIA II GRADO,2,17,17,0,0,0
202223,TO1E012002,SCUOLA PRIMARIA,4,24,23,1,1,0
202223,APPSNE500L,SCUOLA SECONDARIA II GRADO,1,18,18,0,0,0
202223,NA1E064008,SCUOLA PRIMARIA,2,16,3,13,0,13
202223,SARFMI5004,SCUOLA SECONDARIA II GRADO,4,9,7,2,1,1
202223,RMTND1500F,SCUOLA SECONDARIA II GRADO,1,3,3,0,0,0
202223,REPMPU500Q,SCUOLA SECONDARIA II GRADO,3,15,15,0,0,0
202223,PAPS3Q5009,SCUOLA SECONDARIA II GRADO,5,38,38,0,0,0
202223,VAPS6M5003,SCUOLA SECONDARIA II GRADO,3,28,28,0,0,0
202223,SATL09500T,SCUOLA SECONDARIA II GRADO,2,9,9,0,0,0
202223,CE1E01800L,SCUOLA PRIMARIA,4,18,17,1,0,1
202223,MI1E08600G,SCUOLA PRIMARIA,3,46,42,4,0,4
202223,RCTD035005,SCUOLA SECONDARIA II GRADO,5,24,22,2,0,2
202223,NA1E22800V,SCUOLA PRIMARIA,5,6,6,0,0,0
202223,BG1E00900G,SCUOLA PRIMARIA,4,4,4,0,0,0
202223,BGPS02500P,SCUOLA SECONDARIA II GRADO,1,26,26,0,0,0
202223,VA1E41500F,SCUOLA PRIMARIA,5,6,6,0,0,0
202223,NA1E200003,SCUOLA PRIMARIA,3,10,10,0,0,0
202223,CERHT0500Q,SCUOLA SECONDARIA II GRADO,5,70,67,3,1,2
202223,SA1E009006,SCUOLA PRIMARIA,5,5,5,0,0,0
202223,LTTA335002,SCUOLA SECONDARIA II GRADO,5,22,22,0,0,0
202223,VR1M00800G,SCUOLA SECONDARIA I GRADO,3,78,75,3,0,3
202223,VE1M00500C,SCUOLA SECONDARIA I GRADO,3,30,30,0,0,0
202223,CT1M00100P,SCUOLA SECONDARIA I GRADO,1,7,7,0,0,0
202223,CTPC605004,SCUOLA SECONDARIA II GRADO,3,3,3,0,0,0
202223,NA1E027009,SCUOLA PRIMARIA,3,24,24,0,0,0
202223,BGPL06500X,SCUOLA SECONDARIA II GRADO,5,21,21,0,0,0
202223,NA1E044003,SCUOLA PRIMARIA,5,47,46,1,0,1
202223,CO1E012006,SCUOLA PRIMARIA,3,12,10,2,1,1
202223,CO1MCB500P,SCUOLA SECONDARIA I GRADO,2,10,9,1,1,0
202223,TO1M05700R,SCUOLA SECONDARIA I GRADO,1,24,22,2,2,0
202223,FIPS00500D,SCUOLA SECONDARIA II GRADO,4,20,20,0,0,0
202223,VARFR75004,SCUOLA SECONDARIA II GRADO,4,3,2,1,0,1
202223,RM1M11900B,SCUOLA SECONDARIA I GRADO,2,52,51,1,1,0
202223,RM1M09300C,SCUOLA SECONDARIA I GRADO,2,11,10,1,0,1
202223,CRPS00500B,SCUOLA SECONDARIA II GRADO,4,19,19,0,0,0
202223,SA1M01100B,SCUOLA SECONDARIA I GRADO,1,1,1,0,0,0
202223,RM1E198007,SCUOLA PRIMARIA,2,29,29,0,0,0
202223,BG1E005008,SCUOLA PRIMARIA,5,41,41,0,0,0
202223,TO1E02900B,SCUOLA PRIMARIA,4,20,20,0,0,0
202223,GE1E01700B,SCUOLA PRIMARIA,5,19,15,4,0,4
202223,MERHFN500I,SCUOLA SECONDARIA II GRADO,1,4,4,0,0,0
202223,BS1M018004,SCUOLA SECONDARIA I GRADO,3,28,28,0,0,0
202223,MI1M103009,SCUOLA SECONDARIA I GRADO,2,27,27,0,0,0
202223,NATDGC5003,SCUOLA SECONDARIA II GRADO,3,17,17,0,0,0
202223,CZPL925000,SCUOLA SECONDARIA II GRADO,1,11,11,0,0,0
202223,BLPC01500G,SCUOLA SECONDARIA II GRADO,5,16,16,0,0,0
202223,PD1E012008,SCUOLA PRIMARIA,4,35,34,1,0,1
202223,BG1E03200L,SCUOLA PRIMARIA,2,41,40,1,0,1
202223,BA1E01100E,SCUOLA PRIMARIA,4,12,9,3,1,2
202223,MTTD01500D,SCUOLA SECONDARIA II GRADO,2,7,6,1,0,1
202223,MO1E00900B,SCUOLA PRIMARIA,2,27,24,3,0,3
202223,NA1E15900N,SCUOLA PRIMARIA,2,10,10,0,0,0
202223,NA1E18300E,SCUOLA PRIMARIA,4,35,35,0,0,0
202223,NARF0C5004,SCUOLA SECONDARIA II GRADO,1,8,7,1,1,0
202223,NAPLQ2500N,SCUOLA SECONDARIA II GRADO,5,103,100,3,2,1
202223,VR1E004003,SCUOLA PRIMARIA,4,21,21,0,0,0
202223,CTTD195006,SCUOLA SECONDARIA II GRADO,5,49,48,1,1,0
202223,FRPM9Q500B,SCUOLA SECONDARIA II GRADO,4,2,2,0,0,0
202223,VI1E01100T,SCUOLA PRIMARIA,3,20,20,0,0,0
202223,RM1E006007,SCUOLA PRIMARIA,5,25,22,3,1,2
202223,MEPS435000,SCUOLA SECONDARIA II GRADO,4,1,1,0,0,0
202223,FITD01500X,SCUOLA SECONDARIA II GRADO,4,5,5,0,0,0
202223,BS1E02100P,SCUOLA PRIMARIA,5,22,22,0,0,0
202223,COPS055009,SCUOLA SECONDARIA II GRADO,3,13,13,0,0,0
202223,VRTF005006,SCUOLA SECONDARIA II GRADO,1,110,107,3,1,2
202223,PCPS01500A,SCUOLA SECONDARIA II GRADO,1,4,4,0,0,0
202223,PV1M008009,SCUOLA SECONDARIA I GRADO,3,46,46,0,0,0
202223,NATD27500D,SCUOLA SECONDARIA II GRADO,5,25,25,0,0,0
202223,VEPL01500T,SCUOLA SECONDARIA II GRADO,2,7,6,1,0,1
202223,MI1E009006,SCUOLA PRIMARIA,3,114,109,5,0,5
202223,NAPC00500E,SCUOLA SECONDARIA II GRADO,5,19,17,2,0,2
202223,NAPSP25001,SCUOLA SECONDARIA II GRADO,5,70,66,4,0,4
202223,GE1E02300P,SCUOLA PRIMARIA,5,25,20,5,2,3
202223,RGRHL4500A,SCUOLA SECONDARIA II GRADO,5,19,18,1,0,1
202223,VAPL10500N,SCUOLA SECONDARIA II GRADO,1,6,5,1,0,1
202223,RM1E01000V,SCUOLA PRIMARIA,4,24,24,0,0,0
202223,VA1M00800D,SCUOLA SECONDARIA I GRADO,2,94,94,0,0,0
202223,UD1E00600B,SCUOLA PRIMARIA,4,31,30,1,0,1
202223,PATDEE500L,SCUOLA SECONDARIA II GRADO,5,25,24,1,0,1
202223,AV1E008005,SCUOLA PRIMARIA,4,17,17,0,0,0
202223,RMTD72500Q,SCUOLA SECONDARIA II GRADO,4,10,9,1,0,1
202223,VEPS00500C,SCUOLA SECONDARIA II GRADO,2,14,12,2,0,2
202223,CSRFQA500F,SCUOLA SECONDARIA II GRADO,2,7,6,1,1,0
202223,RM1E07500N,SCUOLA PRIMARIA,4,81,77,4,2,2
202223,AN1E001009,SCUOLA PRIMARIA,3,9,9,0,0,0
202223,MIPQ01500X,SCUOLA SECONDARIA II GRADO,2,24,24,0,0,0
202223,SA1E02300C,SCUOLA PRIMARIA,1,10,10,0,0,0
202223,MIPS085001,SCUOLA SECONDARIA II GRADO,3,46,45,1,1,0
202223,PS1E00500V,SCUOLA PRIMARIA,3,20,18,2,1,1
202223,SATD22500V,SCUOLA SECONDARIA II GRADO,3,8,8,0,0,0
202223,NARHZ5500Q,SCUOLA SECONDARIA II GRADO,5,25,25,0,0,0
202223,MB1E02800C,SCUOLA PRIMARIA,3,48,47,1,0,1
202223,CTPS075008,SCUOLA SECONDARIA II GRADO,3,22,21,1,0,1
202223,PDPL04500G,SCUOLA SECONDARIA II GRADO,5,21,19,2,0,2
202223,BNPC02500R,SCUOLA SECONDARIA II GRADO,4,17,17,0,0,0
202223,FGTD095004,SCUOLA SECONDARIA II GRADO,2,3,3,0,0,0
202223,BS1E00500R,SCUOLA PRIMARIA,3,39,34,5,0,5
202223,MI1E06500E,SCUOLA PRIMARIA,4,52,52,0,0,0
202223,RM1E023001,SCUOLA PRIMARIA,4,48,41,7,0,7
202223,SV1E00200P,SCUOLA PRIMARIA,4,13,11,2,0,2
202223,SS1E00400L,SCUOLA PRIMARIA,5,15,14,1,0,1
202223,ISPM1I500P,SCUOLA SECONDARIA II GRADO,1,1,1,0,0,0
202223,VR1M025009,SCUOLA SECONDARIA I GRADO,3,25,24,1,0,1
202223,TOPMP2500E,SCUOLA SECONDARIA II GRADO,4,10,10,0,0,0
202223,RM1E12900R,SCUOLA PRIMARIA,4,15,15,0,0,0
202223,NA1E25400B,SCUOLA PRIMARIA,5,14,14,0,0,0
202223,BGTF1A500N,SCUOLA SECONDARIA II GRADO,1,6,5,1,1,0
202223,BGTFMP5003,SCUOLA SECONDARIA II GRADO,1,15,15,0,0,0
202223,FG1E01100V,SCUOLA PRIMARIA,5,15,15,0,0,0
202223,VAPSZC500T,SCUOLA SECONDARIA II GRADO,1,19,19,0,0,0
202223,MBTD37500N,SCUOLA SECONDARIA II GRADO,3,19,18,1,1,0
202223,BNRHZS500C,SCUOLA SECONDARIA II GRADO,2,7,7,0,0,0
202223,RMPC10500A,SCUOLA SECONDARIA II GRADO,3,46,46,0,0,0
202223,RMPC05500E,SCUOLA SECONDARIA II GRADO,2,10,10,0,0,0
202223,MI1E05100L,SCUOLA PRIMARIA,1,42,38,4,0,4
202223,MI1E06600A,SCUOLA PRIMARIA,2,52,48,4,0,4
202223,CHRFQQ5004,SCUOLA SECONDARIA II GRADO,2,6,5,1,0,1
202223,CA1E01100B,SCUOLA PRIMARIA,3,15,15,0,0,0
202223,RM1E02400R,SCUOLA PRIMARIA,3,49,48,1,0,1
202223,NAPM115006,SCUOLA SECONDARIA II GRADO,1,14,11,3,0,3
202223,PE1E003004,SCUOLA PRIMARIA,3,15,15,0,0,0
202223,LE1E00800D,SCUOLA PRIMARIA,4,31,30,1,0,1
202223,CE1E045001,SCUOLA PRIMARIA,3,13,13,0,0,0
202223,MB1E07200E,SCUOLA PRIMARIA,3,18,18,0,0,0
202223,MCRHOE500M,SCUOLA SECONDARIA II GRADO,1,4,3,1,0,1
202223,NAPMTL5004,SCUOLA SECONDARIA II GRADO,1,5,5,0,0,0
202223,CTTD365004,SCUOLA SECONDARIA II GRADO,4,2,2,0,0,0
202223,TA1E009007,SCUOLA PRIMARIA,4,12,12,0,0,0
202223,MITD13500L,SCUOLA SECONDARIA II GRADO,2,17,15,2,0,2
202223,PA1E03800L,SCUOLA PRIMARIA,3,20,20,0,0,0
202223,PS1E003007,SCUOLA PRIMARIA,5,23,21,2,1,1
202223,MI1MT3500U,SCUOLA SECONDARIA I GRADO,3,54,53,1,1,0
202223,RARI015004,SCUOLA SECONDARIA II GRADO,5,6,4,2,0,2
202223,BGTD085006,SCUOLA SECONDARIA II GRADO,5,43,43,0,0,0
202223,MI1E09300P,SCUOLA PRIMARIA,3,6,5,1,0,1
202223,MI1E02600X,SCUOLA PRIMARIA,5,36,35,1,0,1
202223,BS1E011004,SCUOLA PRIMARIA,3,34,32,2,0,2
202223,TVRA3C5009,SCUOLA SECONDARIA II GRADO,4,26,25,1,0,1
202223,NATHE15007,SCUOLA SECONDARIA II GRADO,3,7,7,0,0,0
202223,NARHZ8500V,SCUOLA SECONDARIA II GRADO,3,17,16,1,0,1
202223,CH1E006003,SCUOLA PRIMARIA,1,10,10,0,0,0
202223,CSPQ025009,SCUOLA SECONDARIA II GRADO,2,5,5,0,0,0
202223,CE1E03500A,SCUOLA PRIMARIA,5,12,12,0,0,0
202223,LTTD595008,SCUOLA SECONDARIA II GRADO,4,19,19,0,0,0
202223,MISL025006,SCUOLA SECONDARIA II GRADO,1,51,51,0,0,0
202223,NA1ED8500Q,SCUOLA PRIMARIA,3,4,4,0,0,0
202223,BSPS6Z5004,SCUOLA SECONDARIA II GRADO,5,15,15,0,0,0
202223,VE1E01000P,SCUOLA PRIMARIA,1,42,42,0,0,0
202223,VE1E00200Q,SCUOLA PRIMARIA,2,23,23,0,0,0
202223,BO1E01100D,SCUOLA PRIMARIA,1,40,36,4,0,4
202223,MI1E089003,SCUOLA PRIMARIA,2,11,10,1,0,1
202223,PA1E02300V,SCUOLA PRIMARIA,5,10,10,0,0,0
202223,RMTAZI500E,SCUOLA SECONDARIA II GRADO,4,18,18,0,0,0
202223,BS1E01500B,SCUOLA PRIMARIA,2,51,46,5,0,5
202223,LO1E00500E,SCUOLA PRIMARIA,5,40,40,0,0,0
202223,PGPSVU500T,SCUOLA SECONDARIA II GRADO,3,3,3,0,0,0
202223,RM1E04000P,SCUOLA PRIMARIA,1,12,6,6,0,6
202223,SATD075006,SCUOLA SECONDARIA II GRADO,2,19,18,1,0,1
202223,PO1E00300L,SCUOLA PRIMARIA,1,45,33,12,0,12
202223,LC1M070005,SCUOLA SECONDARIA I GRADO,2,48,46,2,0,2
202223,AL1E004006,SCUOLA PRIMARIA,4,15,15,0,0,0
202223,FI1E034008,SCUOLA PRIMARIA,3,47,47,0,0,0
202223,NARH4C5006,SCUOLA SECONDARIA II GRADO,3,7,7,0,0,0
202223,CE1E002003,SCUOLA PRIMARIA,2,27,27,0,0,0
202223,MI1E039002,SCUOLA PRIMARIA,3,49,48,1,0,1
202223,RM1E043006,SCUOLA PRIMARIA,5,57,55,2,0,2
202223,AGTD00500C,SCUOLA SECONDARIA II GRADO,3,3,3,0,0,0
202223,BO1M00200X,SCUOLA SECONDARIA I GRADO,2,46,42,4,1,3
202223,FI1E063008,SCUOLA PRIMARIA,2,9,7,2,1,1
202223,RM1ES55005,SCUOLA PRIMARIA,2,21,21,0,0,0
202223,SRTD08500V,SCUOLA SECONDARIA II GRADO,2,4,4,0,0,0
202223,RM1E155009,SCUOLA PRIMARIA,5,46,46,0,0,0
202223,CORC43500S,SCUOLA SECONDARIA II GRADO,2,9,7,2,0,2
202223,NA1E239009,SCUOLA PRIMARIA,5,12,12,0,0,0
202223,VR1E01500D,SCUOLA PRIMARIA,2,22,21,1,0,1
202223,RMPM9P500H,SCUOLA SECONDARIA II GRADO,1,1,1,0,0,0
202223,CZ1M00100B,SCUOLA SECONDARIA I GRADO,1,16,16,0,0,0
202223,NA1E26500T,SCUOLA PRIMARIA,3,5,5,0,0,0
202223,RM1E12500D,SCUOLA PRIMARIA,4,20,20,0,0,0
202223,BN1E82500A,SCUOLA PRIMARIA,1,26,26,0,0,0
202223,MI1E033003,SCUOLA PRIMARIA,2,21,21,0,0,0
202223,NATL175003,SCUOLA SECONDARIA II GRADO,5,61,60,1,0,1
202223,LI1E005009,SCUOLA PRIMARIA,1,32,31,1,0,1
202223,APPM04500X,SCUOLA SECONDARIA II GRADO,4,28,28,0,0,0
202223,RMPS305007,SCUOLA SECONDARIA II GRADO,5,23,23,0,0,0
202223,RN1E001002,SCUOLA PRIMARIA,3,20,17,3,0,3
202223,PETN015009,SCUOLA SECONDARIA II GRADO,4,3,2,1,1,0
202223,MEPMEB500L,SCUOLA SECONDARIA II GRADO,4,9,8,1,0,1
202223,CETF1M500C,SCUOLA SECONDARIA II GRADO,5,105,104,1,0,1
202223,NA1M060006,SCUOLA SECONDARIA I GRADO,3,17,17,0,0,0
202223,COPSIS500Q,SCUOLA SECONDARIA II GRADO,3,28,28,0,0,0
202223,RM1E14600E,SCUOLA PRIMARIA,3,23,23,0,0,0
202223,SATF9L500V,SCUOLA SECONDARIA II GRADO,5,124,121,3,1,2
202223,NAPMVM500H,SCUOLA SECONDARIA II GRADO,3,3,3,0,0,0
202223,PVPS5H500G,SCUOLA SECONDARIA II GRADO,1,5,5,0,0,0
202223,ANTD03500D,SCUOLA SECONDARIA II GRADO,4,4,4,0,0,0
202223,NA1E065004,SCUOLA PRIMARIA,4,15,10,5,0,5
202223,TV1EDQ500C,SCUOLA PRIMARIA,1,26,25,1,1,0
202223,RM1E064007,SCUOLA PRIMARIA,2,33,33,0,0,0
202223,FRRFL1500I,SCUOLA SECONDARIA II GRADO,1,2,2,0,0,0
202223,CETD115003,SCUOLA SECONDARIA II GRADO,5,41,40,1,0,1
202223,PO1EHR500Z,SCUOLA PRIMARIA,3,12,7,5,0,5
202223,NA1MT6500T,SCUOLA SECONDARIA I GRADO,3,7,5,2,0,2
202223,VB1E001004,SCUOLA PRIMARIA,2,22,21,1,0,1
202223,SATFHG5004,SCUOLA SECONDARIA II GRADO,1,9,9,0,0,0
202223,CN1E00300P,SCUOLA PRIMARIA,1,13,13,0,0,0
202223,PA1E00400D,SCUOLA PRIMARIA,1,26,26,0,0,0
202223,MIPS43500B,SCUOLA SECONDARIA II GRADO,4,30,30,0,0,0
202223,RMTD58500N,SCUOLA SECONDARIA II GRADO,2,24,23,1,1,0
202223,MIPSEN500E,SCUOLA SECONDARIA II GRADO,2,64,62,2,1,1
202223,RMSLVB5007,SCUOLA SECONDARIA II GRADO,3,19,19,0,0,0
202223,SP1E003004,SCUOLA PRIMARIA,1,24,22,2,0,2
202223,VA1E01400G,SCUOLA PRIMARIA,5,12,12,0,0,0
202223,BOPS05500C,SCUOLA SECONDARIA II GRADO,3,28,28,0,0,0
202223,MIPS06500Q,SCUOLA SECONDARIA II GRADO,4,25,22,3,0,3
202223,FIPC04500R,SCUOLA SECONDARIA II GRADO,1,2,2,0,0,0
202223,CERIOH500S,SCUOLA SECONDARIA II GRADO,4,10,10,0,0,0
202223,NARH02500L,SCUOLA SECONDARIA II GRADO,5,134,129,5,2,3
202223,NA1M040001,SCUOLA SECONDARIA I GRADO,2,7,6,1,0,1
202223,FI1E00800Q,SCUOLA PRIMARIA,2,20,14,6,0,6
202223,BG1MVN5002,SCUOLA SECONDARIA I GRADO,1,12,11,1,0,1
202223,APRF3R500G,SCUOLA SECONDARIA II GRADO,3,2,2,0,0,0
202223,CE1E015005,SCUOLA PRIMARIA,5,13,11,2,1,1
202223,FIPS15500B,SCUOLA SECONDARIA II GRADO,4,9,8,1,0,1
202223,AT1E00300B,SCUOLA PRIMARIA,3,15,15,0,0,0
202223,RMPS455005,SCUOLA SECONDARIA II GRADO,4,25,25,0,0,0
202223,RE1E00400N,SCUOLA PRIMARIA,2,22,21,1,1,0
202223,BO1E01600L,SCUOLA PRIMARIA,2,35,34,1,1,0
202223,RM1E08700X,SCUOLA PRIMARIA,1,10,10,0,0,0
202223,BOPSOI5007,SCUOLA SECONDARIA II GRADO,3,24,23,1,0,1
202223,LTPSU65008,SCUOLA SECONDARIA II GRADO,3,2,2,0,0,0
202223,IS1MS7500N,SCUOLA SECONDARIA I GRADO,2,3,3,0,0,0
202223,BS1M005002,SCUOLA SECONDARIA I GRADO,2,83,83,0,0,0
202223,RM1E21000L,SCUOLA PRIMARIA,2,23,23,0,0,0
202223,PA1M008002,SCUOLA SECONDARIA I GRADO,3,22,22,0,0,0
202223,PAPLE05003,SCUOLA SECONDARIA II GRADO,3,5,5,0,0,0
202223,MIPC125003,SCUOLA SECONDARIA II GRADO,5,19,18,1,0,1
202223,NATDQN500O,SCUOLA SECONDARIA II GRADO,2,3,3,0,0,0
202223,TOPC10500T,SCUOLA SECONDARIA II GRADO,2,7,6,1,1,0
202223,PC1E002003,SCUOLA PRIMARIA,2,16,16,0,0,0
202223,RMPSNS500T,SCUOLA SECONDARIA II GRADO,2,6,6,0,0,0
202223,NATDAT500E,SCUOLA SECONDARIA II GRADO,4,3,3,0,0,0
202223,CA1E00900B,SCUOLA PRIMARIA,1,10,10,0,0,0
202223,PVTD065009,SCUOLA SECONDARIA II GRADO,3,7,6,1,0,1
202223,MI1M00700Q,SCUOLA SECONDARIA I GRADO,3,40,37,3,0,3
202223,NA1E085009,SCUOLA PRIMARIA,1,16,16,0,0,0
202223,VIPS3I500B,SCUOLA SECONDARIA II GRADO,2,31,30,1,0,1
202223,TV1E00700V,SCUOLA PRIMARIA,4,20,20,0,0,0
202223,NA1E007004,SCUOLA PRIMARIA,5,17,17,0,0,0
202223,CTTL07500E,SCUOLA SECONDARIA II GRADO,2,7,7,0,0,0
202223,MITD5V500H,SCUOLA SECONDARIA II GRADO,3,46,41,5,0,5
202223,BS1EU3500Q,SCUOLA PRIMARIA,5,26,23,3,0,3
202223,BS1M025007,SCUOLA SECONDARIA I GRADO,1,26,26,0,0,0
202223,AVTD045005,SCUOLA SECONDARIA II GRADO,2,8,7,1,1,0
202223,PATL095008,SCUOLA SECONDARIA II GRADO,2,1,1,0,0,0
202223,VRPS3P500M,SCUOLA SECONDARIA II GRADO,3,24,24,0,0,0
202223,RM1M057009,SCUOLA SECONDARIA I GRADO,3,81,80,1,1,0
202223,SATF1Z500T,SCUOLA SECONDARIA II GRADO,3,6,6,0,0,0
202223,RMPS27500L,SCUOLA SECONDARIA II GRADO,5,24,18,6,0,6
202223,MOTD04500G,SCUOLA SECONDARIA II GRADO,2,18,14,4,0,4
202223,RMPMTS5005,SCUOLA SECONDARIA II GRADO,3,13,13,0,0,0
202223,CHTD035004,SCUOLA SECONDARIA II GRADO,4,5,5,0,0,0
202223,RM1E163008,SCUOLA PRIMARIA,3,24,24,0,0,0
202223,MI1M063004,SCUOLA SECONDARIA I GRADO,2,120,120,0,0,0
202223,MI1E2B5001,SCUOLA PRIMARIA,1,33,31,2,0,2
202223,SAPSNV500C,SCUOLA SECONDARIA II GRADO,4,5,4,1,0,1
202223,NAPL975007,SCUOLA SECONDARIA II GRADO,5,22,21,1,0,1
202223,FR1E00500L,SCUOLA PRIMARIA,2,15,15,0,0,0
202223,RMPL135004,SCUOLA SECONDARIA II GRADO,3,15,14,1,1,0
202223,PAPMUP500I,SCUOLA SECONDARIA II GRADO,2,4,4,0,0,0
202223,CERHU1500P,SCUOLA SECONDARIA II GRADO,1,21,18,3,0,3
202223,PO1E00900G,SCUOLA PRIMARIA,2,27,20,7,0,7
202223,NARHRH500P,SCUOLA SECONDARIA II GRADO,4,12,12,0,0,0
202223,CETFS0500N,SCUOLA SECONDARIA II GRADO,2,6,6,0,0,0
202223,CTPM345004,SCUOLA SECONDARIA II GRADO,3,7,7,0,0,0
202223,VRPM055006,SCUOLA SECONDARIA II GRADO,4,22,22,0,0,0
202223,MB1M02200P,SCUOLA SECONDARIA I GRADO,2,42,40,2,0,2
202223,BS1E01800V,SCUOLA PRIMARIA,1,46,46,0,0,0
202223,BG1E00400C,SCUOLA PRIMARIA,3,51,49,2,0,2
202223,NATD0C5008,SCUOLA SECONDARIA II GRADO,2,3,3,0,0,0
202223,NATD21500T,SCUOLA SECONDARIA II GRADO,4,4,3,1,0,1
202223,VEPS04500V,SCUOLA SECONDARIA II GRADO,1,22,21,1,0,1
202223,REPM3F5001,SCUOLA SECONDARIA II GRADO,3,41,37,4,1,3
202223,TV1E00900E,SCUOLA PRIMARIA,2,21,18,3,1,2
202223,CT1M01600C,SCUOLA SECONDARIA I GRADO,1,21,20,1,0,1
202223,TO1M020006,SCUOLA SECONDARIA I GRADO,1,49,48,1,0,1
202223,VR1M00300C,SCUOLA SECONDARIA I GRADO,1,54,54,0,0,0
202223,VR1E02100R,SCUOLA PRIMARIA,5,24,24,0,0,0
202223,CO1E012006,SCUOLA PRIMARIA,4,21,21,0,0,0
202223,FIPS035009,SCUOLA SECONDARIA II GRADO,2,9,9,0,0,0
202223,RMPLLD5008,SCUOLA SECONDARIA II GRADO,3,9,9,0,0,0
202223,AQ1E00500T,SCUOLA PRIMARIA,5,21,20,1,1,0
202223,NA1E106005,SCUOLA PRIMARIA,4,25,25,0,0,0
202223,RM1M11200L,SCUOLA SECONDARIA I GRADO,1,9,9,0,0,0
202223,RM1M106009,SCUOLA SECONDARIA I GRADO,1,5,3,2,0,2
202223,CR1M00200X,SCUOLA SECONDARIA I GRADO,1,39,37,2,0,2
202223,CA1M01100L,SCUOLA SECONDARIA I GRADO,1,34,32,2,0,2
202223,RM1E04600N,SCUOLA PRIMARIA,4,16,15,1,0,1
202223,MB1E058008,SCUOLA PRIMARIA,3,28,28,0,0,0
202223,GE1E01400X,SCUOLA PRIMARIA,5,18,17,1,0,1
202223,PERF71500A,SCUOLA SECONDARIA II GRADO,5,14,14,0,0,0
202223,LT1E00400C,SCUOLA PRIMARIA,1,14,13,1,0,1
202223,CE1E030007,SCUOLA PRIMARIA,2,18,18,0,0,0
202223,SATD2H5007,SCUOLA SECONDARIA II GRADO,5,70,67,3,3,0
202223,BG1MT0500I,SCUOLA SECONDARIA I GRADO,2,44,44,0,0,0
202223,MIPM01500Q,SCUOLA SECONDARIA II GRADO,2,26,26,0,0,0
202223,VRPC04500B,SCUOLA SECONDARIA II GRADO,4,27,26,1,1,0
202223,NAPS92500P,SCUOLA SECONDARIA II GRADO,1,28,18,10,0,10
202223,NA1E09000R,SCUOLA PRIMARIA,3,27,26,1,0,1
202223,BA1E00400B,SCUOLA PRIMARIA,3,36,33,3,1,2
202223,CS1E002006,SCUOLA PRIMARIA,1,13,13,0,0,0
202223,NA1E007004,SCUOLA PRIMARIA,4,15,15,0,0,0
202223,CA1E019002,SCUOLA PRIMARIA,5,13,12,1,0,1
202223,TO1E6M500I,SCUOLA PRIMARIA,2,41,39,2,1,1
202223,RN1E00400D,SCUOLA PRIMARIA,5,37,37,0,0,0
202223,RMTDSN500S,SCUOLA SECONDARIA II GRADO,3,9,9,0,0,0
202223,MB1E06900P,SCUOLA PRIMARIA,4,54,47,7,1,6
202223,MB1E052009,SCUOLA PRIMARIA,2,35,35,0,0,0
202223,CTTD335008,SCUOLA SECONDARIA II GRADO,5,30,28,2,1,1
202223,VI1E00900T,SCUOLA PRIMARIA,5,25,25,0,0,0
202223,MEPLZL500L,SCUOLA SECONDARIA II GRADO,1,4,4,0,0,0
202223,MITF005006,SCUOLA SECONDARIA II GRADO,5,62,61,1,0,1
202223,RMPC255008,SCUOLA SECONDARIA II GRADO,2,12,12,0,0,0
202223,VT1E002002,SCUOLA PRIMARIA,2,23,23,0,0,0
202223,VRPS09500G,SCUOLA SECONDARIA II GRADO,3,16,16,0,0,0
202223,BNTDDC500S,SCUOLA SECONDARIA II GRADO,5,70,66,4,0,4
202223,MI1E08500Q,SCUOLA PRIMARIA,2,25,24,1,1,0
202223,RM1E10900G,SCUOLA PRIMARIA,4,17,16,1,1,0
202223,CT1E00100D,SCUOLA PRIMARIA,4,24,24,0,0,0
202223,VR1M92500T,SCUOLA SECONDARIA I GRADO,1,31,30,1,1,0
202223,GEPMUO500T,SCUOLA SECONDARIA II GRADO,2,21,19,2,0,2
202223,MIPSN6500B,SCUOLA SECONDARIA II GRADO,1,14,14,0,0,0
202223,NA1E22900P,SCUOLA PRIMARIA,2,10,8,2,0,2
202223,TATF035003,SCUOLA SECONDARIA II GRADO,2,15,15,0,0,0
202223,NA1E17300X,SCUOLA PRIMARIA,2,10,10,0,0,0
202223,CS1E010005,SCUOLA PRIMARIA,3,12,12,0,0,0
202223,CE1E043009,SCUOLA PRIMARIA,3,27,24,3,2,1
202223,VA1M004006,SCUOLA SECONDARIA I GRADO,3,35,35,0,0,0
202223,VBPM03500D,SCUOLA SECONDARIA II GRADO,1,9,9,0,0,0
202223,VAPLL0500E,SCUOLA SECONDARIA II GRADO,4,16,16,0,0,0
202223,NA1E04800A,SCUOLA PRIMARIA,5,34,34,0,0,0
202223,CE1E00900T,SCUOLA PRIMARIA,4,13,13,0,0,0
202223,VT1E001006,SCUOLA PRIMARIA,4,19,17,2,0,2
202223,ATPL01500N,SCUOLA SECONDARIA II GRADO,2,2,2,0,0,0
202223,BS1E00500R,SCUOLA PRIMARIA,4,30,25,5,0,5
202223,TETD00500B,SCUOLA SECONDARIA II GRADO,3,10,10,0,0,0
202223,RM1E186001,SCUOLA PRIMARIA,1,16,15,1,0,1
202223,LEPC01500P,SCUOLA SECONDARIA II GRADO,4,5,5,0,0,0
202223,CS1E00400T,SCUOLA PRIMARIA,3,4,4,0,0,0
202223,AGTD685001,SCUOLA SECONDARIA II GRADO,5,46,46,0,0,0
202223,CSRFQA500F,SCUOLA SECONDARIA II GRADO,4,5,5,0,0,0
202223,TO1E01900R,SCUOLA PRIMARIA,1,26,26,0,0,0
202223,CERHT0500Q,SCUOLA SECONDARIA II GRADO,1,8,0,8,0,8
202223,RNTD02500G,SCUOLA SECONDARIA II GRADO,2,9,7,2,0,2
202223,BG1M01900B,SCUOLA SECONDARIA I GRADO,1,62,57,5,1,4
202223,PD1M007002,SCUOLA SECONDARIA I GRADO,3,39,36,3,0,3
202223,SATNC2500G,SCUOLA SECONDARIA II GRADO,2,6,6,0,0,0
202223,UDPSBD500N,SCUOLA SECONDARIA II GRADO,3,19,18,1,1,0
202223,RMPM4G5004,SCUOLA SECONDARIA II GRADO,3,25,25,0,0,0
202223,NA1E355008,SCUOLA PRIMARIA,5,22,22,0,0,0
202223,MI1E083004,SCUOLA PRIMARIA,4,45,44,1,1,0
202223,MI1M08100N,SCUOLA SECONDARIA I GRADO,1,34,31,3,0,3
202223,NO1E001004,SCUOLA PRIMARIA,5,23,22,1,0,1
202223,RM1E02400R,SCUOLA PRIMARIA,4,49,47,2,0,2
202223,NA1E01100Q,SCUOLA PRIMARIA,5,14,14,0,0,0
202223,VA1E01200X,SCUOLA PRIMARIA,4,38,38,0,0,0
202223,RM1M016003,SCUOLA SECONDARIA I GRADO,2,13,12,1,1,0
202223,BGSD01500E,SCUOLA SECONDARIA II GRADO,2,45,45,0,0,0
202223,SRTHA6500C,SCUOLA SECONDARIA II GRADO,3,2,2,0,0,0
202223,RM1E204009,SCUOLA PRIMARIA,5,13,13,0,0,0
202223,BG1M008001,SCUOLA SECONDARIA I GRADO,3,24,23,1,0,1
202223,NA1E01900A,SCUOLA PRIMARIA,1,25,24,1,0,1
202223,TVPS015003,SCUOLA SECONDARIA II GRADO,5,30,30,0,0,0
202223,NA1E247008,SCUOLA PRIMARIA,2,13,13,0,0,0
202223,TO1MUU5007,SCUOLA SECONDARIA I GRADO,2,23,21,2,2,0
202223,ENSD01500A,SCUOLA SECONDARIA II GRADO,1,22,22,0,0,0
202223,FE1MFE500C,SCUOLA SECONDARIA I GRADO,3,26,26,0,0,0
202223,NATD9Z5006,SCUOLA SECONDARIA II GRADO,1,15,15,0,0,0
202223,NA1E12300V,SCUOLA PRIMARIA,3,47,47,0,0,0
202223,CE1ELC500C,SCUOLA PRIMARIA,2,15,14,1,0,1
202223,RMPC19500T,SCUOLA SECONDARIA II GRADO,3,13,13,0,0,0
202223,MITL485005,SCUOLA SECONDARIA II GRADO,3,24,22,2,0,2
202223,BATD01500V,SCUOLA SECONDARIA II GRADO,4,5,5,0,0,0
202223,BSTD355007,SCUOLA SECONDARIA II GRADO,4,14,12,2,1,1
202223,RA1E00100Q,SCUOLA PRIMARIA,2,24,22,2,1,1
202223,PDRHMH500P,SCUOLA SECONDARIA II GRADO,3,18,16,2,0,2
202223,VR1E00100G,SCUOLA PRIMARIA,2,14,7,7,0,7
202223,MCTFBF5005,SCUOLA SECONDARIA II GRADO,2,4,4,0,0,0
202223,BGPS1G5008,SCUOLA SECONDARIA II GRADO,5,17,17,0,0,0
202223,PG1EPF500P,SCUOLA PRIMARIA,1,21,21,0,0,0
202223,RM1M00600C,SCUOLA SECONDARIA I GRADO,1,26,25,1,1,0
202223,MERHH5500F,SCUOLA SECONDARIA II GRADO,3,1,1,0,0,0
202223,METL98500P,SCUOLA SECONDARIA II GRADO,3,1,1,0,0,0
202223,SS1E01300B,SCUOLA PRIMARIA,1,11,11,0,0,0
202223,LC1E003005,SCUOLA PRIMARIA,3,27,25,2,0,2
202223,TVPS05500D,SCUOLA SECONDARIA II GRADO,1,8,8,0,0,0
202223,NA1E23200E,SCUOLA PRIMARIA,3,10,10,0,0,0
202223,BGTD1D5000,SCUOLA SECONDARIA II GRADO,1,19,19,0,0,0
202223,UD1E00600B,SCUOLA PRIMARIA,2,26,25,1,0,1
202223,MIPS295009,SCUOLA SECONDARIA II GRADO,4,46,45,1,1,0
202223,NA1E08200T,SCUOLA PRIMARIA,5,17,15,2,0,2
202223,FR1E007008,SCUOLA PRIMARIA,5,17,17,0,0,0
202223,VR1E003007,SCUOLA PRIMARIA,3,13,13,0,0,0
202223,RMPL07500N,SCUOLA SECONDARIA II GRADO,5,44,43,1,1,0
202223,RM1E05400L,SCUOLA PRIMARIA,5,24,24,0,0,0
202223,TARF2M500U,SCUOLA SECONDARIA II GRADO,1,4,4,0,0,0
202223,NA1M015008,SCUOLA SECONDARIA I GRADO,2,26,26,0,0,0
202223,BSPS13500P,SCUOLA SECONDARIA II GRADO,1,24,23,1,0,1
202223,VE1E00700V,SCUOLA PRIMARIA,3,14,9,5,0,5
202223,FI1E00400C,SCUOLA PRIMARIA,1,34,32,2,0,2
202223,VATF295009,SCUOLA SECONDARIA II GRADO,1,27,25,2,0,2
202223,RM1E16000R,SCUOLA PRIMARIA,5,12,12,0,0,0
202223,NATF41500Q,SCUOLA SECONDARIA II GRADO,3,9,9,0,0,0
202223,GE1E034005,SCUOLA PRIMARIA,5,22,22,0,0,0
202223,AR1E001005,SCUOLA PRIMARIA,2,13,13,0,0,0
202223,MIPS1R500A,SCUOLA SECONDARIA II GRADO,1,39,39,0,0,0
202223,RMTD355004,SCUOLA SECONDARIA II GRADO,1,13,12,1,0,1
202223,MB1EVP500T,SCUOLA PRIMARIA,3,15,15,0,0,0
202223,VETF015005,SCUOLA SECONDARIA II GRADO,4,81,79,2,0,2
202223,MI1M083009,SCUOLA SECONDARIA I GRADO,3,17,16,1,0,1
202223,MI1E00200B,SCUOLA PRIMARIA,2,20,18,2,0,2
202223,SARHZG500U,SCUOLA SECONDARIA II GRADO,1,6,6,0,0,0
202223,RE1E008001,SCUOLA PRIMARIA,4,40,39,1,0,1
202223,NAPC095002,SCUOLA SECONDARIA II GRADO,2,14,14,0,0,0
202223,TV1E006003,SCUOLA PRIMARIA,4,10,9,1,0,1
202223,RGTD04500G,SCUOLA SECONDARIA II GRADO,5,14,14,0,0,0
202223,RM1E00400G,SCUOLA PRIMARIA,3,22,22,0,0,0
202223,RM1ES55005,SCUOLA PRIMARIA,1,13,12,1,0,1
202223,RM1E21500Q,SCUOLA PRIMARIA,3,14,13,1,1,0
202223,LC1E009004,SCUOLA PRIMARIA,3,45,45,0,0,0
202223,SATFUB5003,SCUOLA SECONDARIA II GRADO,2,3,3,0,0,0
202223,NATF0M5006,SCUOLA SECONDARIA II GRADO,5,173,159,14,2,12
202223,NA1E11000R,SCUOLA PRIMARIA,3,25,25,0,0,0
202223,TOTD08500R,SCUOLA SECONDARIA II GRADO,2,18,17,1,0,1
202223,BG1E013007,SCUOLA PRIMARIA,4,25,25,0,0,0
202223,RMPSCH500E,SCUOLA SECONDARIA II GRADO,1,16,16,0,0,0
202223,VETN745000,SCUOLA SECONDARIA II GRADO,5,14,14,0,0,0
202223,AGTD4U500B,SCUOLA SECONDARIA II GRADO,5,120,118,2,1,1
202223,NA1E206002,SCUOLA PRIMARIA,4,11,11,0,0,0
202223,RM1EBQ5007,SCUOLA PRIMARIA,3,10,9,1,0,1
202223,CT1EH25008,SCUOLA PRIMARIA,1,14,14,0,0,0
202223,AVPM10500T,SCUOLA SECONDARIA II GRADO,2,7,7,0,0,0
202223,COTD06500Q,SCUOLA SECONDARIA II GRADO,3,10,8,2,0,2
202223,TOPS01500P,SCUOLA SECONDARIA II GRADO,4,44,41,3,2,1
202223,RMPSRQ500V,SCUOLA SECONDARIA II GRADO,3,47,46,1,0,1
202223,RM1E10800Q,SCUOLA PRIMARIA,1,26,25,1,1,0
202223,TO1M055005,SCUOLA SECONDARIA I GRADO,2,11,11,0,0,0
202223,FG1E015006,SCUOLA PRIMARIA,3,16,16,0,0,0
202223,SATF795007,SCUOLA SECONDARIA II GRADO,3,2,2,0,0,0
202223,RM1M024002,SCUOLA SECONDARIA I GRADO,1,71,68,3,2,1
202223,NAPSAV500Q,SCUOLA SECONDARIA II GRADO,5,49,46,3,0,3
202223,MI1E04300N,SCUOLA PRIMARIA,5,39,37,2,0,2
202223,PVPS5H500G,SCUOLA SECONDARIA II GRADO,2,14,14,0,0,0
202223,RM1E015002,SCUOLA PRIMARIA,2,25,24,1,0,1
202223,MIPM0O500U,SCUOLA SECONDARIA II GRADO,3,35,33,2,1,1
202223,TV1E00100X,SCUOLA PRIMARIA,4,25,25,0,0,0
202223,SATDD75001,SCUOLA SECONDARIA II GRADO,1,5,5,0,0,0
202223,PA1E035005,SCUOLA PRIMARIA,4,56,56,0,0,0
202223,FI1E01200B,SCUOLA PRIMARIA,2,22,21,1,0,1
202223,AVRH015007,SCUOLA SECONDARIA II GRADO,3,5,5,0,0,0
202223,BNTFOA500V,SCUOLA SECONDARIA II GRADO,1,8,8,0,0,0
202223,NA1E14700B,SCUOLA PRIMARIA,2,15,14,1,0,1
202223,RMPSPL500P,SCUOLA SECONDARIA II GRADO,3,20,20,0,0,0
202223,NAPS3S500N,SCUOLA SECONDARIA II GRADO,3,7,7,0,0,0
202223,RM1M03900Q,SCUOLA SECONDARIA I GRADO,2,32,31,1,0,1
202223,RMPS265002,SCUOLA SECONDARIA II GRADO,5,29,28,1,0,1
202223,PV1M004002,SCUOLA SECONDARIA I GRADO,1,24,20,4,0,4
202223,MSPC01500B,SCUOLA SECONDARIA II GRADO,2,19,18,1,0,1
202223,MI1M04900T,SCUOLA SECONDARIA I GRADO,1,60,59,1,0,1
202223,TV1E013006,SCUOLA PRIMARIA,2,19,18,1,0,1
202223,CE1E04800C,SCUOLA PRIMARIA,3,20,20,0,0,0
202223,FRPC02500X,SCUOLA SECONDARIA II GRADO,1,19,17,2,1,1
202223,POPS00500D,SCUOLA SECONDARIA II GRADO,3,25,24,1,0,1
202223,LUPL01500A,SCUOLA SECONDARIA II GRADO,2,6,5,1,0,1
202223,NA1M040001,SCUOLA SECONDARIA I GRADO,3,26,22,4,0,4
202223,FI1E00800Q,SCUOLA PRIMARIA,3,19,16,3,0,3
202223,PATD91500R,SCUOLA SECONDARIA II GRADO,5,71,71,0,0,0
202223,RMSL02500P,SCUOLA SECONDARIA II GRADO,3,4,2,2,1,1
202223,PVPL02500T,SCUOLA SECONDARIA II GRADO,2,8,8,0,0,0
202223,MI1E137007,SCUOLA PRIMARIA,1,10,6,4,0,4
202223,PNPS9G5000,SCUOLA SECONDARIA II GRADO,1,10,9,1,0,1
202223,TV1M00800X,SCUOLA SECONDARIA I GRADO,2,84,82,2,2,0
202223,LCRFHO5008,SCUOLA SECONDARIA II GRADO,2,14,13,1,0,1
202223,TV1E01600N,SCUOLA PRIMARIA,3,25,23,2,0,2
202223,BOPLMA500N,SCUOLA SECONDARIA II GRADO,2,24,23,1,1,0
202223,FIPC05500B,SCUOLA SECONDARIA II GRADO,4,10,10,0,0,0
202223,FIPL06500X,SCUOLA SECONDARIA II GRADO,3,14,13,1,0,1
202223,LTPST2500E,SCUOLA SECONDARIA II GRADO,1,13,12,1,0,1
202223,BG1M02400V,SCUOLA SECONDARIA I GRADO,1,43,42,1,0,1
202223,TO1M00100R,SCUOLA SECONDARIA I GRADO,1,52,48,4,1,3
202223,SI1E002005,SCUOLA PRIMARIA,1,13,13,0,0,0
202223,CE1E01700R,SCUOLA PRIMARIA,3,18,18,0,0,0
202223,FIPSFU500L,SCUOLA SECONDARIA II GRADO,4,7,4,3,0,3
202223,CE1EO0500I,SCUOLA PRIMARIA,2,18,17,1,0,1
202223,RM1M13400D,SCUOLA SECONDARIA I GRADO,2,48,46,2,0,2
202223,MI1M089008,SCUOLA SECONDARIA I GRADO,3,10,9,1,0,1
202223,TOTB025006,SCUOLA SECONDARIA II GRADO,2,20,17,3,1,2
202223,RMPS505001,SCUOLA SECONDARIA II GRADO,4,20,20,0,0,0
202223,TO1E04400D,SCUOLA PRIMARIA,4,30,29,1,1,0
202223,RM1E094003,SCUOLA PRIMARIA,1,72,68,4,1,3
202223,MB1E09200Q,SCUOLA PRIMARIA,3,22,22,0,0,0
202223,PT1E004006,SCUOLA PRIMARIA,4,24,20,4,1,3
202223,ALPS005007,SCUOLA SECONDARIA II GRADO,2,14,14,0,0,0
202223,MIPS04500E,SCUOLA SECONDARIA II GRADO,4,12,12,0,0,0
202223,SA1E018001,SCUOLA PRIMARIA,2,5,5,0,0,0
202223,LTPLCG500C,SCUOLA SECONDARIA II GRADO,1,3,3,0,0,0
202223,SA1E00100G,SCUOLA PRIMARIA,5,13,13,0,0,0
202223,AGPSCE5001,SCUOLA SECONDARIA II GRADO,2,3,3,0,0,0
202223,PD1E020007,SCUOLA PRIMARIA,5,20,18,2,0,2
202223,PA1M01700R,SCUOLA SECONDARIA I GRADO,2,9,9,0,0,0
202223,AVTLU25001,SCUOLA SECONDARIA II GRADO,2,3,3,0,0,0
202223,CA1E00900B,SCUOLA PRIMARIA,2,12,12,0,0,0
202223,MI1E2B5001,SCUOLA PRIMARIA,2,16,15,1,0,1
202223,BGPSDM500A,SCUOLA SECONDARIA II GRADO,1,25,25,0,0,0
202223,CE1E028007,SCUOLA PRIMARIA,1,21,21,0,0,0
202223,VAPL08500N,SCUOLA SECONDARIA II GRADO,1,14,13,1,0,1
202223,CT1E02100P,SCUOLA PRIMARIA,3,11,11,0,0,0
202223,VRPM055006,SCUOLA SECONDARIA II GRADO,3,54,53,1,0,1
202223,RM1MZ7500R,SCUOLA SECONDARIA I GRADO,3,12,12,0,0,0
202223,NAPS5P500P,SCUOLA SECONDARIA II GRADO,4,6,6,0,0,0
202223,MS1E00100B,SCUOLA PRIMARIA,5,12,11,1,0,1
202223,LI1E00400D,SCUOLA PRIMARIA,2,20,19,1,0,1
202223,MI1E14200P,SCUOLA PRIMARIA,1,54,53,1,0,1
202223,RN1E007001,SCUOLA PRIMARIA,1,15,14,1,1,0
202223,MB1E03600B,SCUOLA PRIMARIA,4,19,18,1,0,1
202223,RMPL085008,SCUOLA SECONDARIA II GRADO,5,29,26,3,0,3
202223,VTPM7D500R,SCUOLA SECONDARIA II GRADO,3,10,9,1,1,0
202223,RN1M030007,SCUOLA SECONDARIA I GRADO,2,44,42,2,0,2
202223,PRPS015007,SCUOLA SECONDARIA II GRADO,3,12,12,0,0,0
202223,NATF34500R,SCUOLA SECONDARIA II GRADO,4,4,4,0,0,0
202223,UDTFI2500I,SCUOLA SECONDARIA II GRADO,3,19,19,0,0,0
202223,VRSL01500G,SCUOLA SECONDARIA II GRADO,1,10,9,1,0,1
202223,MB1M012004,SCUOLA SECONDARIA I GRADO,1,66,64,2,0,2
202223,NA1E227003,SCUOLA PRIMARIA,1,6,6,0,0,0
202223,NATA0L500I,SCUOLA SECONDARIA II GRADO,4,3,3,0,0,0
202223,REPMPU500Q,SCUOLA SECONDARIA II GRADO,1,11,11,0,0,0
202223,BOTF2S5000,SCUOLA SECONDARIA II GRADO,4,27,27,0,0,0
202223,VV1E00100R,SCUOLA PRIMARIA,4,21,20,1,0,1
202223,TO1M039007,SCUOLA SECONDARIA I GRADO,3,149,149,0,0,0
202223,NA1E029001,SCUOLA PRIMARIA,3,12,12,0,0,0
202223,BG1MT0500I,SCUOLA SECONDARIA I GRADO,3,27,27,0,0,0
202223,CO1M001001,SCUOLA SECONDARIA I GRADO,1,35,32,3,0,3
202223,BGPMNC5002,SCUOLA SECONDARIA II GRADO,2,20,20,0,0,0
202223,RMPMIO5006,SCUOLA SECONDARIA II GRADO,2,8,8,0,0,0
202223,FIPS035009,SCUOLA SECONDARIA II GRADO,4,16,16,0,0,0
202223,APTFOR5004,SCUOLA SECONDARIA II GRADO,2,25,24,1,0,1
202223,SA1M0B500F,SCUOLA SECONDARIA I GRADO,1,11,10,1,0,1
202223,LO1E00300V,SCUOLA PRIMARIA,4,20,20,0,0,0
202223,RMPS95500D,SCUOLA SECONDARIA II GRADO,5,25,25,0,0,0
202223,TO1E6M500I,SCUOLA PRIMARIA,1,44,40,4,0,4
202223,RMPS46500Q,SCUOLA SECONDARIA II GRADO,4,10,9,1,0,1
202223,RMTDSN500S,SCUOLA SECONDARIA II GRADO,2,1,1,0,0,0
202223,NOPC05500E,SCUOLA SECONDARIA II GRADO,3,56,54,2,0,2
202223,VA1E4D500Q,SCUOLA PRIMARIA,1,48,46,2,0,2
202223,TO1E02100R,SCUOLA PRIMARIA,2,50,48,2,0,2
202223,SA1E016009,SCUOLA PRIMARIA,2,19,19,0,0,0
202223,RM1E06900A,SCUOLA PRIMARIA,4,22,20,2,1,1
202223,MEPLZL500L,SCUOLA SECONDARIA II GRADO,2,6,6,0,0,0
202223,BSPC01500D,SCUOLA SECONDARIA II GRADO,2,26,26,0,0,0
202223,NA1E02500N,SCUOLA PRIMARIA,5,24,24,0,0,0
202223,VR1M00900B,SCUOLA SECONDARIA I GRADO,2,25,23,2,0,2
202223,CO1E012006,SCUOLA PRIMARIA,1,11,11,0,0,0
202223,NATDI75001,SCUOLA SECONDARIA II GRADO,3,9,9,0,0,0
202223,NATD5N500Q,SCUOLA SECONDARIA II GRADO,5,130,124,6,1,5
202223,MBPSIE500B,SCUOLA SECONDARIA II GRADO,2,12,12,0,0,0
202223,BLPSMD500A,SCUOLA SECONDARIA II GRADO,2,15,15,0,0,0
202223,BA1E00900E,SCUOLA PRIMARIA,1,57,55,2,0,2
202223,CRPS00500B,SCUOLA SECONDARIA II GRADO,2,21,21,0,0,0
202223,MO1E01100B,SCUOLA PRIMARIA,5,48,47,1,0,1
202223,BG1E005008,SCUOLA PRIMARIA,4,57,56,1,0,1
202223,CA1E013003,SCUOLA PRIMARIA,3,24,23,1,0,1
202223,TO1E02900B,SCUOLA PRIMARIA,5,17,16,1,0,1
202223,VI1M003004,SCUOLA SECONDARIA I GRADO,1,6,5,1,0,1
202223,BS1E025002,SCUOLA PRIMARIA,5,6,5,1,0,1
202223,BSPLPI500F,SCUOLA SECONDARIA II GRADO,2,15,13,2,0,2
202223,RM1E16100L,SCUOLA PRIMARIA,4,17,16,1,1,0
202223,RM1E128001,SCUOLA PRIMARIA,3,28,28,0,0,0
202223,MIPL265008,SCUOLA SECONDARIA II GRADO,2,14,14,0,0,0
202223,PD1E012008,SCUOLA PRIMARIA,3,35,35,0,0,0
202223,MBRC4H500I,SCUOLA SECONDARIA II GRADO,3,11,10,1,0,1
202223,MIPSDF5000,SCUOLA SECONDARIA II GRADO,5,34,34,0,0,0
202223,NATL83500Z,SCUOLA SECONDARIA II GRADO,5,104,100,4,2,2
202223,NA1E156006,SCUOLA PRIMARIA,5,9,8,1,0,1
202223,CE1E045001,SCUOLA PRIMARIA,1,14,13,1,0,1
202223,RGPL025009,SCUOLA SECONDARIA II GRADO,2,7,4,3,1,2
202223,RGRHH6500Z,SCUOLA SECONDARIA II GRADO,1,6,6,0,0,0
202223,BGPSAF500M,SCUOLA SECONDARIA II GRADO,1,7,6,1,1,0
202223,VA1MUI500S,SCUOLA SECONDARIA I GRADO,3,8,8,0,0,0
202223,BS1E02100P,SCUOLA PRIMARIA,4,20,16,4,0,4
202223,FI1E021006,SCUOLA PRIMARIA,1,25,24,1,1,0
202223,NATFAA500F,SCUOLA SECONDARIA II GRADO,5,47,47,0,0,0
202223,NATFTA500I,SCUOLA SECONDARIA II GRADO,2,9,9,0,0,0
202223,VRTF005006,SCUOLA SECONDARIA II GRADO,2,114,107,7,3,4
202223,UD1E00900V,SCUOLA PRIMARIA,3,8,8,0,0,0
202223,ARPM015009,SCUOLA SECONDARIA II GRADO,1,35,33,2,0,2
202223,AV1E01200R,SCUOLA PRIMARIA,5,2,0,2,0,2
202223,MBPMM55007,SCUOLA SECONDARIA II GRADO,2,31,31,0,0,0
202223,TO1E00600P,SCUOLA PRIMARIA,5,16,16,0,0,0
202223,RM1E18200N,SCUOLA PRIMARIA,3,12,10,2,0,2
202223,MI1E009006,SCUOLA PRIMARIA,1,119,115,4,1,3
202223,NA1E06800G,SCUOLA PRIMARIA,1,20,14,6,0,6
202223,GE1E02300P,SCUOLA PRIMARIA,4,17,13,4,0,4
202223,NARFGU5004,SCUOLA SECONDARIA II GRADO,2,3,3,0,0,0
202223,RNPC015002,SCUOLA SECONDARIA II GRADO,4,18,17,1,0,1
202223,NATF2E500L,SCUOLA SECONDARIA II GRADO,5,104,104,0,0,0
202223,RMTD77500R,SCUOLA SECONDARIA II GRADO,5,57,57,0,0,0
202223,RCTDPL500T,SCUOLA SECONDARIA II GRADO,3,4,4,0,0,0
202223,MI1E074009,SCUOLA PRIMARIA,4,27,27,0,0,0
202223,RM1E030004,SCUOLA PRIMARIA,1,16,14,2,2,0
202223,GE1E01000L,SCUOLA PRIMARIA,5,53,52,1,0,1
202223,VA1E01900P,SCUOLA PRIMARIA,1,85,83,2,0,2
202223,NARH25500E,SCUOLA SECONDARIA II GRADO,4,4,4,0,0,0
202223,RM1E212008,SCUOLA PRIMARIA,5,90,79,11,1,10
202223,CT1M02300G,SCUOLA SECONDARIA I GRADO,2,38,36,2,2,0
202223,CTPM075009,SCUOLA SECONDARIA II GRADO,3,8,8,0,0,0
202223,AVTFRU5000,SCUOLA SECONDARIA II GRADO,4,4,4,0,0,0
202223,FE1E00100N,SCUOLA PRIMARIA,3,42,34,8,3,5
202223,CE1ME85005,SCUOLA SECONDARIA I GRADO,1,10,9,1,1,0
202223,MCPM505001,SCUOLA SECONDARIA II GRADO,1,10,7,3,1,2
202223,RM1M10900R,SCUOLA SECONDARIA I GRADO,1,13,12,1,0,1
202223,MITFDH5000,SCUOLA SECONDARIA II GRADO,3,29,29,0,0,0
202223,BA1M01200G,SCUOLA SECONDARIA I GRADO,1,41,38,3,0,3
202223,NA1E18700T,SCUOLA PRIMARIA,4,25,17,8,7,1
202223,VI1E00600A,SCUOLA PRIMARIA,3,13,13,0,0,0
202223,RM1E10300L,SCUOLA PRIMARIA,1,43,41,2,1,1
202223,NAPM31500X,SCUOLA SECONDARIA II GRADO,3,6,5,1,1,0
202223,LEPS02500C,SCUOLA SECONDARIA II GRADO,4,11,11,0,0,0
202223,CE1E06300E,SCUOLA PRIMARIA,5,16,4,12,2,10
202223,FO1E00500D,SCUOLA PRIMARIA,4,31,26,5,1,4
202223,MESL0P500H,SCUOLA SECONDARIA II GRADO,4,3,2,1,1,0
202223,KR1M00100A,SCUOLA SECONDARIA I GRADO,2,20,19,1,1,0
202223,PR1M003001,SCUOLA SECONDARIA I GRADO,3,51,48,3,1,2
202223,RARI015004,SCUOLA SECONDARIA II GRADO,3,7,7,0,0,0
202223,MI1MMU500B,SCUOLA SECONDARIA I GRADO,3,27,25,2,1,1
202223,RM1E113007,SCUOLA PRIMARIA,5,16,16,0,0,0
202223,NATFZE5004,SCUOLA SECONDARIA II GRADO,4,2,2,0,0,0
202223,MI1M084005,SCUOLA SECONDARIA I GRADO,1,44,41,3,0,3
202223,NA1E18800N,SCUOLA PRIMARIA,3,8,8,0,0,0
202223,NAPC095002,SCUOLA SECONDARIA II GRADO,4,27,27,0,0,0
202223,LE1E00800D,SCUOLA PRIMARIA,3,22,21,1,1,0
202223,VR1E00800A,SCUOLA PRIMARIA,4,25,23,2,0,2
202223,TV1E00300G,SCUOLA PRIMARIA,5,25,25,0,0,0
202223,CTTD365004,SCUOLA SECONDARIA II GRADO,2,1,1,0,0,0
202223,TA1M00300D,SCUOLA SECONDARIA I GRADO,1,21,20,1,1,0
202223,FI1E006004,SCUOLA PRIMARIA,4,23,23,0,0,0
202223,BSPS2O5007,SCUOLA SECONDARIA II GRADO,3,11,11,0,0,0
202223,SATFVU500C,SCUOLA SECONDARIA II GRADO,4,6,6,0,0,0
202223,TOPS76500T,SCUOLA SECONDARIA II GRADO,4,53,52,1,1,0
202223,NA1E14000L,SCUOLA PRIMARIA,3,17,17,0,0,0
202223,RMPL26500R,SCUOLA SECONDARIA II GRADO,5,60,52,8,3,5
202223,AT1E00200G,SCUOLA PRIMARIA,1,16,14,2,2,0
202223,BG1E02300T,SCUOLA PRIMARIA,3,25,25,0,0,0
202223,RCTDO0500U,SCUOLA SECONDARIA II GRADO,1,2,2,0,0,0
202223,RM1M04300B,SCUOLA SECONDARIA I GRADO,1,27,26,1,0,1
202223,MI1M056001,SCUOLA SECONDARIA I GRADO,3,55,53,2,0,2
202223,MI1E123009,SCUOLA PRIMARIA,5,43,40,3,0,3
202223,MI1M07400E,SCUOLA SECONDARIA I GRADO,3,17,17,0,0,0
202223,SATABS5008,SCUOLA SECONDARIA II GRADO,5,70,69,1,1,0
202223,LC1M01000D,SCUOLA SECONDARIA I GRADO,1,35,35,0,0,0
202223,SRPS395007,SCUOLA SECONDARIA II GRADO,1,1,0,1,0,1
202223,NAPC24500P,SCUOLA SECONDARIA II GRADO,5,20,20,0,0,0
202223,AGTD685001,SCUOLA SECONDARIA II GRADO,1,3,3,0,0,0
202223,AL1M00700V,SCUOLA SECONDARIA I GRADO,3,16,15,1,0,1
202223,FO1M00600E,SCUOLA SECONDARIA I GRADO,2,61,58,3,1,2
202223,GE1E02900N,SCUOLA PRIMARIA,4,25,25,0,0,0
202223,RGTDCA500P,SCUOLA SECONDARIA II GRADO,2,1,1,0,0,0
202223,PATD205004,SCUOLA SECONDARIA II GRADO,4,6,6,0,0,0
202223,NA1E12600A,SCUOLA PRIMARIA,3,10,10,0,0,0
202223,NA1E21100D,SCUOLA PRIMARIA,3,11,11,0,0,0
202223,BS1E00100D,SCUOLA PRIMARIA,5,23,20,3,0,3
202223,LO1E001007,SCUOLA PRIMARIA,2,27,26,1,1,0
202223,BG1E00800Q,SCUOLA PRIMARIA,2,50,49,1,1,0
202223,TOPSQB5003,SCUOLA SECONDARIA II GRADO,2,22,20,2,2,0
202223,RM1E051005,SCUOLA PRIMARIA,2,12,10,2,2,0
202223,SP1E00400X,SCUOLA PRIMARIA,5,43,42,1,0,1
202223,FI1MIM500Z,SCUOLA SECONDARIA I GRADO,3,50,39,11,1,10
202223,VR1M01000G,SCUOLA SECONDARIA I GRADO,3,28,26,2,0,2
202223,RMPC29500P,SCUOLA SECONDARIA II GRADO,1,16,15,1,1,0
202223,NA1E031001,SCUOLA PRIMARIA,5,23,22,1,0,1
202223,AVRH015007,SCUOLA SECONDARIA II GRADO,4,4,4,0,0,0
202223,PAPC12500D,SCUOLA SECONDARIA II GRADO,3,48,48,0,0,0
202223,NA1E272001,SCUOLA PRIMARIA,2,21,21,0,0,0
202223,BL1E818011,SCUOLA PRIMARIA,3,1,1,0,0,0
202223,TO1M054009,SCUOLA SECONDARIA I GRADO,3,54,52,2,1,1
202223,RM1M151007,SCUOLA SECONDARIA I GRADO,3,58,58,0,0,0
202223,RM1M029005,SCUOLA SECONDARIA I GRADO,3,25,22,3,0,3
202223,MI1E039002,SCUOLA PRIMARIA,1,49,48,1,0,1
202223,NATLL75008,SCUOLA SECONDARIA II GRADO,3,7,7,0,0,0
202223,TPTD075004,SCUOLA SECONDARIA II GRADO,2,4,4,0,0,0
202223,CE1E03800T,SCUOLA PRIMARIA,5,22,22,0,0,0
202223,TVPL005007,SCUOLA SECONDARIA II GRADO,4,10,10,0,0,0
202223,RM1E15800R,SCUOLA PRIMARIA,5,11,4,7,0,7
202223,RM1E12500D,SCUOLA PRIMARIA,5,9,8,1,0,1
202223,NA1E130002,SCUOLA PRIMARIA,3,11,11,0,0,0
202223,NA1E26500T,SCUOLA PRIMARIA,1,17,16,1,1,0
202223,BGTFUM500Z,SCUOLA SECONDARIA II GRADO,1,8,7,1,0,1
202223,NAPS25500C,SCUOLA SECONDARIA II GRADO,1,8,7,1,0,1
202223,MSPSI35008,SCUOLA SECONDARIA II GRADO,5,9,8,1,0,1
202223,NATL265009,SCUOLA SECONDARIA II GRADO,3,4,4,0,0,0
202223,ANRFBS500Z,SCUOLA SECONDARIA II GRADO,5,24,23,1,1,0
202223,CHTF00500E,SCUOLA SECONDARIA II GRADO,2,3,2,1,1,0
202223,APPM04500X,SCUOLA SECONDARIA II GRADO,3,19,18,1,0,1
202223,LCRC4F500Q,SCUOLA SECONDARIA II GRADO,5,18,17,1,0,1
202223,CE1E03300P,SCUOLA PRIMARIA,2,15,15,0,0,0
202223,RGPM0A500T,SCUOLA SECONDARIA II GRADO,2,7,7,0,0,0
202223,BGPS135006,SCUOLA SECONDARIA II GRADO,5,12,12,0,0,0
202223,PO1E01100G,SCUOLA PRIMARIA,5,25,24,1,0,1
202223,MITD73500S,SCUOLA SECONDARIA II GRADO,4,19,18,1,0,1
202223,SSPSNU500Q,SCUOLA SECONDARIA II GRADO,5,6,6,0,0,0
202223,POPS9T5004,SCUOLA SECONDARIA II GRADO,3,20,11,9,0,9
202223,VE1E00400B,SCUOLA PRIMARIA,1,44,33,11,1,10
202223,GE1M027007,SCUOLA SECONDARIA I GRADO,1,26,25,1,0,1
202223,RMPLO35009,SCUOLA SECONDARIA II GRADO,2,2,2,0,0,0
202223,MI1E082008,SCUOLA PRIMARIA,3,37,34,3,1,2
202223,GEPS70500C,SCUOLA SECONDARIA II GRADO,5,62,62,0,0,0
202223,MIPSEA5006,SCUOLA SECONDARIA II GRADO,4,11,10,1,0,1
202223,RMSLBH500V,SCUOLA SECONDARIA II GRADO,3,14,14,0,0,0
202223,PIPS02500D,SCUOLA SECONDARIA II GRADO,1,10,9,1,0,1
202223,MI1E00500V,SCUOLA PRIMARIA,5,25,24,1,0,1
202223,SARFMI5004,SCUOLA SECONDARIA II GRADO,5,33,29,4,1,3
202223,RM1E073002,SCUOLA PRIMARIA,1,30,23,7,4,3
202223,PAPS3Q5009,SCUOLA SECONDARIA II GRADO,4,41,40,1,0,1
202223,VA1M9G500V,SCUOLA SECONDARIA I GRADO,3,98,94,4,0,4
202223,NA1MIM5003,SCUOLA SECONDARIA I GRADO,2,12,12,0,0,0
202223,BSPSO5500G,SCUOLA SECONDARIA II GRADO,5,20,20,0,0,0
202223,VE1E006003,SCUOLA PRIMARIA,2,21,20,1,0,1
202223,CTTD045008,SCUOLA SECONDARIA II GRADO,2,3,3,0,0,0
202223,CE1E01100T,SCUOLA PRIMARIA,2,27,26,1,0,1
202223,MI1E08600G,SCUOLA PRIMARIA,2,53,46,7,2,5
202223,PA1E005009,SCUOLA PRIMARIA,2,32,32,0,0,0
202223,SAPS06500Q,SCUOLA SECONDARIA II GRADO,2,4,4,0,0,0
202223,MO1E004008,SCUOLA PRIMARIA,1,25,25,0,0,0
202223,BAPS035008,SCUOLA SECONDARIA II GRADO,5,7,6,1,0,1
202223,LT1E00200R,SCUOLA PRIMARIA,2,24,20,4,0,4
202223,RMPS59500C,SCUOLA SECONDARIA II GRADO,3,8,6,2,0,2
202223,RM1E100005,SCUOLA PRIMARIA,1,19,17,2,0,2
202223,NO1E00400G,SCUOLA PRIMARIA,5,70,68,2,0,2
202223,PSPS005004,SCUOLA SECONDARIA II GRADO,3,11,11,0,0,0
202223,NA1E200003,SCUOLA PRIMARIA,2,10,10,0,0,0
202223,MIPS06500Q,SCUOLA SECONDARIA II GRADO,2,11,11,0,0,0
202223,SA1E01000A,SCUOLA PRIMARIA,1,11,10,1,0,1
202223,RM1M010004,SCUOLA SECONDARIA I GRADO,1,26,26,0,0,0
202223,LC1E002009,SCUOLA PRIMARIA,2,50,50,0,0,0
202223,RM1E13200L,SCUOLA PRIMARIA,5,21,19,2,0,2
202223,MI1E045009,SCUOLA PRIMARIA,3,18,18,0,0,0
202223,MNPL02500L,SCUOLA SECONDARIA II GRADO,2,7,7,0,0,0
202223,RMPMQB5004,SCUOLA SECONDARIA II GRADO,2,27,26,1,0,1
202223,SAPMNI5000,SCUOLA SECONDARIA II GRADO,2,2,1,1,1,0
202223,CA1E00700Q,SCUOLA PRIMARIA,2,24,23,1,0,1
202223,TPTDS9500A,SCUOLA SECONDARIA II GRADO,3,3,3,0,0,0
202223,NA1E19000N,SCUOLA PRIMARIA,3,13,13,0,0,0
202223,FI1E02500D,SCUOLA PRIMARIA,3,16,15,1,0,1
202223,BOPL02500B,SCUOLA SECONDARIA II GRADO,4,19,18,1,1,0
202223,VIPL015005,SCUOLA SECONDARIA II GRADO,2,8,7,1,0,1
202223,VAPS4N5008,SCUOLA SECONDARIA II GRADO,1,25,23,2,1,1
202223,TOPQ04500Q,SCUOLA SECONDARIA II GRADO,5,38,38,0,0,0
202223,RM1E13900B,SCUOLA PRIMARIA,3,21,21,0,0,0
202223,RM1E135004,SCUOLA PRIMARIA,1,14,13,1,0,1
202223,NATDGC5003,SCUOLA SECONDARIA II GRADO,2,9,8,1,0,1
202223,COSL02500A,SCUOLA SECONDARIA II GRADO,5,10,10,0,0,0
202223,MI1M10600R,SCUOLA SECONDARIA I GRADO,3,13,12,1,0,1
202223,NA1E243001,SCUOLA PRIMARIA,5,11,10,1,0,1
202223,MIPC125003,SCUOLA SECONDARIA II GRADO,3,19,19,0,0,0
202223,PATD34500B,SCUOLA SECONDARIA II GRADO,2,1,1,0,0,0
202223,CZPM00500Q,SCUOLA SECONDARIA II GRADO,3,18,16,2,1,1
202223,PC1E002003,SCUOLA PRIMARIA,1,15,12,3,1,2
202223,NA1E151003,SCUOLA PRIMARIA,4,22,22,0,0,0
202223,BG1E01800A,SCUOLA PRIMARIA,5,29,29,0,0,0
202223,BG1E026009,SCUOLA PRIMARIA,3,18,16,2,0,2
202223,RMPS00500L,SCUOLA SECONDARIA II GRADO,3,2,2,0,0,0
202223,TO1E012002,SCUOLA PRIMARIA,5,18,18,0,0,0
202223,PVSLMT5003,SCUOLA SECONDARIA II GRADO,4,8,8,0,0,0
202223,APPSL05000,SCUOLA SECONDARIA II GRADO,5,18,17,1,0,1
202223,MI1EA8500G,SCUOLA PRIMARIA,3,33,28,5,0,5
202223,RMTND1500F,SCUOLA SECONDARIA II GRADO,2,5,5,0,0,0
202223,REPMPU500Q,SCUOLA SECONDARIA II GRADO,2,13,13,0,0,0
202223,NAPC00500E,SCUOLA SECONDARIA II GRADO,1,12,12,0,0,0
202223,MI1E02100R,SCUOLA PRIMARIA,4,38,38,0,0,0
202223,NAPLQ2500N,SCUOLA SECONDARIA II GRADO,4,4,4,0,0,0
202223,PE1E003004,SCUOLA PRIMARIA,1,12,12,0,0,0
202223,FRTFF6500V,SCUOLA SECONDARIA II GRADO,4,2,2,0,0,0
202223,RM1E006007,SCUOLA PRIMARIA,4,28,23,5,3,2
202223,CETDHG500L,SCUOLA SECONDARIA II GRADO,5,62,56,6,2,4
202223,VAPS6M5003,SCUOLA SECONDARIA II GRADO,4,26,26,0,0,0
202223,COPS055009,SCUOLA SECONDARIA II GRADO,2,27,26,1,1,0
202223,MIPC06500L,SCUOLA SECONDARIA II GRADO,4,24,23,1,1,0
202223,BG1E021006,SCUOLA PRIMARIA,1,31,29,2,1,1
202223,NA1E22800V,SCUOLA PRIMARIA,4,14,14,0,0,0
202223,RMPMR25005,SCUOLA SECONDARIA II GRADO,5,52,48,4,2,2
202223,PV1M008009,SCUOLA SECONDARIA I GRADO,2,36,36,0,0,0
202223,MBPS245005,SCUOLA SECONDARIA II GRADO,5,6,6,0,0,0
202223,NATD27500D,SCUOLA SECONDARIA II GRADO,4,8,8,0,0,0
202223,RM1E171007,SCUOLA PRIMARIA,3,17,16,1,1,0
202223,RE1E006009,SCUOLA PRIMARIA,3,12,11,1,0,1
202223,NA1E078006,SCUOLA PRIMARIA,1,22,21,1,0,1
202223,BOPSR2500M,SCUOLA SECONDARIA II GRADO,3,48,47,1,0,1
202223,CETD135008,SCUOLA SECONDARIA II GRADO,5,52,48,4,1,3
202223,CETD4C500S,SCUOLA SECONDARIA II GRADO,4,8,2,6,0,6
202223,LU1E00400X,SCUOLA PRIMARIA,2,17,17,0,0,0
202223,VE1M006008,SCUOLA SECONDARIA I GRADO,1,9,5,4,0,4
202223,FI1E00200R,SCUOLA PRIMARIA,1,36,35,1,0,1
202223,BGPS00500D,SCUOLA SECONDARIA II GRADO,5,27,26,1,0,1
202223,VARFR75004,SCUOLA SECONDARIA II GRADO,5,6,5,1,0,1
202223,CERH4F500L,SCUOLA SECONDARIA II GRADO,3,11,11,0,0,0
202223,AV1E00500N,SCUOLA PRIMARIA,5,13,13,0,0,0
202223,RM1M09300C,SCUOLA SECONDARIA I GRADO,3,15,11,4,0,4
202223,SA1M01100B,SCUOLA SECONDARIA I GRADO,2,1,1,0,0,0
202223,RM1E198007,SCUOLA PRIMARIA,3,23,19,4,3,1
202223,SA1E02300C,SCUOLA PRIMARIA,2,10,9,1,0,1
202223,GE1E01700B,SCUOLA PRIMARIA,4,20,19,1,1,0
202223,RM1E07500N,SCUOLA PRIMARIA,5,88,85,3,2,1
202223,PV1E008004,SCUOLA PRIMARIA,3,20,16,4,0,4
202223,LTTF9N5007,SCUOLA SECONDARIA II GRADO,4,2,2,0,0,0
202223,CT1M011009,SCUOLA SECONDARIA I GRADO,2,14,11,3,0,3
202223,BS1M018004,SCUOLA SECONDARIA I GRADO,2,28,26,2,1,1
202223,PD1E020007,SCUOLA PRIMARIA,1,26,26,0,0,0
202223,PDPL04500G,SCUOLA SECONDARIA II GRADO,4,15,14,1,0,1
202223,CZPC00500G,SCUOLA SECONDARIA II GRADO,5,15,15,0,0,0
202223,BLPC01500G,SCUOLA SECONDARIA II GRADO,4,9,9,0,0,0
202223,NA1E119007,SCUOLA PRIMARIA,2,22,20,2,0,2
202223,VARHL7500G,SCUOLA SECONDARIA II GRADO,2,3,3,0,0,0
202223,CE1E06700T,SCUOLA PRIMARIA,2,10,9,1,0,1
202223,FGRHSR500L,SCUOLA SECONDARIA II GRADO,5,12,12,0,0,0
202223,NA1E09200C,SCUOLA PRIMARIA,2,18,18,0,0,0
202223,MITF105003,SCUOLA SECONDARIA II GRADO,4,26,23,3,0,3
202223,MO1E00900B,SCUOLA PRIMARIA,1,27,26,1,0,1
202223,MO1M006005,SCUOLA SECONDARIA I GRADO,3,100,97,3,0,3
202223,NA1E15900N,SCUOLA PRIMARIA,1,18,18,0,0,0
202223,MB1E058008,SCUOLA PRIMARIA,2,28,28,0,0,0
202223,VR1E004003,SCUOLA PRIMARIA,5,19,19,0,0,0
202223,BO1EL9500N,SCUOLA PRIMARIA,1,18,18,0,0,0
202223,VI1E01100T,SCUOLA PRIMARIA,4,11,8,3,2,1
202223,MEPS435000,SCUOLA SECONDARIA II GRADO,3,5,5,0,0,0
202223,SV1E00200P,SCUOLA PRIMARIA,5,19,19,0,0,0
202223,MIPL08500Q,SCUOLA SECONDARIA II GRADO,2,16,15,1,0,1
202223,FIPMRR500G,SCUOLA SECONDARIA II GRADO,2,17,16,1,0,1
202223,RMRF00500V,SCUOLA SECONDARIA II GRADO,5,60,57,3,2,1
202223,PCPM79500U,SCUOLA SECONDARIA II GRADO,5,26,26,0,0,0
202223,MBTD37500N,SCUOLA SECONDARIA II GRADO,2,13,12,1,0,1
202223,RMPC05500E,SCUOLA SECONDARIA II GRADO,3,12,12,0,0,0
202223,MI1E047001,SCUOLA PRIMARIA,5,63,63,0,0,0
202223,MI1E132004,SCUOLA PRIMARIA,5,21,20,1,1,0
202223,NAPSP25001,SCUOLA SECONDARIA II GRADO,4,3,3,0,0,0
202223,PE1E003004,SCUOLA PRIMARIA,2,9,9,0,0,0
202223,CE1E045001,SCUOLA PRIMARIA,2,14,14,0,0,0
202223,NAPM05500Q,SCUOLA SECONDARIA II GRADO,5,26,25,1,0,1
202223,RGRHL4500A,SCUOLA SECONDARIA II GRADO,4,17,16,1,0,1
202223,CZ1E45500Q,SCUOLA PRIMARIA,1,10,9,1,0,1
202223,MITF005006,SCUOLA SECONDARIA II GRADO,4,65,58,7,1,6
202223,VATFMQ5008,SCUOLA SECONDARIA II GRADO,2,3,3,0,0,0
202223,BGTD085006,SCUOLA SECONDARIA II GRADO,4,31,31,0,0,0
202223,NA1E14400X,SCUOLA PRIMARIA,3,11,11,0,0,0
202223,VT1E002002,SCUOLA PRIMARIA,3,23,22,1,0,1
202223,UD1E00600B,SCUOLA PRIMARIA,5,13,12,1,1,0
202223,CT1E00100D,SCUOLA PRIMARIA,2,18,18,0,0,0
202223,MBPC27500T,SCUOLA SECONDARIA II GRADO,5,24,24,0,0,0
202223,NARHZ8500V,SCUOLA SECONDARIA II GRADO,2,15,15,0,0,0
202223,NATD355005,SCUOLA SECONDARIA II GRADO,5,70,68,2,0,2
202223,NA1E07000G,SCUOLA PRIMARIA,4,29,27,2,0,2
202223,SR1E005001,SCUOLA PRIMARIA,4,16,15,1,0,1
202223,LE1E005002,SCUOLA PRIMARIA,2,18,16,2,0,2
202223,AN1E001009,SCUOLA PRIMARIA,2,5,5,0,0,0
202223,MIRIB1500S,SCUOLA SECONDARIA II GRADO,1,17,14,3,0,3
202223,PS1E00500V,SCUOLA PRIMARIA,2,22,20,2,1,1
202223,NARHZ5500Q,SCUOLA SECONDARIA II GRADO,4,6,6,0,0,0
202223,MB1E02800C,SCUOLA PRIMARIA,2,51,51,0,0,0
202223,CTPS075008,SCUOLA SECONDARIA II GRADO,2,29,29,0,0,0
202223,OR1E00100R,SCUOLA PRIMARIA,3,17,17,0,0,0
202223,MI1E06500E,SCUOLA PRIMARIA,3,29,29,0,0,0
202223,RM1E03900E,SCUOLA PRIMARIA,5,20,18,2,1,1
202223,PO1E00200R,SCUOLA PRIMARIA,5,22,20,2,0,2
202223,FI1E034008,SCUOLA PRIMARIA,2,34,33,1,0,1
202223,ALPLVD500U,SCUOLA SECONDARIA II GRADO,4,7,7,0,0,0
202223,SI1M00200A,SCUOLA SECONDARIA I GRADO,2,21,20,1,1,0
202223,NARH4C5006,SCUOLA SECONDARIA II GRADO,2,8,8,0,0,0
202223,CTPC01500D,SCUOLA SECONDARIA II GRADO,5,8,8,0,0,0
202223,NA1E02000E,SCUOLA PRIMARIA,5,21,21,0,0,0
202223,BG1M01800G,SCUOLA SECONDARIA I GRADO,2,67,65,2,1,1
202223,VR1M026005,SCUOLA SECONDARIA I GRADO,1,55,51,4,0,4
202223,TV1MRF500I,SCUOLA SECONDARIA I GRADO,3,22,22,0,0,0
202223,NA1E239009,SCUOLA PRIMARIA,1,7,7,0,0,0
202223,NA1E25400B,SCUOLA PRIMARIA,4,15,15,0,0,0
202223,RM1E12900R,SCUOLA PRIMARIA,5,25,24,1,1,0
202223,BGTFF0500O,SCUOLA SECONDARIA II GRADO,5,24,22,2,1,1
202223,CO1E00300B,SCUOLA PRIMARIA,1,50,49,1,1,0
202223,VAPSZC500T,SCUOLA SECONDARIA II GRADO,2,27,26,1,1,0
202223,BNRHZS500C,SCUOLA SECONDARIA II GRADO,1,4,4,0,0,0
202223,RMPC10500A,SCUOLA SECONDARIA II GRADO,4,25,25,0,0,0
202223,BA1E014002,SCUOLA PRIMARIA,4,17,17,0,0,0
202223,CRPLAB5007,SCUOLA SECONDARIA II GRADO,1,20,20,0,0,0
202223,NO1E001004,SCUOLA PRIMARIA,4,15,13,2,1,1
202223,RM1E02400R,SCUOLA PRIMARIA,2,45,42,3,0,3
202223,AGTD00500C,SCUOLA SECONDARIA II GRADO,2,3,2,1,1,0
202223,MB1E07200E,SCUOLA PRIMARIA,2,17,17,0,0,0
202223,PSPC01500G,SCUOLA SECONDARIA II GRADO,1,10,10,0,0,0
202223,PETF005003,SCUOLA SECONDARIA II GRADO,4,4,3,1,0,1
202223,SA1E02200L,SCUOLA PRIMARIA,1,12,12,0,0,0
202223,TA1E009007,SCUOLA PRIMARIA,5,6,6,0,0,0
202223,MITD13500L,SCUOLA SECONDARIA II GRADO,1,27,27,0,0,0
202223,TVPS02500N,SCUOLA SECONDARIA II GRADO,1,18,18,0,0,0
202223,SRTD08500V,SCUOLA SECONDARIA II GRADO,3,5,4,1,0,1
202223,MI1MT3500U,SCUOLA SECONDARIA I GRADO,2,56,55,1,0,1
202223,RARI015004,SCUOLA SECONDARIA II GRADO,4,9,6,3,2,1
202223,CZ1MBR5002,SCUOLA SECONDARIA I GRADO,2,4,4,0,0,0
202223,NA1E10900L,SCUOLA PRIMARIA,1,11,10,1,0,1
202223,MI1E09300P,SCUOLA PRIMARIA,2,18,14,4,1,3
202223,NA1E12300V,SCUOLA PRIMARIA,2,31,31,0,0,0
202223,NAPS4U500S,SCUOLA SECONDARIA II GRADO,5,13,13,0,0,0
202223,MI1E02600X,SCUOLA PRIMARIA,4,27,26,1,0,1
202223,MI1E033003,SCUOLA PRIMARIA,1,23,23,0,0,0
202223,NATL175003,SCUOLA SECONDARIA II GRADO,4,6,6,0,0,0
202223,NATHE15007,SCUOLA SECONDARIA II GRADO,2,11,11,0,0,0
202223,RMPS335003,SCUOLA SECONDARIA II GRADO,1,28,27,1,1,0
202223,CSPMMV500S,SCUOLA SECONDARIA II GRADO,1,12,12,0,0,0
202223,VR1E00500V,SCUOLA PRIMARIA,5,24,24,0,0,0
202223,PE1M00100N,SCUOLA SECONDARIA I GRADO,3,20,18,2,2,0
202223,CTTDG7500Z,SCUOLA SECONDARIA II GRADO,4,1,1,0,0,0
202223,CETF1M500C,SCUOLA SECONDARIA II GRADO,4,8,8,0,0,0
202223,MISL075007,SCUOLA SECONDARIA II GRADO,4,51,51,0,0,0
202223,SS1E01300B,SCUOLA PRIMARIA,2,15,15,0,0,0
202223,VAPLDB5003,SCUOLA SECONDARIA II GRADO,3,14,13,1,0,1
202223,RMPL48500Q,SCUOLA SECONDARIA II GRADO,4,13,12,1,1,0
202223,MI1E089003,SCUOLA PRIMARIA,1,6,5,1,0,1
202223,VRPS005004,SCUOLA SECONDARIA II GRADO,4,29,28,1,1,0
202223,PA1E02300V,SCUOLA PRIMARIA,4,10,10,0,0,0
202223,MIPSQ55000,SCUOLA SECONDARIA II GRADO,1,29,28,1,0,1
202223,NATL0L500Q,SCUOLA SECONDARIA II GRADO,3,4,4,0,0,0
202223,MS1EO3500D,SCUOLA PRIMARIA,4,8,8,0,0,0
202223,TATD055002,SCUOLA SECONDARIA II GRADO,3,4,4,0,0,0
202223,LC1M070005,SCUOLA SECONDARIA I GRADO,1,50,49,1,1,0
202223,AL1E004006,SCUOLA PRIMARIA,3,24,24,0,0,0
202223,FR1E00400R,SCUOLA PRIMARIA,1,21,21,0,0,0
202223,RMPCQ1500T,SCUOLA SECONDARIA II GRADO,2,7,5,2,2,0
202223,PO1EHR500Z,SCUOLA PRIMARIA,2,7,1,6,0,6
202223,SATL00500A,SCUOLA SECONDARIA II GRADO,5,32,32,0,0,0
202223,CE1E002003,SCUOLA PRIMARIA,1,26,25,1,0,1
202223,AQ1M00200G,SCUOLA SECONDARIA I GRADO,3,19,19,0,0,0
202223,PA1E01500X,SCUOLA PRIMARIA,4,18,17,1,0,1
202223,RMSLVB5007,SCUOLA SECONDARIA II GRADO,4,12,10,2,2,0
202223,PI1E00200G,SCUOLA PRIMARIA,2,23,23,0,0,0
202223,VETFO1500N,SCUOLA SECONDARIA II GRADO,1,5,5,0,0,0
202223,TO1E033003,SCUOLA PRIMARIA,3,50,46,4,4,0
202223,SP1E003004,SCUOLA PRIMARIA,2,26,25,1,0,1
202223,AL1E00100P,SCUOLA PRIMARIA,2,59,58,1,0,1
202223,BOPS05500C,SCUOLA SECONDARIA II GRADO,2,23,22,1,0,1
202223,CERIOH500S,SCUOLA SECONDARIA II GRADO,3,7,7,0,0,0
202223,RM1ES55005,SCUOLA PRIMARIA,3,21,19,2,1,1
202223,LC1E009004,SCUOLA PRIMARIA,2,39,38,1,0,1
202223,BG1M02700A,SCUOLA SECONDARIA I GRADO,2,41,40,1,1,0
202223,CTRCQ5500S,SCUOLA SECONDARIA II GRADO,4,3,3,0,0,0
202223,RMPM9P500H,SCUOLA SECONDARIA II GRADO,2,3,3,0,0,0
202223,NA1E26500T,SCUOLA PRIMARIA,2,10,8,2,0,2
202223,FIPS15500B,SCUOLA SECONDARIA II GRADO,3,13,10,3,0,3
202223,AQ1E004002,SCUOLA PRIMARIA,4,16,15,1,0,1
202223,RA1M00300L,SCUOLA SECONDARIA I GRADO,1,16,16,0,0,0
202223,RMPSE55000,SCUOLA SECONDARIA II GRADO,2,29,29,0,0,0
202223,ME1M004001,SCUOLA SECONDARIA I GRADO,2,25,25,0,0,0
202223,IM1M010009,SCUOLA SECONDARIA I GRADO,3,15,15,0,0,0
202223,PA1M008002,SCUOLA SECONDARIA I GRADO,2,38,38,0,0,0
202223,TVPM8T500U,SCUOLA SECONDARIA II GRADO,1,17,17,0,0,0
202223,COPSIS500Q,SCUOLA SECONDARIA II GRADO,2,26,25,1,0,1
202223,NATDQN500O,SCUOLA SECONDARIA II GRADO,1,2,2,0,0,0
202223,TO1M055005,SCUOLA SECONDARIA I GRADO,3,16,15,1,1,0
202223,FG1E010003,SCUOLA PRIMARIA,4,22,21,1,0,1
202223,BG1EL2500G,SCUOLA PRIMARIA,4,3,3,0,0,0
202223,MITF035002,SCUOLA SECONDARIA II GRADO,4,26,25,1,0,1
202223,PV1M00200A,SCUOLA SECONDARIA I GRADO,2,28,28,0,0,0
202223,CL1E00400X,SCUOLA PRIMARIA,5,17,16,1,0,1
202223,ANTD02500V,SCUOLA SECONDARIA II GRADO,5,10,9,1,1,0
202223,RA1E00600V,SCUOLA PRIMARIA,1,30,29,1,0,1
202223,NA1E08400D,SCUOLA PRIMARIA,5,48,48,0,0,0
202223,FRPSII500H,SCUOLA SECONDARIA II GRADO,5,8,8,0,0,0
202223,VIPS01500A,SCUOLA SECONDARIA II GRADO,1,8,8,0,0,0
202223,BGPSH85002,SCUOLA SECONDARIA II GRADO,1,28,28,0,0,0
202223,CETD115003,SCUOLA SECONDARIA II GRADO,4,4,4,0,0,0
202223,BSPSS1500O,SCUOLA SECONDARIA II GRADO,1,30,30,0,0,0
202223,TO1E6M500I,SCUOLA PRIMARIA,4,23,21,2,1,1
202223,GE1M006006,SCUOLA SECONDARIA I GRADO,2,27,27,0,0,0
202223,SATFHG5004,SCUOLA SECONDARIA II GRADO,2,9,9,0,0,0
202223,PA1E00300N,SCUOLA PRIMARIA,5,17,16,1,0,1
202223,MIPS43500B,SCUOLA SECONDARIA II GRADO,3,30,30,0,0,0
202223,RMPS285007,SCUOLA SECONDARIA II GRADO,1,5,5,0,0,0
202223,MI1E011006,SCUOLA PRIMARIA,4,15,14,1,0,1
202223,TV1M01000X,SCUOLA SECONDARIA I GRADO,2,40,39,1,1,0
202223,RMPL135004,SCUOLA SECONDARIA II GRADO,4,21,20,1,1,0
202223,PAPMUP500I,SCUOLA SECONDARIA II GRADO,1,9,9,0,0,0
202223,MIPS06500Q,SCUOLA SECONDARIA II GRADO,3,22,20,2,0,2
202223,FRTDEU500U,SCUOLA SECONDARIA II GRADO,5,42,39,3,0,3
202223,VAPL10500N,SCUOLA SECONDARIA II GRADO,2,3,3,0,0,0
202223,LUPL01500A,SCUOLA SECONDARIA II GRADO,1,7,7,0,0,0
202223,NA1M040001,SCUOLA SECONDARIA I GRADO,1,10,10,0,0,0
202223,BSPS6Z5004,SCUOLA SECONDARIA II GRADO,3,18,17,1,0,1
202223,CTPM345004,SCUOLA SECONDARIA II GRADO,2,15,15,0,0,0
202223,FI1E00800Q,SCUOLA PRIMARIA,1,19,9,10,2,8
202223,SATFNZ5007,SCUOLA SECONDARIA II GRADO,5,63,58,5,2,3
202223,CE1E015005,SCUOLA PRIMARIA,4,15,13,2,1,1
202223,VAPSQF500T,SCUOLA SECONDARIA II GRADO,1,19,19,0,0,0
202223,AT1E00300B,SCUOLA PRIMARIA,2,15,15,0,0,0
202223,MB1M02200P,SCUOLA SECONDARIA I GRADO,1,49,46,3,0,3
202223,MNPL02500L,SCUOLA SECONDARIA II GRADO,3,8,8,0,0,0
202223,BG1E00400C,SCUOLA PRIMARIA,2,29,28,1,0,1
202223,TPTDS9500A,SCUOLA SECONDARIA II GRADO,2,2,2,0,0,0
202223,RM1E17400P,SCUOLA PRIMARIA,4,10,9,1,1,0
202223,VEPS00500C,SCUOLA SECONDARIA II GRADO,3,25,25,0,0,0
202223,RE1E00400N,SCUOLA PRIMARIA,1,26,26,0,0,0
202223,CSRFQA500F,SCUOLA SECONDARIA II GRADO,1,4,4,0,0,0
202223,GE1E02500A,SCUOLA PRIMARIA,4,18,17,1,0,1
202223,MIPQ01500X,SCUOLA SECONDARIA II GRADO,1,20,19,1,0,1
202223,SA1E01500D,SCUOLA PRIMARIA,1,15,15,0,0,0
202223,MIPS085001,SCUOLA SECONDARIA II GRADO,2,50,50,0,0,0
202223,SATDGN500Z,SCUOLA SECONDARIA II GRADO,3,16,16,0,0,0
202223,LTPSU65008,SCUOLA SECONDARIA II GRADO,2,2,2,0,0,0
202223,RM1E21000L,SCUOLA PRIMARIA,3,24,24,0,0,0
202223,SI1E002005,SCUOLA PRIMARIA,2,16,15,1,0,1
202223,AVTD075001,SCUOLA SECONDARIA II GRADO,4,7,7,0,0,0
202223,RMPMIO5006,SCUOLA SECONDARIA II GRADO,4,11,11,0,0,0
202223,MIPC125003,SCUOLA SECONDARIA II GRADO,4,9,9,0,0,0
202223,TOPC10500T,SCUOLA SECONDARIA II GRADO,3,13,13,0,0,0
202223,FIPS035009,SCUOLA SECONDARIA II GRADO,1,6,6,0,0,0
202223,RMPLLD5008,SCUOLA SECONDARIA II GRADO,4,17,16,1,1,0
202223,VARFIU5007,SCUOLA SECONDARIA II GRADO,2,16,15,1,0,1
202223,VAPSQ4500H,SCUOLA SECONDARIA II GRADO,2,18,17,1,0,1
202223,CA1E00800G,SCUOLA PRIMARIA,5,50,50,0,0,0
202223,RM1E023001,SCUOLA PRIMARIA,3,46,44,2,0,2
202223,VIPS3I500B,SCUOLA SECONDARIA II GRADO,3,39,37,2,0,2
202223,CTTD315003,SCUOLA SECONDARIA II GRADO,3,6,6,0,0,0
202223,BO1M01200E,SCUOLA SECONDARIA I GRADO,2,177,175,2,0,2
202223,CTTL07500E,SCUOLA SECONDARIA II GRADO,1,9,9,0,0,0
202223,CE1E030007,SCUOLA PRIMARIA,1,18,18,0,0,0
202223,MITD5V500H,SCUOLA SECONDARIA II GRADO,2,32,31,1,0,1
202223,SATD30500E,SCUOLA SECONDARIA II GRADO,1,2,1,1,0,1
202223,PAPM9C5005,SCUOLA SECONDARIA II GRADO,3,31,30,1,0,1
202223,AVTDMI500Z,SCUOLA SECONDARIA II GRADO,5,56,56,0,0,0
202223,AVTD045005,SCUOLA SECONDARIA II GRADO,1,5,5,0,0,0
202223,CZ1E45500Q,SCUOLA PRIMARIA,3,14,14,0,0,0
202223,TOPMP2500E,SCUOLA SECONDARIA II GRADO,5,13,13,0,0,0
202223,NA1E114004,SCUOLA PRIMARIA,3,10,10,0,0,0
202223,BG1E021006,SCUOLA PRIMARIA,2,30,27,3,0,3
202223,VRPC04500B,SCUOLA SECONDARIA II GRADO,5,26,26,0,0,0
202223,NAPS7Q5000,SCUOLA SECONDARIA II GRADO,5,22,21,1,0,1
202223,GERI015006,SCUOLA SECONDARIA II GRADO,5,48,47,1,0,1
202223,SATF1Z500T,SCUOLA SECONDARIA II GRADO,4,6,6,0,0,0
202223,RM1M03400L,SCUOLA SECONDARIA I GRADO,3,38,36,2,0,2
202223,CR1E00700T,SCUOLA PRIMARIA,4,24,23,1,0,1
202223,RM1E163008,SCUOLA PRIMARIA,4,15,15,0,0,0
202223,MI1E14300E,SCUOLA PRIMARIA,5,10,6,4,1,3
202223,SARF6Q5004,SCUOLA SECONDARIA II GRADO,4,2,2,0,0,0
202223,SAPSNV500C,SCUOLA SECONDARIA II GRADO,5,69,66,3,1,2
202223,FR1E00500L,SCUOLA PRIMARIA,1,13,13,0,0,0
202223,CE1E02700B,SCUOLA PRIMARIA,5,18,16,2,0,2
202223,NATF6F5005,SCUOLA SECONDARIA II GRADO,2,9,9,0,0,0
202223,TVTF015005,SCUOLA SECONDARIA II GRADO,5,19,19,0,0,0
202223,VRPM055006,SCUOLA SECONDARIA II GRADO,5,46,46,0,0,0
202223,NAPS5P500P,SCUOLA SECONDARIA II GRADO,3,4,4,0,0,0
202223,NA1E214001,SCUOLA PRIMARIA,4,15,8,7,1,6
202223,TVRA3C5009,SCUOLA SECONDARIA II GRADO,5,24,24,0,0,0
202223,BS1E017003,SCUOLA PRIMARIA,5,60,59,1,1,0
202223,NATD0C5008,SCUOLA SECONDARIA II GRADO,1,5,5,0,0,0
202223,TV1E00900E,SCUOLA PRIMARIA,3,19,19,0,0,0
202223,VTPM7D500R,SCUOLA SECONDARIA II GRADO,5,9,9,0,0,0
202223,LTTD595008,SCUOLA SECONDARIA II GRADO,3,17,17,0,0,0
202223,NA1ED8500Q,SCUOLA PRIMARIA,2,6,6,0,0,0
202223,CT1M011009,SCUOLA SECONDARIA I GRADO,3,9,8,1,1,0
202223,VE1E01000P,SCUOLA PRIMARIA,2,24,24,0,0,0
202223,BGPC02500G,SCUOLA SECONDARIA II GRADO,3,15,15,0,0,0
202223,NA1E04800A,SCUOLA PRIMARIA,4,32,32,0,0,0
202223,BGPMIZ500F,SCUOLA SECONDARIA II GRADO,3,10,8,2,2,0
202223,VR1EEF5000,SCUOLA PRIMARIA,1,58,55,3,1,2
202223,CE1E00900T,SCUOLA PRIMARIA,3,17,15,2,0,2
202223,RMPL39500D,SCUOLA SECONDARIA II GRADO,1,21,20,1,0,1
202223,RM1M11200L,SCUOLA SECONDARIA I GRADO,2,7,6,1,1,0
202223,LE1MO05005,SCUOLA SECONDARIA I GRADO,3,11,9,2,0,2
202223,SATD075006,SCUOLA SECONDARIA II GRADO,3,21,20,1,1,0
202223,RM1E04600N,SCUOLA PRIMARIA,3,21,20,1,0,1
202223,RMPS44500E,SCUOLA SECONDARIA II GRADO,4,24,24,0,0,0
202223,TO1E03500P,SCUOLA PRIMARIA,4,85,83,2,2,0
202223,RM1E08400C,SCUOLA PRIMARIA,5,51,50,1,0,1
202223,PV1E003001,SCUOLA PRIMARIA,2,46,44,2,1,1
202223,RNTD02500G,SCUOLA SECONDARIA II GRADO,3,13,10,3,0,3
202223,NA1E029001,SCUOLA PRIMARIA,2,14,14,0,0,0
202223,PD1M007002,SCUOLA SECONDARIA I GRADO,2,28,26,2,0,2
202223,BG1MT0500I,SCUOLA SECONDARIA I GRADO,1,22,22,0,0,0
202223,RMPM4G5004,SCUOLA SECONDARIA II GRADO,4,13,13,0,0,0
202223,NA1E355008,SCUOLA PRIMARIA,4,20,20,0,0,0
202223,MIPM01500Q,SCUOLA SECONDARIA II GRADO,1,25,24,1,0,1
202223,NA1E09000R,SCUOLA PRIMARIA,2,23,23,0,0,0
202223,MI1M08000T,SCUOLA SECONDARIA I GRADO,3,132,129,3,1,2
202223,CAPC005006,SCUOLA SECONDARIA II GRADO,5,5,5,0,0,0
202223,TORI46500C,SCUOLA SECONDARIA II GRADO,3,3,3,0,0,0
202223,RN1E005009,SCUOLA PRIMARIA,1,39,39,0,0,0
202223,MB1E06900P,SCUOLA PRIMARIA,3,47,45,2,1,1
202223,BO1M00200X,SCUOLA SECONDARIA I GRADO,1,49,49,0,0,0
202223,TO1E03700A,SCUOLA PRIMARIA,5,51,49,2,1,1
202223,PETD03500L,SCUOLA SECONDARIA II GRADO,5,20,16,4,0,4
202223,BGSD01500E,SCUOLA SECONDARIA II GRADO,1,68,64,4,2,2
202223,MEPCPD5001,SCUOLA SECONDARIA II GRADO,4,4,4,0,0,0
202223,CZ1E45500Q,SCUOLA PRIMARIA,2,11,11,0,0,0
202223,BG1M008001,SCUOLA SECONDARIA I GRADO,2,26,26,0,0,0
202223,RMPC255008,SCUOLA SECONDARIA II GRADO,3,15,15,0,0,0
202223,CORC43500S,SCUOLA SECONDARIA II GRADO,1,12,12,0,0,0
202223,RM1E156005,SCUOLA PRIMARIA,1,9,6,3,0,3
202223,CT1E00100D,SCUOLA PRIMARIA,3,22,22,0,0,0
202223,CE1ELC500C,SCUOLA PRIMARIA,1,27,27,0,0,0
202223,RMPC19500T,SCUOLA SECONDARIA II GRADO,4,28,28,0,0,0
202223,TATF035003,SCUOLA SECONDARIA II GRADO,3,26,24,2,1,1
202223,NATNCE5004,SCUOLA SECONDARIA II GRADO,4,4,4,0,0,0
202223,CA1E013003,SCUOLA PRIMARIA,1,23,23,0,0,0
202223,NA1E17300X,SCUOLA PRIMARIA,1,10,10,0,0,0
202223,PDRHMH500P,SCUOLA SECONDARIA II GRADO,2,10,10,0,0,0
202223,CE1E043009,SCUOLA PRIMARIA,2,15,15,0,0,0
202223,MCTFBF5005,SCUOLA SECONDARIA II GRADO,1,3,2,1,0,1
202223,BGPSRR5006,SCUOLA SECONDARIA II GRADO,3,29,29,0,0,0
202223,VA1M005002,SCUOLA SECONDARIA I GRADO,1,24,23,1,0,1
202223,BS1E025002,SCUOLA PRIMARIA,3,12,10,2,0,2
202223,VBPM03500D,SCUOLA SECONDARIA II GRADO,2,9,9,0,0,0
202223,TVPS05500D,SCUOLA SECONDARIA II GRADO,2,9,9,0,0,0
202223,UDPS01500B,SCUOLA SECONDARIA II GRADO,3,18,18,0,0,0
202223,CSTD03500E,SCUOLA SECONDARIA II GRADO,5,13,12,1,0,1
202223,NAPMVM500H,SCUOLA SECONDARIA II GRADO,2,4,4,0,0,0
202223,MIPSDF5000,SCUOLA SECONDARIA II GRADO,3,53,53,0,0,0
202223,RMRHRE5002,SCUOLA SECONDARIA II GRADO,5,25,22,3,1,2
202223,TETD00500B,SCUOLA SECONDARIA II GRADO,5,12,10,2,1,1
202223,MI1E01400N,SCUOLA PRIMARIA,3,30,29,1,0,1
202223,LCTB00500V,SCUOLA SECONDARIA II GRADO,4,7,6,1,0,1
202223,RG1E00600X,SCUOLA PRIMARIA,2,19,17,2,0,2
202223,VR1E003007,SCUOLA PRIMARIA,4,14,12,2,0,2
202223,TO1E01900R,SCUOLA PRIMARIA,2,29,29,0,0,0
202223,RM1E064007,SCUOLA PRIMARIA,3,21,21,0,0,0
202223,CERHP55001,SCUOLA SECONDARIA II GRADO,5,103,97,6,5,1
202223,POPS00500D,SCUOLA SECONDARIA II GRADO,1,48,31,17,0,17
202223,BG1M01800G,SCUOLA SECONDARIA I GRADO,3,63,62,1,0,1
202223,SATNTR5000,SCUOLA SECONDARIA II GRADO,3,1,1,0,0,0
202223,GE1E034005,SCUOLA PRIMARIA,4,15,14,1,0,1
202223,UDPSBD500N,SCUOLA SECONDARIA II GRADO,4,29,27,2,1,1
202223,CSTF6C500B,SCUOLA SECONDARIA II GRADO,5,22,21,1,0,1
202223,RMSL3E5005,SCUOLA SECONDARIA II GRADO,4,7,5,2,0,2
202223,PN1M002009,SCUOLA SECONDARIA I GRADO,2,115,112,3,3,0
202223,MI1E01000A,SCUOLA PRIMARIA,4,52,51,1,0,1
202223,RE1E008001,SCUOLA PRIMARIA,3,42,42,0,0,0
202223,VA1E01500B,SCUOLA PRIMARIA,1,41,40,1,0,1
202223,VA1E01200X,SCUOLA PRIMARIA,5,46,44,2,0,2
202223,RM1M016003,SCUOLA SECONDARIA I GRADO,3,15,15,0,0,0
202223,RM1E206001,SCUOLA PRIMARIA,1,24,23,1,1,0
202223,CO1M019006,SCUOLA SECONDARIA I GRADO,2,34,33,1,0,1
202223,NA1E25900E,SCUOLA PRIMARIA,1,10,10,0,0,0
202223,CATF955004,SCUOLA SECONDARIA II GRADO,1,6,6,0,0,0
202223,FE1MFE500C,SCUOLA SECONDARIA I GRADO,2,47,47,0,0,0
202223,MBRFZ6500C,SCUOLA SECONDARIA II GRADO,4,15,15,0,0,0
202223,NATD9F500E,SCUOLA SECONDARIA II GRADO,5,54,51,3,0,3
202223,RMTD78500B,SCUOLA SECONDARIA II GRADO,1,1,0,1,1,0
202223,MITL485005,SCUOLA SECONDARIA II GRADO,2,21,16,5,0,5
202223,LO1E00500E,SCUOLA PRIMARIA,4,41,39,2,0,2
202223,RA1E00100Q,SCUOLA PRIMARIA,1,18,16,2,1,1
202223,RMPSCH500E,SCUOLA SECONDARIA II GRADO,2,20,20,0,0,0
202223,TO1E054004,SCUOLA PRIMARIA,2,13,13,0,0,0
202223,RM1E10300L,SCUOLA PRIMARIA,2,40,39,1,1,0
202223,RM1M00600C,SCUOLA SECONDARIA I GRADO,2,50,50,0,0,0
202223,METFU8500R,SCUOLA SECONDARIA II GRADO,5,32,32,0,0,0
202223,LC1E003005,SCUOLA PRIMARIA,2,35,33,2,1,1
202223,FE1E00100N,SCUOLA PRIMARIA,1,29,18,11,4,7
202223,NATDAT500E,SCUOLA SECONDARIA II GRADO,3,7,7,0,0,0
202223,MOPSMO5004,SCUOLA SECONDARIA II GRADO,4,6,6,0,0,0
202223,CHPMVZ5007,SCUOLA SECONDARIA II GRADO,5,27,26,1,0,1
202223,AP1E006003,SCUOLA PRIMARIA,5,19,18,1,1,0
202223,TV1E00100X,SCUOLA PRIMARIA,5,25,25,0,0,0
202223,RM1E05400L,SCUOLA PRIMARIA,4,30,29,1,1,0
202223,VE1E00700V,SCUOLA PRIMARIA,4,12,6,6,1,5
202223,BSPS125004,SCUOLA SECONDARIA II GRADO,5,11,11,0,0,0
202223,BS1EU3500Q,SCUOLA PRIMARIA,4,27,24,3,0,3
202223,VATF295009,SCUOLA SECONDARIA II GRADO,2,26,26,0,0,0
202223,RM1E16100L,SCUOLA PRIMARIA,1,18,16,2,0,2
202223,VRPS3P500M,SCUOLA SECONDARIA II GRADO,4,20,19,1,0,1
202223,AR1E001005,SCUOLA PRIMARIA,1,14,14,0,0,0
202223,RMTD355004,SCUOLA SECONDARIA II GRADO,2,8,8,0,0,0
202223,MB1EVP500T,SCUOLA PRIMARIA,2,16,16,0,0,0
202223,MIPSIG500R,SCUOLA SECONDARIA II GRADO,4,50,50,0,0,0
202223,PVTL025009,SCUOLA SECONDARIA II GRADO,3,11,8,3,0,3
202223,MI1M083009,SCUOLA SECONDARIA I GRADO,2,33,31,2,0,2
202223,VETF015005,SCUOLA SECONDARIA II GRADO,5,75,75,0,0,0
202223,MI1EGH5005,SCUOLA PRIMARIA,2,25,25,0,0,0
202223,NAPC095002,SCUOLA SECONDARIA II GRADO,1,19,19,0,0,0
202223,TV1E006003,SCUOLA PRIMARIA,5,11,11,0,0,0
202223,RMPL0L500V,SCUOLA SECONDARIA II GRADO,2,12,12,0,0,0
202223,FR1M003006,SCUOLA SECONDARIA I GRADO,3,10,10,0,0,0
202223,RGTD04500G,SCUOLA SECONDARIA II GRADO,4,3,3,0,0,0
202223,NARH065003,SCUOLA SECONDARIA II GRADO,2,8,8,0,0,0
202223,NARHRH500P,SCUOLA SECONDARIA II GRADO,3,12,12,0,0,0
202223,POPS00500D,SCUOLA SECONDARIA II GRADO,2,20,15,5,0,5
202223,BSPS08500V,SCUOLA SECONDARIA II GRADO,1,30,28,2,0,2
202223,AQ1E00100E,SCUOLA PRIMARIA,4,24,23,1,1,0
202223,NA1E11000R,SCUOLA PRIMARIA,2,16,15,1,0,1
202223,NA1E22500B,SCUOLA PRIMARIA,5,19,19,0,0,0
202223,RMTB035009,SCUOLA SECONDARIA II GRADO,1,32,29,3,1,2
202223,NATD21500T,SCUOLA SECONDARIA II GRADO,3,7,7,0,0,0
202223,VEPS04500V,SCUOLA SECONDARIA II GRADO,2,25,23,2,1,1
202223,RM1E03900E,SCUOLA PRIMARIA,1,25,25,0,0,0
202223,FI1M010001,SCUOLA SECONDARIA I GRADO,1,26,18,8,0,8
202223,AGTD4U500B,SCUOLA SECONDARIA II GRADO,4,5,5,0,0,0
202223,BO1E01700C,SCUOLA PRIMARIA,4,52,51,1,0,1
202223,FO1M00600E,SCUOLA SECONDARIA I GRADO,1,65,62,3,0,3
202223,BOPL57500R,SCUOLA SECONDARIA II GRADO,5,39,38,1,0,1
202223,NA1E20200P,SCUOLA PRIMARIA,4,15,15,0,0,0
202223,RM1EBQ5007,SCUOLA PRIMARIA,4,13,13,0,0,0
202223,NARHHE500A,SCUOLA SECONDARIA II GRADO,4,9,9,0,0,0
202223,LU1ETH500S,SCUOLA PRIMARIA,1,13,13,0,0,0
202223,RC1E00300L,SCUOLA PRIMARIA,4,17,17,0,0,0
202223,FIPSFU500L,SCUOLA SECONDARIA II GRADO,3,4,4,0,0,0
202223,FG1E015006,SCUOLA PRIMARIA,2,14,14,0,0,0
202223,CERH00500D,SCUOLA SECONDARIA II GRADO,4,9,9,0,0,0
202223,RM1M024002,SCUOLA SECONDARIA I GRADO,2,75,72,3,1,2
202223,RM1M106009,SCUOLA SECONDARIA I GRADO,2,17,13,4,0,4
202223,TOPSQB5003,SCUOLA SECONDARIA II GRADO,3,21,18,3,2,1
202223,MI1M04300V,SCUOLA SECONDARIA I GRADO,3,51,48,3,1,2
202223,SP1E00500Q,SCUOLA PRIMARIA,2,21,18,3,0,3
202223,PERF71500A,SCUOLA SECONDARIA II GRADO,4,1,1,0,0,0
202223,GE1E01400X,SCUOLA PRIMARIA,4,21,21,0,0,0
202223,MIPM0O500U,SCUOLA SECONDARIA II GRADO,2,33,31,2,0,2
202223,SATF02500B,SCUOLA SECONDARIA II GRADO,3,5,5,0,0,0
202223,PA1M01700R,SCUOLA SECONDARIA I GRADO,1,24,24,0,0,0
202223,AVRH015007,SCUOLA SECONDARIA II GRADO,2,6,6,0,0,0
202223,NATDS2500B,SCUOLA SECONDARIA II GRADO,2,10,10,0,0,0
202223,TOPL66500H,SCUOLA SECONDARIA II GRADO,4,27,22,5,1,4
202223,BNTF2A500Q,SCUOLA SECONDARIA II GRADO,5,70,67,3,0,3
202223,BL1E818011,SCUOLA PRIMARIA,1,5,5,0,0,0
202223,RMPSPL500P,SCUOLA SECONDARIA II GRADO,4,12,12,0,0,0
202223,PV1M00200A,SCUOLA SECONDARIA I GRADO,3,15,13,2,0,2
202223,MSPC01500B,SCUOLA SECONDARIA II GRADO,1,17,17,0,0,0
202223,NA1E007004,SCUOLA PRIMARIA,3,17,16,1,1,0
202223,AP1E005007,SCUOLA PRIMARIA,2,18,15,3,1,2
202223,LCPL025002,SCUOLA SECONDARIA II GRADO,2,12,11,1,0,1
202223,MI1M04600A,SCUOLA SECONDARIA I GRADO,3,43,42,1,0,1
202223,TS1E006009,SCUOLA PRIMARIA,3,26,24,2,1,1
202223,CTTF01500P,SCUOLA SECONDARIA II GRADO,2,2,2,0,0,0
202223,AV1ETA500G,SCUOLA PRIMARIA,3,3,2,1,0,1
202223,RM1E10900G,SCUOLA PRIMARIA,5,25,25,0,0,0
202223,NAPS065009,SCUOLA SECONDARIA II GRADO,5,71,69,2,1,1
202223,MIPS4M500V,SCUOLA SECONDARIA II GRADO,2,21,20,1,0,1
202223,RM1M028009,SCUOLA SECONDARIA I GRADO,1,24,24,0,0,0
202223,MI1M09500G,SCUOLA SECONDARIA I GRADO,1,80,79,1,0,1
202223,RMSL02500P,SCUOLA SECONDARIA II GRADO,4,1,1,0,0,0
202223,PVPL02500T,SCUOLA SECONDARIA II GRADO,1,7,5,2,0,2
202223,MI1E13300X,SCUOLA PRIMARIA,5,28,28,0,0,0
202223,MI1E14100V,SCUOLA PRIMARIA,5,48,47,1,0,1
202223,LCRFHO5008,SCUOLA SECONDARIA II GRADO,1,8,3,5,0,5
202223,TV1M00800X,SCUOLA SECONDARIA I GRADO,3,61,58,3,2,1
202223,RMPL0L500V,SCUOLA SECONDARIA II GRADO,1,9,8,1,0,1
202223,CTTD06500D,SCUOLA SECONDARIA II GRADO,3,5,5,0,0,0
202223,TO1M00100R,SCUOLA SECONDARIA I GRADO,2,47,47,0,0,0
202223,PR1E00300Q,SCUOLA PRIMARIA,3,22,21,1,0,1
202223,PRPS015007,SCUOLA SECONDARIA II GRADO,2,8,8,0,0,0
202223,FI1E01000Q,SCUOLA PRIMARIA,3,41,35,6,2,4
202223,RMPM7V500G,SCUOLA SECONDARIA II GRADO,1,27,25,2,1,1
202223,COPCCE5008,SCUOLA SECONDARIA II GRADO,5,26,22,4,0,4
202223,RMPLO35009,SCUOLA SECONDARIA II GRADO,3,10,10,0,0,0
202223,UD1E010003,SCUOLA PRIMARIA,4,18,16,2,1,1
202223,CO1E00100Q,SCUOLA PRIMARIA,5,44,40,4,0,4
202223,ATPL01500N,SCUOLA SECONDARIA II GRADO,1,10,8,2,1,1
202223,MB1M011008,SCUOLA SECONDARIA I GRADO,3,20,18,2,0,2
202223,MI1M089008,SCUOLA SECONDARIA I GRADO,2,10,9,1,0,1
202223,SARIF2500L,SCUOLA SECONDARIA II GRADO,3,3,1,2,0,2
202223,RMPS505001,SCUOLA SECONDARIA II GRADO,5,22,22,0,0,0
202223,CS1E003002,SCUOLA PRIMARIA,5,22,22,0,0,0
202223,NA1E07700A,SCUOLA PRIMARIA,3,12,12,0,0,0
202223,TO1E04400D,SCUOLA PRIMARIA,5,30,29,1,0,1
202223,RMPL1M500I,SCUOLA SECONDARIA II GRADO,3,7,6,1,0,1
202223,PGPC00500C,SCUOLA SECONDARIA II GRADO,2,5,5,0,0,0
202223,PT1E004006,SCUOLA PRIMARIA,3,16,14,2,0,2
202223,ALPS005007,SCUOLA SECONDARIA II GRADO,1,14,11,3,0,3
202223,BOTF2S5000,SCUOLA SECONDARIA II GRADO,3,27,24,3,0,3
202223,MIPS04500E,SCUOLA SECONDARIA II GRADO,3,15,13,2,0,2
202223,VV1E00100R,SCUOLA PRIMARIA,5,24,23,1,0,1
202223,LT1M001006,SCUOLA SECONDARIA I GRADO,3,12,12,0,0,0
202223,AGPSCE5001,SCUOLA SECONDARIA II GRADO,1,2,2,0,0,0
202223,NATD5N500Q,SCUOLA SECONDARIA II GRADO,1,6,6,0,0,0
202223,PA1E005009,SCUOLA PRIMARIA,1,27,27,0,0,0
202223,BAPS035008,SCUOLA SECONDARIA II GRADO,3,4,4,0,0,0
202223,BSSL2A500P,SCUOLA SECONDARIA II GRADO,1,18,18,0,0,0
202223,SA1M0B500F,SCUOLA SECONDARIA I GRADO,2,11,11,0,0,0
202223,LO1E00300V,SCUOLA PRIMARIA,3,25,24,1,0,1
202223,RMPS46500Q,SCUOLA SECONDARIA II GRADO,5,26,26,0,0,0
202223,TO1E040006,SCUOLA PRIMARIA,4,48,47,1,0,1
202223,NA1E01100Q,SCUOLA PRIMARIA,4,10,9,1,0,1
202223,PTPM02500D,SCUOLA SECONDARIA II GRADO,5,35,32,3,1,2
202223,FIPCI25001,SCUOLA SECONDARIA II GRADO,4,20,20,0,0,0
202223,SATD295005,SCUOLA SECONDARIA II GRADO,1,8,8,0,0,0
202223,BSPC01500D,SCUOLA SECONDARIA II GRADO,1,18,17,1,1,0
202223,NA1E02500N,SCUOLA PRIMARIA,4,39,39,0,0,0
202223,COTAV75005,SCUOLA SECONDARIA II GRADO,4,20,20,0,0,0
202223,CO1E01100A,SCUOLA PRIMARIA,5,23,22,1,0,1
202223,RM1E148006,SCUOLA PRIMARIA,2,38,35,3,1,2
202223,RM1E13300C,SCUOLA PRIMARIA,1,14,14,0,0,0
202223,GEPS04500R,SCUOLA SECONDARIA II GRADO,3,26,26,0,0,0
202223,RM1MZQ500O,SCUOLA SECONDARIA I GRADO,1,24,23,1,1,0
202223,CR1E00200P,SCUOLA PRIMARIA,1,14,14,0,0,0
202223,MS1E00100B,SCUOLA PRIMARIA,4,15,15,0,0,0
202223,TVPSIL5006,SCUOLA SECONDARIA II GRADO,1,11,11,0,0,0
202223,SARFRL5003,SCUOLA SECONDARIA II GRADO,4,12,12,0,0,0
202223,RN1E007001,SCUOLA PRIMARIA,2,12,12,0,0,0
202223,TO1E04800R,SCUOLA PRIMARIA,3,8,8,0,0,0
202223,PDPS77500P,SCUOLA SECONDARIA II GRADO,2,33,30,3,0,3
202223,VTPM7D500R,SCUOLA SECONDARIA II GRADO,4,10,10,0,0,0
202223,VAPS4N5008,SCUOLA SECONDARIA II GRADO,2,24,23,1,1,0
202223,RM1E16100L,SCUOLA PRIMARIA,5,16,14,2,1,1
202223,NATF34500R,SCUOLA SECONDARIA II GRADO,3,6,6,0,0,0
202223,MIPC06500L,SCUOLA SECONDARIA II GRADO,2,29,29,0,0,0
202223,NA1E136001,SCUOLA PRIMARIA,2,26,22,4,0,4
202223,PC1MIV500Z,SCUOLA SECONDARIA I GRADO,1,16,15,1,0,1
202223,NA1E151003,SCUOLA PRIMARIA,3,26,26,0,0,0
202223,CT1E004001,SCUOLA PRIMARIA,4,29,29,0,0,0
202223,GR1E00100D,SCUOLA PRIMARIA,2,34,34,0,0,0
202223,RE1E006009,SCUOLA PRIMARIA,1,14,13,1,0,1
202223,REPM7R500G,SCUOLA SECONDARIA II GRADO,5,10,10,0,0,0
202223,CSTD03500E,SCUOLA SECONDARIA II GRADO,2,2,2,0,0,0
202223,RGRHL4500A,SCUOLA SECONDARIA II GRADO,3,16,13,3,0,3
202223,BGPS505007,SCUOLA SECONDARIA II GRADO,5,25,25,0,0,0
202223,VA1M013001,SCUOLA SECONDARIA I GRADO,2,65,64,1,0,1
202223,TA1M00300D,SCUOLA SECONDARIA I GRADO,3,23,23,0,0,0
202223,TO1M041007,SCUOLA SECONDARIA I GRADO,1,45,43,2,1,1
202223,BSPS2O5007,SCUOLA SECONDARIA II GRADO,1,17,15,2,0,2
202223,BO1E00800N,SCUOLA PRIMARIA,1,8,7,1,0,1
202223,CO1EMI5009,SCUOLA PRIMARIA,5,26,25,1,0,1
202223,RMPLB3500E,SCUOLA SECONDARIA II GRADO,3,5,4,1,1,0
202223,APTFOR5004,SCUOLA SECONDARIA II GRADO,1,16,16,0,0,0
202223,SAPME1500D,SCUOLA SECONDARIA II GRADO,2,9,9,0,0,0
202223,MB1M020003,SCUOLA SECONDARIA I GRADO,3,25,25,0,0,0
202223,MO1E01100B,SCUOLA PRIMARIA,1,55,50,5,0,5
202223,MBPMM55007,SCUOLA SECONDARIA II GRADO,1,29,29,0,0,0
202223,RMPS97500P,SCUOLA SECONDARIA II GRADO,1,11,9,2,0,2
202223,MI1E00800A,SCUOLA PRIMARIA,5,47,47,0,0,0
202223,NOPC05500E,SCUOLA SECONDARIA II GRADO,2,64,63,1,0,1
202223,GE1E01000L,SCUOLA PRIMARIA,1,25,25,0,0,0
202223,NARFGU5004,SCUOLA SECONDARIA II GRADO,1,3,3,0,0,0
202223,PD1E021003,SCUOLA PRIMARIA,5,17,15,2,1,1
202223,PAPL6T500Q,SCUOLA SECONDARIA II GRADO,2,8,8,0,0,0
202223,SATFUB5003,SCUOLA SECONDARIA II GRADO,3,3,2,1,0,1
202223,VA1E003005,SCUOLA PRIMARIA,2,8,8,0,0,0
202223,FG1E01200P,SCUOLA PRIMARIA,5,22,22,0,0,0
202223,MBPSIE500B,SCUOLA SECONDARIA II GRADO,1,26,24,2,0,2
202223,VARFS2500Z,SCUOLA SECONDARIA II GRADO,1,19,19,0,0,0
202223,CERH4F500L,SCUOLA SECONDARIA II GRADO,2,7,7,0,0,0
202223,RCTDPL500T,SCUOLA SECONDARIA II GRADO,2,4,3,1,0,1
202223,BA1E005007,SCUOLA PRIMARIA,5,23,23,0,0,0
202223,MO1E005004,SCUOLA PRIMARIA,4,38,34,4,1,3
202223,BG1E005008,SCUOLA PRIMARIA,3,41,41,0,0,0
202223,BG1E013007,SCUOLA PRIMARIA,3,17,17,0,0,0
202223,CA1E013003,SCUOLA PRIMARIA,2,19,19,0,0,0
202223,TOTD08500R,SCUOLA SECONDARIA II GRADO,3,5,4,1,0,1
202223,VI1M003004,SCUOLA SECONDARIA I GRADO,2,5,4,1,0,1
202223,GE1E01700B,SCUOLA PRIMARIA,3,16,14,2,1,1
202223,VA1E01900P,SCUOLA PRIMARIA,2,82,79,3,0,3
202223,ME1E01200P,SCUOLA PRIMARIA,5,21,20,1,0,1
202223,NA1E206002,SCUOLA PRIMARIA,3,11,11,0,0,0
202223,BS1E025002,SCUOLA PRIMARIA,4,10,9,1,0,1
202223,PD1E019003,SCUOLA PRIMARIA,4,39,31,8,0,8
202223,AVPM10500T,SCUOLA SECONDARIA II GRADO,1,7,7,0,0,0
202223,COPSUC5004,SCUOLA SECONDARIA II GRADO,3,27,27,0,0,0
202223,RM1E128001,SCUOLA PRIMARIA,4,27,27,0,0,0
202223,MIPL265008,SCUOLA SECONDARIA II GRADO,1,10,10,0,0,0
202223,PD1E012008,SCUOLA PRIMARIA,2,37,36,1,0,1
202223,MBRC4H500I,SCUOLA SECONDARIA II GRADO,2,8,5,3,1,2
202223,RMPC185007,SCUOLA SECONDARIA II GRADO,1,23,23,0,0,0
202223,MIPSDF5000,SCUOLA SECONDARIA II GRADO,4,36,36,0,0,0
202223,RM1M10900R,SCUOLA SECONDARIA I GRADO,2,17,13,4,0,4
202223,BA1E00200Q,SCUOLA PRIMARIA,1,23,23,0,0,0
202223,MITFDH5000,SCUOLA SECONDARIA II GRADO,2,31,31,0,0,0
202223,NA1E156006,SCUOLA PRIMARIA,4,11,9,2,0,2
202223,PVTD05500P,SCUOLA SECONDARIA II GRADO,2,12,12,0,0,0
202223,RMPSI6500C,SCUOLA SECONDARIA II GRADO,1,45,37,8,5,3
202223,CE1E044005,SCUOLA PRIMARIA,5,17,17,0,0,0
202223,NAPM31500X,SCUOLA SECONDARIA II GRADO,2,2,2,0,0,0
202223,VI1M008007,SCUOLA SECONDARIA I GRADO,1,26,22,4,0,4
202223,VAPL06500C,SCUOLA SECONDARIA II GRADO,1,5,3,2,0,2
202223,RM1E01200E,SCUOLA PRIMARIA,4,31,31,0,0,0
202223,FO1E00500D,SCUOLA PRIMARIA,3,47,46,1,1,0
202223,VE1E00100X,SCUOLA PRIMARIA,4,11,8,3,0,3
202223,VAPMV0500Q,SCUOLA SECONDARIA II GRADO,4,26,25,1,0,1
202223,FI1E019006,SCUOLA PRIMARIA,5,29,25,4,0,4
202223,NATFTA500I,SCUOLA SECONDARIA II GRADO,1,5,5,0,0,0
202223,MI1MMU500B,SCUOLA SECONDARIA I GRADO,2,37,34,3,1,2
202223,BO1E00900D,SCUOLA PRIMARIA,1,62,61,1,0,1
202223,MBPS8T500R,SCUOLA SECONDARIA II GRADO,2,24,24,0,0,0
202223,BG1E022002,SCUOLA PRIMARIA,4,16,16,0,0,0
202223,MIPS8E5005,SCUOLA SECONDARIA II GRADO,1,7,7,0,0,0
202223,RMSL3M5001,SCUOLA SECONDARIA II GRADO,1,7,7,0,0,0
202223,TO1E00700E,SCUOLA PRIMARIA,1,34,33,1,1,0
202223,RM1E18200N,SCUOLA PRIMARIA,4,19,18,1,0,1
202223,NATD455002,SCUOLA SECONDARIA II GRADO,5,69,69,0,0,0
202223,NA1E06700Q,SCUOLA PRIMARIA,5,60,60,0,0,0
202223,LCPSU45004,SCUOLA SECONDARIA II GRADO,4,20,20,0,0,0
202223,VR1E00800A,SCUOLA PRIMARIA,5,24,23,1,1,0
202223,NAPM05500Q,SCUOLA SECONDARIA II GRADO,3,18,18,0,0,0
202223,GE1E02300P,SCUOLA PRIMARIA,3,24,15,9,0,9
202223,CTTD365004,SCUOLA SECONDARIA II GRADO,1,3,3,0,0,0
202223,FRTD00500N,SCUOLA SECONDARIA II GRADO,2,2,2,0,0,0
202223,RNPC015002,SCUOLA SECONDARIA II GRADO,5,23,23,0,0,0
202223,RM1E01000V,SCUOLA PRIMARIA,3,27,26,1,0,1
202223,FO1E00300T,SCUOLA PRIMARIA,2,15,14,1,0,1
202223,UD1E008003,SCUOLA PRIMARIA,1,23,22,1,0,1
202223,PA1E007001,SCUOLA PRIMARIA,4,13,13,0,0,0
202223,RMTD49500B,SCUOLA SECONDARIA II GRADO,4,14,12,2,1,1
202223,RM1E02900X,SCUOLA PRIMARIA,5,28,26,2,1,1
202223,NATD355005,SCUOLA SECONDARIA II GRADO,4,4,4,0,0,0
202223,SRPS395007,SCUOLA SECONDARIA II GRADO,4,2,2,0,0,0
202223,GE1E02900N,SCUOLA PRIMARIA,3,17,16,1,0,1
202223,NARH25500E,SCUOLA SECONDARIA II GRADO,3,7,7,0,0,0
202223,CT1M02300G,SCUOLA SECONDARIA I GRADO,1,22,21,1,1,0
202223,BG1M023003,SCUOLA SECONDARIA I GRADO,3,16,14,2,0,2
202223,CTPM075009,SCUOLA SECONDARIA II GRADO,2,4,4,0,0,0
202223,VR1E01400N,SCUOLA PRIMARIA,2,23,23,0,0,0
202223,AVTFRU5000,SCUOLA SECONDARIA II GRADO,3,5,5,0,0,0
202223,FE1E00100N,SCUOLA PRIMARIA,2,36,28,8,1,7
202223,BNRHT2500O,SCUOLA SECONDARIA II GRADO,1,4,4,0,0,0
202223,NA1E12600A,SCUOLA PRIMARIA,2,14,13,1,0,1
202223,NA1E128002,SCUOLA PRIMARIA,4,10,10,0,0,0
202223,CE1EO0500I,SCUOLA PRIMARIA,1,21,21,0,0,0
202223,CE1M00600G,SCUOLA SECONDARIA I GRADO,3,53,50,3,0,3
202223,RMTD665009,SCUOLA SECONDARIA II GRADO,1,6,5,1,0,1
202223,NA1E21100D,SCUOLA PRIMARIA,2,8,8,0,0,0
202223,BS1E00100D,SCUOLA PRIMARIA,4,24,22,2,0,2
202223,RM1M08300T,SCUOLA SECONDARIA I GRADO,2,17,16,1,0,1
202223,VI1E00600A,SCUOLA PRIMARIA,4,18,18,0,0,0
202223,CE1E06300E,SCUOLA PRIMARIA,4,11,7,4,1,3
202223,NAPMSV500U,SCUOLA SECONDARIA II GRADO,1,14,14,0,0,0
202223,PG1E001003,SCUOLA PRIMARIA,5,17,17,0,0,0
202223,SA1E018001,SCUOLA PRIMARIA,3,14,13,1,1,0
202223,MESL0P500H,SCUOLA SECONDARIA II GRADO,3,2,2,0,0,0
202223,PAPC12500D,SCUOLA SECONDARIA II GRADO,2,34,34,0,0,0
202223,RM1E114003,SCUOLA PRIMARIA,1,15,15,0,0,0
202223,NA1E11100L,SCUOLA PRIMARIA,1,10,10,0,0,0
202223,BLPS54500H,SCUOLA SECONDARIA II GRADO,4,11,11,0,0,0
202223,BNRHT2500O,SCUOLA SECONDARIA II GRADO,5,51,49,2,1,1
202223,RM1M2E5007,SCUOLA SECONDARIA I GRADO,1,21,21,0,0,0
202223,MI1E038006,SCUOLA PRIMARIA,5,31,30,1,0,1
202223,NATFZE5004,SCUOLA SECONDARIA II GRADO,3,4,4,0,0,0
202223,NA1E17000C,SCUOLA PRIMARIA,2,13,13,0,0,0
202223,RM1E028004,SCUOLA PRIMARIA,2,21,20,1,0,1
202223,NA1E18800N,SCUOLA PRIMARIA,2,10,10,0,0,0
202223,FI1E02400N,SCUOLA PRIMARIA,2,13,11,2,0,2
202223,LE1E00800D,SCUOLA PRIMARIA,2,31,30,1,1,0
202223,TA1M00300D,SCUOLA SECONDARIA I GRADO,2,25,24,1,0,1
202223,MITD11500B,SCUOLA SECONDARIA II GRADO,4,4,4,0,0,0
202223,BS1M00100P,SCUOLA SECONDARIA I GRADO,2,24,24,0,0,0
202223,SSTD00500D,SCUOLA SECONDARIA II GRADO,4,11,10,1,0,1
202223,PR1M008004,SCUOLA SECONDARIA I GRADO,1,48,48,0,0,0
202223,BO1E013005,SCUOLA PRIMARIA,1,18,18,0,0,0
202223,BGTFMP5003,SCUOLA SECONDARIA II GRADO,5,10,7,3,0,3
202223,CT1E02100P,SCUOLA PRIMARIA,2,4,4,0,0,0
202223,RM1M04300B,SCUOLA SECONDARIA I GRADO,2,29,27,2,1,1
202223,ANRFBS500Z,SCUOLA SECONDARIA II GRADO,2,4,4,0,0,0
202223,MBPS67500C,SCUOLA SECONDARIA II GRADO,3,22,22,0,0,0
202223,CHTF00500E,SCUOLA SECONDARIA II GRADO,1,1,1,0,0,0
202223,MI1M056001,SCUOLA SECONDARIA I GRADO,2,32,31,1,0,1
202223,MI1M07400E,SCUOLA SECONDARIA I GRADO,2,27,27,0,0,0
202223,SATAIC500V,SCUOLA SECONDARIA II GRADO,3,1,1,0,0,0
202223,LC1E010008,SCUOLA PRIMARIA,5,41,38,3,1,2
202223,MB1E03600B,SCUOLA PRIMARIA,3,22,22,0,0,0
202223,NAPC24500P,SCUOLA SECONDARIA II GRADO,4,26,26,0,0,0
202223,PE1M00100N,SCUOLA SECONDARIA I GRADO,1,14,14,0,0,0
202223,LE1E00100P,SCUOLA PRIMARIA,3,41,39,2,0,2
202223,CE1E05000C,SCUOLA PRIMARIA,1,22,16,6,0,6
202223,RGTDCA500P,SCUOLA SECONDARIA II GRADO,1,3,3,0,0,0
202223,PATD205004,SCUOLA SECONDARIA II GRADO,3,8,7,1,0,1
202223,PO1E01100G,SCUOLA PRIMARIA,4,27,25,2,0,2
202223,BO1E01000N,SCUOLA PRIMARIA,5,24,22,2,0,2
202223,GE1E033009,SCUOLA PRIMARIA,4,29,27,2,0,2
202223,SATFTL5007,SCUOLA SECONDARIA II GRADO,5,69,68,1,0,1
202223,GE1M02500G,SCUOLA SECONDARIA I GRADO,3,31,28,3,1,2
202223,UDTFI2500I,SCUOLA SECONDARIA II GRADO,4,24,24,0,0,0
202223,BS1E01500B,SCUOLA PRIMARIA,1,26,24,2,0,2
202223,LO1E001007,SCUOLA PRIMARIA,1,28,28,0,0,0
202223,NATA0L500I,SCUOLA SECONDARIA II GRADO,3,4,4,0,0,0
202223,MI1M06400X,SCUOLA SECONDARIA I GRADO,3,36,34,2,0,2
202223,TO1E024008,SCUOLA PRIMARIA,5,63,60,3,1,2
202223,SP1E00500Q,SCUOLA PRIMARIA,1,25,20,5,2,3
202223,FI1E06200C,SCUOLA PRIMARIA,2,50,47,3,0,3
202223,RM1E073002,SCUOLA PRIMARIA,2,37,28,9,5,4
202223,FI1MIM500Z,SCUOLA SECONDARIA I GRADO,2,51,40,11,4,7
202223,ANPS00500T,SCUOLA SECONDARIA II GRADO,2,4,4,0,0,0
202223,VA1MAR500M,SCUOLA SECONDARIA I GRADO,1,25,24,1,0,1
202223,LU1E002008,SCUOLA PRIMARIA,5,26,25,1,0,1
202223,VE1E006003,SCUOLA PRIMARIA,3,22,19,3,0,3
202223,NA1E031001,SCUOLA PRIMARIA,4,19,19,0,0,0
202223,VR1M01100B,SCUOLA SECONDARIA I GRADO,1,17,16,1,0,1
202223,NA1E272001,SCUOLA PRIMARIA,1,14,13,1,0,1
202223,BL1E818011,SCUOLA PRIMARIA,2,4,4,0,0,0
202223,SAPS06500Q,SCUOLA SECONDARIA II GRADO,3,3,3,0,0,0
202223,LT1E00200R,SCUOLA PRIMARIA,1,19,17,2,0,2
202223,RM1E043006,SCUOLA PRIMARIA,4,55,55,0,0,0
202223,FI1E063008,SCUOLA PRIMARIA,1,12,9,3,1,2
202223,NARHCV500Q,SCUOLA SECONDARIA II GRADO,5,172,162,10,3,7
202223,TVPL75500A,SCUOLA SECONDARIA II GRADO,1,21,21,0,0,0
202223,TVPL005007,SCUOLA SECONDARIA II GRADO,5,18,18,0,0,0
202223,RM1E15900L,SCUOLA PRIMARIA,1,20,17,3,1,2
202223,NA1E25800P,SCUOLA PRIMARIA,1,24,15,9,2,7
202223,NA1E26100E,SCUOLA PRIMARIA,4,13,13,0,0,0
202223,RM1E126009,SCUOLA PRIMARIA,1,20,19,1,0,1
202223,BLPSD7500D,SCUOLA SECONDARIA II GRADO,4,13,13,0,0,0
202223,MI1E045009,SCUOLA PRIMARIA,1,13,13,0,0,0
202223,NATL265009,SCUOLA SECONDARIA II GRADO,2,7,7,0,0,0
202223,RMPSE55000,SCUOLA SECONDARIA II GRADO,3,42,42,0,0,0
202223,LCRC4F500Q,SCUOLA SECONDARIA II GRADO,4,20,17,3,1,2
202223,MB1E09200Q,SCUOLA PRIMARIA,2,22,22,0,0,0
202223,RGPM0A500T,SCUOLA SECONDARIA II GRADO,1,5,5,0,0,0
202223,BGPS135006,SCUOLA SECONDARIA II GRADO,3,9,9,0,0,0
202223,TA1E003008,SCUOLA PRIMARIA,1,16,16,0,0,0
202223,MITD73500S,SCUOLA SECONDARIA II GRADO,3,8,8,0,0,0
202223,RM1E155009,SCUOLA PRIMARIA,1,27,25,2,0,2
202223,COSL02500A,SCUOLA SECONDARIA II GRADO,4,6,5,1,0,1
202223,NA1E243001,SCUOLA PRIMARIA,4,11,11,0,0,0
202223,PATD34500B,SCUOLA SECONDARIA II GRADO,1,1,1,0,0,0
202223,CZPM00500Q,SCUOLA SECONDARIA II GRADO,2,14,12,2,0,2
202223,MI1E12100N,SCUOLA PRIMARIA,1,35,33,2,0,2
202223,GEPS70500C,SCUOLA SECONDARIA II GRADO,4,49,49,0,0,0
202223,RMPS00500L,SCUOLA SECONDARIA II GRADO,4,11,11,0,0,0
202223,RMSLBH500V,SCUOLA SECONDARIA II GRADO,4,9,9,0,0,0
202223,NATL83500Z,SCUOLA SECONDARIA II GRADO,4,3,3,0,0,0
202223,PVPMF55003,SCUOLA SECONDARIA II GRADO,3,5,5,0,0,0
202223,PI1M001001,SCUOLA SECONDARIA I GRADO,3,25,23,2,0,2
202223,APPSL05000,SCUOLA SECONDARIA II GRADO,4,6,6,0,0,0
202223,NA1E065004,SCUOLA PRIMARIA,3,11,7,4,0,4
202223,MI1E00500V,SCUOLA PRIMARIA,4,25,25,0,0,0
202223,SARFRL5003,SCUOLA SECONDARIA II GRADO,1,4,4,0,0,0
202223,TV1EDQ500C,SCUOLA PRIMARIA,2,17,17,0,0,0
202223,VAPS6M5003,SCUOLA SECONDARIA II GRADO,5,47,47,0,0,0
202223,CETF8R5001,SCUOLA SECONDARIA II GRADO,3,8,8,0,0,0
202223,BSPSO5500G,SCUOLA SECONDARIA II GRADO,4,19,19,0,0,0
202223,NA1MIM5003,SCUOLA SECONDARIA I GRADO,1,9,9,0,0,0
202223,NA1MT6500T,SCUOLA SECONDARIA I GRADO,2,12,11,1,0,1
202223,NATFAA500F,SCUOLA SECONDARIA II GRADO,4,7,7,0,0,0
202223,CE1E01100T,SCUOLA PRIMARIA,1,36,34,2,0,2
202223,MI1E08600G,SCUOLA PRIMARIA,1,44,41,3,0,3
202223,AR1E006008,SCUOLA PRIMARIA,5,23,21,2,0,2
202223,RCTD5M5009,SCUOLA SECONDARIA II GRADO,5,43,41,2,1,1
202223,BAPS035008,SCUOLA SECONDARIA II GRADO,4,2,2,0,0,0
202223,MBPS245005,SCUOLA SECONDARIA II GRADO,4,10,10,0,0,0
202223,RMPS59500C,SCUOLA SECONDARIA II GRADO,4,7,6,1,0,1
202223,PSPS005004,SCUOLA SECONDARIA II GRADO,2,13,12,1,0,1
202223,AL1M00400B,SCUOLA SECONDARIA I GRADO,2,22,21,1,1,0
202223,MIPS06500Q,SCUOLA SECONDARIA II GRADO,1,3,3,0,0,0
202223,LT1E005008,SCUOLA PRIMARIA,1,31,29,2,0,2
202223,CETD135008,SCUOLA SECONDARIA II GRADO,4,3,3,0,0,0
202223,VE1M006008,SCUOLA SECONDARIA I GRADO,2,14,12,2,0,2
202223,MI1E07700R,SCUOLA PRIMARIA,2,24,24,0,0,0
202223,PAPC00500B,SCUOLA SECONDARIA II GRADO,3,1,1,0,0,0
202223,NATF2E500L,SCUOLA SECONDARIA II GRADO,4,10,10,0,0,0
202223,CE1E008002,SCUOLA PRIMARIA,5,11,10,1,0,1
202223,RMPST6500P,SCUOLA SECONDARIA II GRADO,2,6,6,0,0,0
202223,CN1MMA500M,SCUOLA SECONDARIA I GRADO,3,16,15,1,1,0
202223,BA1E02500C,SCUOLA PRIMARIA,1,15,15,0,0,0
202223,MNPL02500L,SCUOLA SECONDARIA II GRADO,1,13,13,0,0,0
202223,SAPMNI5000,SCUOLA SECONDARIA II GRADO,3,2,1,1,1,0
202223,NA1E19000N,SCUOLA PRIMARIA,2,19,19,0,0,0
202223,FI1E02500D,SCUOLA PRIMARIA,2,24,19,5,0,5
202223,SIPS01500C,SCUOLA SECONDARIA II GRADO,1,18,16,2,0,2
202223,BOPSOI5007,SCUOLA SECONDARIA II GRADO,2,28,28,0,0,0
202223,VA1E011004,SCUOLA PRIMARIA,2,23,23,0,0,0
202223,NARF5C500N,SCUOLA SECONDARIA II GRADO,1,5,5,0,0,0
202223,BS1M018004,SCUOLA SECONDARIA I GRADO,1,28,26,2,1,1
202223,AVPSPT500F,SCUOLA SECONDARIA II GRADO,3,3,3,0,0,0
202223,AVTD075001,SCUOLA SECONDARIA II GRADO,1,4,4,0,0,0
202223,MI1M10600R,SCUOLA SECONDARIA I GRADO,2,8,5,3,1,2
202223,TOPQ475003,SCUOLA SECONDARIA II GRADO,1,12,12,0,0,0
202223,RM1E13900B,SCUOLA PRIMARIA,4,15,15,0,0,0
202223,SAPS09500G,SCUOLA SECONDARIA II GRADO,5,36,35,1,0,1
202223,MN1E00200X,SCUOLA PRIMARIA,1,28,26,2,0,2
202223,MO1E00700Q,SCUOLA PRIMARIA,5,48,48,0,0,0
202223,PVTD065009,SCUOLA SECONDARIA II GRADO,2,1,1,0,0,0
202223,MI1M00700Q,SCUOLA SECONDARIA I GRADO,2,50,48,2,0,2
202223,NA1MVQ500R,SCUOLA SECONDARIA I GRADO,3,6,6,0,0,0
202223,MB1E04100V,SCUOLA PRIMARIA,3,48,48,0,0,0
202223,FRTFF6500V,SCUOLA SECONDARIA II GRADO,3,2,2,0,0,0
202223,RM1E006007,SCUOLA PRIMARIA,3,25,22,3,1,2
202223,RM1M01400B,SCUOLA SECONDARIA I GRADO,1,42,41,1,1,0
202223,CETDHG500L,SCUOLA SECONDARIA II GRADO,4,7,3,4,0,4
202223,SATD30500E,SCUOLA SECONDARIA II GRADO,3,6,6,0,0,0
202223,KR1M00100A,SCUOLA SECONDARIA I GRADO,1,17,13,4,3,1
202223,PR1M003001,SCUOLA SECONDARIA I GRADO,2,51,48,3,0,3
202223,COPS055009,SCUOLA SECONDARIA II GRADO,1,7,5,2,0,2
202223,RARI015004,SCUOLA SECONDARIA II GRADO,2,3,3,0,0,0
202223,PCPM79500U,SCUOLA SECONDARIA II GRADO,4,12,11,1,0,1
202223,BG1E02000A,SCUOLA PRIMARIA,5,24,24,0,0,0
202223,RM1M074003,SCUOLA SECONDARIA I GRADO,1,73,73,0,0,0
202223,BS1E00600L,SCUOLA PRIMARIA,4,57,56,1,0,1
202223,RMPMSC500I,SCUOLA SECONDARIA II GRADO,1,14,12,2,0,2
202223,NATD27500D,SCUOLA SECONDARIA II GRADO,3,13,13,0,0,0
202223,RE1E006009,SCUOLA PRIMARIA,2,13,13,0,0,0
202223,NAPSP25001,SCUOLA SECONDARIA II GRADO,3,3,3,0,0,0
202223,NA1E07700A,SCUOLA PRIMARIA,5,14,14,0,0,0
202223,TV1E00400B,SCUOLA PRIMARIA,1,40,40,0,0,0
202223,LTPM4Q5001,SCUOLA SECONDARIA II GRADO,5,49,48,1,0,1
202223,CETD4C500S,SCUOLA SECONDARIA II GRADO,3,8,1,7,0,7
202223,RMPLOA500A,SCUOLA SECONDARIA II GRADO,5,24,22,2,0,2
202223,RMPL325007,SCUOLA SECONDARIA II GRADO,1,2,2,0,0,0
202223,VRPS01500P,SCUOLA SECONDARIA II GRADO,5,6,6,0,0,0
202223,RCTDBT500S,SCUOLA SECONDARIA II GRADO,5,48,46,2,1,1
202223,MB1M01600B,SCUOLA SECONDARIA I GRADO,1,28,28,0,0,0
202223,NATBQG5001,SCUOLA SECONDARIA II GRADO,5,39,36,3,1,2
202223,MI1M071003,SCUOLA SECONDARIA I GRADO,3,18,17,1,0,1
202223,SR1E005001,SCUOLA PRIMARIA,5,23,21,2,0,2
202223,RE1EE9500Z,SCUOLA PRIMARIA,3,24,23,1,0,1
202223,SA1E02300C,SCUOLA PRIMARIA,3,17,16,1,0,1
202223,RM1E077009,SCUOLA PRIMARIA,1,11,2,9,1,8
202223,PV1E008004,SCUOLA PRIMARIA,2,19,17,2,0,2
202223,PAPS05500G,SCUOLA SECONDARIA II GRADO,5,20,20,0,0,0
202223,CERIDA500F,SCUOLA SECONDARIA II GRADO,5,66,65,1,0,1
202223,LTTF9N5007,SCUOLA SECONDARIA II GRADO,3,6,6,0,0,0
202223,NARHZ5500Q,SCUOLA SECONDARIA II GRADO,3,6,6,0,0,0
202223,NA1E029001,SCUOLA PRIMARIA,1,23,23,0,0,0
202223,PD1E019003,SCUOLA PRIMARIA,5,40,38,2,0,2
202223,CTPS09500D,SCUOLA SECONDARIA II GRADO,4,13,13,0,0,0
202223,RMPL445009,SCUOLA SECONDARIA II GRADO,3,11,10,1,1,0
202223,VARHL7500G,SCUOLA SECONDARIA II GRADO,3,8,8,0,0,0
202223,NA1E106005,SCUOLA PRIMARIA,3,24,23,1,0,1
202223,RM1M11200L,SCUOLA SECONDARIA I GRADO,3,10,10,0,0,0
202223,CR1E00900D,SCUOLA PRIMARIA,5,42,40,2,0,2
202223,BG1E00800Q,SCUOLA PRIMARIA,1,43,43,0,0,0
202223,CA1E01400V,SCUOLA PRIMARIA,5,25,25,0,0,0
202223,VEPL4H500R,SCUOLA SECONDARIA II GRADO,3,9,8,1,0,1
202223,BO1E020008,SCUOLA PRIMARIA,5,36,33,3,0,3
202223,SV1E00300E,SCUOLA PRIMARIA,1,27,27,0,0,0
202223,RMPC29500P,SCUOLA SECONDARIA II GRADO,2,26,26,0,0,0
202223,VR1E02100R,SCUOLA PRIMARIA,1,41,39,2,1,1
202223,TO1MNU500Z,SCUOLA SECONDARIA I GRADO,3,17,16,1,1,0
202223,RMRF9P500F,SCUOLA SECONDARIA II GRADO,1,6,4,2,1,1
202223,FIPMRR500G,SCUOLA SECONDARIA II GRADO,1,10,9,1,0,1
202223,MIPL08500Q,SCUOLA SECONDARIA II GRADO,1,15,14,1,0,1
202223,BO1E00900D,SCUOLA PRIMARIA,2,64,63,1,1,0
202223,MBPS8T500R,SCUOLA SECONDARIA II GRADO,3,24,24,0,0,0
202223,VATB215007,SCUOLA SECONDARIA II GRADO,3,11,8,3,0,3
202223,VAPSZC500T,SCUOLA SECONDARIA II GRADO,3,24,24,0,0,0
202223,RMPC10500A,SCUOLA SECONDARIA II GRADO,5,17,17,0,0,0
202223,RM1M031005,SCUOLA SECONDARIA I GRADO,1,20,18,2,0,2
202223,MI1E047001,SCUOLA PRIMARIA,4,66,66,0,0,0
202223,CRPL01500R,SCUOLA SECONDARIA II GRADO,5,23,22,1,1,0
202223,SAPS11500B,SCUOLA SECONDARIA II GRADO,4,5,5,0,0,0
202223,MB1E07200E,SCUOLA PRIMARIA,1,24,24,0,0,0
202223,NAPM05500Q,SCUOLA SECONDARIA II GRADO,4,24,24,0,0,0
202223,VIPLVN5005,SCUOLA SECONDARIA II GRADO,1,14,14,0,0,0
202223,PETF005003,SCUOLA SECONDARIA II GRADO,3,9,9,0,0,0
202223,PATD12500C,SCUOLA SECONDARIA II GRADO,5,89,89,0,0,0
202223,CZ1E00400N,SCUOLA PRIMARIA,5,10,10,0,0,0
202223,SSTD02500P,SCUOLA SECONDARIA II GRADO,3,2,2,0,0,0
202223,MITF005006,SCUOLA SECONDARIA II GRADO,3,70,58,12,1,11
202223,NATFDD500F,SCUOLA SECONDARIA II GRADO,5,57,52,5,2,3
202223,MI1MT3500U,SCUOLA SECONDARIA I GRADO,1,56,53,3,1,2
202223,VT1E002002,SCUOLA PRIMARIA,4,19,17,2,1,1
202223,NA1E130002,SCUOLA PRIMARIA,2,19,19,0,0,0
202223,BNTDDC500S,SCUOLA SECONDARIA II GRADO,4,9,9,0,0,0
202223,BO1E00200P,SCUOLA PRIMARIA,4,44,41,3,1,2
202223,NA1E10800R,SCUOLA PRIMARIA,5,23,23,0,0,0
202223,VR1M92500T,SCUOLA SECONDARIA I GRADO,2,35,33,2,0,2
202223,NAPSF2500E,SCUOLA SECONDARIA II GRADO,4,12,12,0,0,0
202223,NARHZ8500V,SCUOLA SECONDARIA II GRADO,1,13,13,0,0,0
202223,MBPS1Q500V,SCUOLA SECONDARIA II GRADO,4,30,30,0,0,0
202223,TO1E01400N,SCUOLA PRIMARIA,1,28,24,4,3,1
202223,TATF035003,SCUOLA SECONDARIA II GRADO,4,8,8,0,0,0
202223,NA1E07000G,SCUOLA PRIMARIA,3,26,22,4,0,4
202223,CSPM04500A,SCUOLA SECONDARIA II GRADO,5,11,10,1,1,0
202223,NAPLIA500F,SCUOLA SECONDARIA II GRADO,2,11,11,0,0,0
202223,CTTD92500V,SCUOLA SECONDARIA II GRADO,5,47,46,1,0,1
202223,RM1E01200E,SCUOLA PRIMARIA,1,37,34,3,1,2
202223,MIRFHT500U,SCUOLA SECONDARIA II GRADO,5,22,21,1,0,1
202223,VR1E01400N,SCUOLA PRIMARIA,1,26,25,1,0,1
202223,UDPS01500B,SCUOLA SECONDARIA II GRADO,4,14,14,0,0,0
202223,BNTFOA500V,SCUOLA SECONDARIA II GRADO,5,70,69,1,0,1
202223,MI1E088007,SCUOLA PRIMARIA,5,50,49,1,0,1
202223,OR1E00100R,SCUOLA PRIMARIA,2,15,15,0,0,0
202223,PO1E00200R,SCUOLA PRIMARIA,4,24,22,2,0,2
202223,CSPM025005,SCUOLA SECONDARIA II GRADO,3,5,5,0,0,0
202223,AL1M01000P,SCUOLA SECONDARIA I GRADO,3,32,29,3,0,3
202223,VA1E01500B,SCUOLA PRIMARIA,2,47,46,1,1,0
202223,NARH4C5006,SCUOLA SECONDARIA II GRADO,1,7,7,0,0,0
202223,RM1E7V500S,SCUOLA PRIMARIA,5,11,10,1,0,1
202223,CTPC01500D,SCUOLA SECONDARIA II GRADO,4,9,9,0,0,0
202223,BG1M01800G,SCUOLA SECONDARIA I GRADO,1,52,49,3,0,3
202223,CE1E015005,SCUOLA PRIMARIA,2,16,13,3,0,3
202223,RM1M09900B,SCUOLA SECONDARIA I GRADO,1,84,83,1,0,1
202223,BA1E014002,SCUOLA PRIMARIA,3,14,14,0,0,0
202223,MO1E00300C,SCUOLA PRIMARIA,5,52,44,8,1,7
202223,LI1E00900L,SCUOLA PRIMARIA,4,26,26,0,0,0
202223,NO1E001004,SCUOLA PRIMARIA,3,19,14,5,1,4
202223,AL1E00100P,SCUOLA PRIMARIA,1,50,50,0,0,0
202223,PG1E00400E,SCUOLA PRIMARIA,1,11,10,1,1,0
202223,SA1E02200L,SCUOLA PRIMARIA,2,11,10,1,0,1
202223,MERH015005,SCUOLA SECONDARIA II GRADO,4,2,1,1,0,1
202223,RM1ES55005,SCUOLA PRIMARIA,4,18,16,2,0,2
202223,TVPS02500N,SCUOLA SECONDARIA II GRADO,2,19,19,0,0,0
202223,SRTD08500V,SCUOLA SECONDARIA II GRADO,4,4,3,1,1,0
202223,CZ1MBR5002,SCUOLA SECONDARIA I GRADO,1,9,9,0,0,0
202223,NATD9F500E,SCUOLA SECONDARIA II GRADO,4,9,9,0,0,0
202223,NA1E194001,SCUOLA PRIMARIA,4,9,9,0,0,0
202223,VR1E00600P,SCUOLA PRIMARIA,1,40,33,7,2,5
202223,PE1M00100N,SCUOLA SECONDARIA I GRADO,2,19,16,3,3,0
202223,CE1E05000C,SCUOLA PRIMARIA,2,17,16,1,1,0
202223,BGSLQP500D,SCUOLA SECONDARIA II GRADO,5,5,5,0,0,0
202223,CETF1M500C,SCUOLA SECONDARIA II GRADO,3,9,9,0,0,0
202223,LC1E003005,SCUOLA PRIMARIA,1,43,40,3,0,3
202223,VATFME500R,SCUOLA SECONDARIA II GRADO,2,16,15,1,0,1
202223,TVPM8T500U,SCUOLA SECONDARIA II GRADO,2,16,15,1,0,1
202223,COPSIS500Q,SCUOLA SECONDARIA II GRADO,1,29,28,1,0,1
202223,VRPS005004,SCUOLA SECONDARIA II GRADO,5,23,22,1,0,1
202223,BG1E01800A,SCUOLA PRIMARIA,4,40,36,4,0,4
202223,CT1E010008,SCUOLA PRIMARIA,2,19,18,1,0,1
202223,MIPSPS500G,SCUOLA SECONDARIA II GRADO,5,23,23,0,0,0
202223,PV1M00200A,SCUOLA SECONDARIA I GRADO,1,27,24,3,0,3
202223,MS1EO3500D,SCUOLA PRIMARIA,3,10,10,0,0,0
202223,TO1E01300T,SCUOLA PRIMARIA,1,54,53,1,0,1
202223,ANTD02500V,SCUOLA SECONDARIA II GRADO,4,10,10,0,0,0
202223,TATD055002,SCUOLA SECONDARIA II GRADO,4,4,4,0,0,0
202223,MI1E02100R,SCUOLA PRIMARIA,3,36,35,1,0,1
202223,SAPSM3500V,SCUOLA SECONDARIA II GRADO,2,5,5,0,0,0
202223,PE1E002008,SCUOLA PRIMARIA,5,12,12,0,0,0
202223,FR1E003001,SCUOLA PRIMARIA,5,22,22,0,0,0
202223,VIPS01500A,SCUOLA SECONDARIA II GRADO,2,6,5,1,0,1
202223,ME1E00500G,SCUOLA PRIMARIA,1,7,7,0,0,0
202223,BGPSDM500A,SCUOLA SECONDARIA II GRADO,5,17,17,0,0,0
202223,VE1E00700V,SCUOLA PRIMARIA,5,22,13,9,1,8
202223,VATN01500A,SCUOLA SECONDARIA II GRADO,1,19,17,2,1,1
202223,SATL04500R,SCUOLA SECONDARIA II GRADO,1,8,7,1,0,1
202223,GE1M006006,SCUOLA SECONDARIA I GRADO,1,24,23,1,0,1
202223,MIPS43500B,SCUOLA SECONDARIA II GRADO,2,29,28,1,0,1
202223,NA1E22800V,SCUOLA PRIMARIA,3,15,15,0,0,0
202223,BS1E016007,SCUOLA PRIMARIA,4,20,20,0,0,0
202223,RMSLVB5007,SCUOLA SECONDARIA II GRADO,5,40,40,0,0,0
202223,RMPS36500V,SCUOLA SECONDARIA II GRADO,2,10,10,0,0,0
202223,TV1M01000X,SCUOLA SECONDARIA I GRADO,3,21,20,1,0,1
202223,SP1E003004,SCUOLA PRIMARIA,3,36,36,0,0,0
202223,RM1E08200R,SCUOLA PRIMARIA,3,14,10,4,0,4
202223,VE1E01100E,SCUOLA PRIMARIA,4,19,19,0,0,0
202223,NA1M03900R,SCUOLA SECONDARIA I GRADO,3,16,15,1,0,1
202223,LC1E009004,SCUOLA PRIMARIA,1,45,45,0,0,0
202223,FI1E00700X,SCUOLA PRIMARIA,5,15,13,2,0,2
202223,BG1M02700A,SCUOLA SECONDARIA I GRADO,1,53,52,1,0,1
202223,CTRCQ5500S,SCUOLA SECONDARIA II GRADO,3,3,3,0,0,0
202223,GE1E039008,SCUOLA PRIMARIA,3,31,28,3,0,3
202223,TOPC11500C,SCUOLA SECONDARIA II GRADO,2,1,1,0,0,0
202223,FIPS15500B,SCUOLA SECONDARIA II GRADO,2,17,15,2,0,2
202223,AQ1E004002,SCUOLA PRIMARIA,3,15,15,0,0,0
202223,RA1M00200R,SCUOLA SECONDARIA I GRADO,3,42,41,1,1,0
202223,RM1E03800P,SCUOLA PRIMARIA,4,9,3,6,0,6
202223,RMPS695009,SCUOLA SECONDARIA II GRADO,1,16,16,0,0,0
202223,BO1E01700C,SCUOLA PRIMARIA,3,47,47,0,0,0
202223,NA1E20200P,SCUOLA PRIMARIA,3,10,10,0,0,0
202223,ME1M004001,SCUOLA SECONDARIA I GRADO,1,23,22,1,1,0
202223,SATDGN500Z,SCUOLA SECONDARIA II GRADO,4,13,13,0,0,0
202223,RM1EQM5004,SCUOLA PRIMARIA,2,25,24,1,0,1
202223,IM1M00500T,SCUOLA SECONDARIA I GRADO,3,18,17,1,0,1
202223,RM1E21000L,SCUOLA PRIMARIA,4,25,25,0,0,0
202223,PA1E03900C,SCUOLA PRIMARIA,4,20,20,0,0,0
202223,PA1M008002,SCUOLA SECONDARIA I GRADO,1,33,33,0,0,0
202223,TO1M056001,SCUOLA SECONDARIA I GRADO,1,84,82,2,1,1
202223,NATDPG500E,SCUOLA SECONDARIA II GRADO,5,66,63,3,1,2
202223,NA1E25300G,SCUOLA PRIMARIA,2,18,18,0,0,0
202223,NATF28500A,SCUOLA SECONDARIA II GRADO,2,4,4,0,0,0
202223,FE1E00200D,SCUOLA PRIMARIA,4,21,20,1,0,1
202223,BLPC01500G,SCUOLA SECONDARIA II GRADO,3,3,3,0,0,0
202223,FG1E010003,SCUOLA PRIMARIA,3,19,18,1,0,1
202223,BG1EL2500G,SCUOLA PRIMARIA,3,6,6,0,0,0
202223,MI1E046005,SCUOLA PRIMARIA,5,81,78,3,2,1
202223,MS1E00400V,SCUOLA PRIMARIA,4,20,20,0,0,0
202223,CL1E002008,SCUOLA PRIMARIA,2,14,14,0,0,0
202223,CL1E00400X,SCUOLA PRIMARIA,4,15,15,0,0,0
202223,TATD08500T,SCUOLA SECONDARIA II GRADO,1,20,18,2,2,0
202223,TOSL01500G,SCUOLA SECONDARIA II GRADO,4,27,26,1,1,0
202223,RA1E004007,SCUOLA PRIMARIA,5,81,71,10,4,6
202223,RMPS97500P,SCUOLA SECONDARIA II GRADO,4,19,18,1,0,1
202223,BO1M01200E,SCUOLA SECONDARIA I GRADO,1,179,176,3,0,3
202223,TS1E00400N,SCUOLA PRIMARIA,3,16,16,0,0,0
202223,VI1E01100T,SCUOLA PRIMARIA,5,23,21,2,1,1
202223,SATF02500B,SCUOLA SECONDARIA II GRADO,4,5,5,0,0,0
202223,MITDOT5002,SCUOLA SECONDARIA II GRADO,2,14,14,0,0,0
202223,TO1EDV500F,SCUOLA PRIMARIA,2,15,14,1,0,1
202223,PA1E035005,SCUOLA PRIMARIA,3,48,48,0,0,0
202223,AVRH2Q500U,SCUOLA SECONDARIA II GRADO,5,105,104,1,1,0
202223,RMPSPL500P,SCUOLA SECONDARIA II GRADO,5,17,17,0,0,0
202223,MBPSLD5004,SCUOLA SECONDARIA II GRADO,1,21,20,1,0,1
202223,PD1E004009,SCUOLA PRIMARIA,1,26,26,0,0,0
202223,SATF1Z500T,SCUOLA SECONDARIA II GRADO,5,37,35,2,2,0
202223,RM1M036008,SCUOLA SECONDARIA I GRADO,1,43,42,1,0,1
202223,RMPS285007,SCUOLA SECONDARIA II GRADO,2,6,5,1,0,1
202223,CETL04500C,SCUOLA SECONDARIA II GRADO,5,26,26,0,0,0
202223,PVRFL2500T,SCUOLA SECONDARIA II GRADO,5,16,13,3,0,3
202223,MI1E14300E,SCUOLA PRIMARIA,4,14,11,3,1,2
202223,SARF17500D,SCUOLA SECONDARIA II GRADO,2,7,7,0,0,0
202223,CE1E04800C,SCUOLA PRIMARIA,2,22,22,0,0,0
202223,TS1E006009,SCUOLA PRIMARIA,4,15,15,0,0,0
202223,PAPMRG500C,SCUOLA SECONDARIA II GRADO,5,61,59,2,0,2
202223,PAPSVD500Q,SCUOLA SECONDARIA II GRADO,3,15,14,1,0,1
202223,FRTDEU500U,SCUOLA SECONDARIA II GRADO,1,3,3,0,0,0
202223,VAPL10500N,SCUOLA SECONDARIA II GRADO,4,7,5,2,0,2
202223,LU1M8R500T,SCUOLA SECONDARIA I GRADO,3,23,14,9,1,8
202223,BSPS6Z5004,SCUOLA SECONDARIA II GRADO,2,17,16,1,0,1
202223,CTPM345004,SCUOLA SECONDARIA II GRADO,1,26,25,1,1,0
202223,NA1E150007,SCUOLA PRIMARIA,5,24,23,1,0,1
202223,BG1E00400C,SCUOLA PRIMARIA,1,18,16,2,0,2
202223,RM1E17400P,SCUOLA PRIMARIA,5,18,16,2,0,2
202223,VEPS00500C,SCUOLA SECONDARIA II GRADO,4,22,22,0,0,0
202223,TV1E00900E,SCUOLA PRIMARIA,4,20,19,1,0,1
202223,LC1M040009,SCUOLA SECONDARIA I GRADO,1,50,50,0,0,0
202223,FI1M029002,SCUOLA SECONDARIA I GRADO,1,46,39,7,0,7
202223,LCRF085005,SCUOLA SECONDARIA II GRADO,5,20,18,2,0,2
202223,AN1E001009,SCUOLA PRIMARIA,1,6,5,1,0,1
202223,MIPM1R500Q,SCUOLA SECONDARIA II GRADO,3,16,15,1,1,0
202223,MIPMZS500F,SCUOLA SECONDARIA II GRADO,5,24,23,1,0,1
202223,SA1E01500D,SCUOLA PRIMARIA,2,20,20,0,0,0
202223,LT1E00800Q,SCUOLA PRIMARIA,4,10,10,0,0,0
202223,PR1E00300Q,SCUOLA PRIMARIA,1,26,25,1,0,1
202223,MB1E029008,SCUOLA PRIMARIA,4,50,50,0,0,0
202223,RMPM045004,SCUOLA SECONDARIA II GRADO,4,8,7,1,0,1
202223,RMPLLD5008,SCUOLA SECONDARIA II GRADO,5,20,19,1,0,1
202223,VARFIU5007,SCUOLA SECONDARIA II GRADO,3,12,9,3,1,2
202223,MI1E06500E,SCUOLA PRIMARIA,2,29,28,1,1,0
202223,LI1E006005,SCUOLA PRIMARIA,2,35,35,0,0,0
202223,RM1E023001,SCUOLA PRIMARIA,2,35,30,5,0,5
202223,NO1M01400B,SCUOLA SECONDARIA I GRADO,3,25,24,1,0,1
202223,MB1E06800V,SCUOLA PRIMARIA,4,17,17,0,0,0
202223,BOPS02500L,SCUOLA SECONDARIA II GRADO,5,28,28,0,0,0
202223,SRTN2V5006,SCUOLA SECONDARIA II GRADO,3,1,1,0,0,0
202223,SATD30500E,SCUOLA SECONDARIA II GRADO,2,7,7,0,0,0
202223,PAPM9C5005,SCUOLA SECONDARIA II GRADO,2,30,30,0,0,0
202223,BG1MRA500Q,SCUOLA SECONDARIA I GRADO,1,9,8,1,0,1
202223,AVTDMI500Z,SCUOLA SECONDARIA II GRADO,4,4,4,0,0,0
202223,NA1E23700N,SCUOLA PRIMARIA,5,19,19,0,0,0
202223,TOPQ04500Q,SCUOLA SECONDARIA II GRADO,1,40,40,0,0,0
202223,MIPM04500G,SCUOLA SECONDARIA II GRADO,3,24,24,0,0,0
202223,NA1E114004,SCUOLA PRIMARIA,2,10,10,0,0,0
202223,NAPS7Q5000,SCUOLA SECONDARIA II GRADO,3,9,9,0,0,0
202223,CEPC015007,SCUOLA SECONDARIA II GRADO,3,28,28,0,0,0
202223,GERI015006,SCUOLA SECONDARIA II GRADO,4,40,35,5,1,4
202223,NA1E09000R,SCUOLA PRIMARIA,1,43,42,1,0,1
202223,APPCV8500G,SCUOLA SECONDARIA II GRADO,4,2,2,0,0,0
202223,MI1EMR500E,SCUOLA PRIMARIA,3,45,42,3,1,2
202223,RN1E005009,SCUOLA PRIMARIA,2,46,45,1,0,1
202223,MB1E03400Q,SCUOLA PRIMARIA,2,42,39,3,1,2
202223,SARF6Q5004,SCUOLA SECONDARIA II GRADO,5,64,55,9,2,7
202223,PETD03500L,SCUOLA SECONDARIA II GRADO,4,10,9,1,1,0
202223,PS1M00200L,SCUOLA SECONDARIA I GRADO,3,14,12,2,0,2
202223,MEPCPD5001,SCUOLA SECONDARIA II GRADO,3,3,2,1,0,1
202223,BO1E00100V,SCUOLA PRIMARIA,4,46,41,5,0,5
202223,CT1E054002,SCUOLA PRIMARIA,5,15,13,2,1,1
202223,NAPS5P500P,SCUOLA SECONDARIA II GRADO,2,2,2,0,0,0
202223,TVTB205003,SCUOLA SECONDARIA II GRADO,1,27,26,1,0,1
202223,MI1EAE500E,SCUOLA PRIMARIA,4,21,21,0,0,0
202223,SARHGL500M,SCUOLA SECONDARIA II GRADO,5,162,158,4,0,4
202223,VTPMI8500B,SCUOLA SECONDARIA II GRADO,2,10,9,1,0,1
202223,LTTD595008,SCUOLA SECONDARIA II GRADO,2,7,7,0,0,0
202223,BSPMNI500T,SCUOLA SECONDARIA II GRADO,2,24,24,0,0,0
202223,NA1ED8500Q,SCUOLA PRIMARIA,1,4,4,0,0,0
202223,NA1E04800A,SCUOLA PRIMARIA,3,29,29,0,0,0
202223,BGPMIZ500F,SCUOLA SECONDARIA II GRADO,2,4,4,0,0,0
202223,CT1E038004,SCUOLA PRIMARIA,1,10,10,0,0,0
202223,MB1M02300E,SCUOLA SECONDARIA I GRADO,3,24,24,0,0,0
202223,LE1MO05005,SCUOLA SECONDARIA I GRADO,2,22,20,2,0,2
202223,SATD075006,SCUOLA SECONDARIA II GRADO,4,27,26,1,0,1
202223,RMPS44500E,SCUOLA SECONDARIA II GRADO,5,25,24,1,0,1
202223,REPLP0500O,SCUOLA SECONDARIA II GRADO,2,13,13,0,0,0
202223,TO1E03500P,SCUOLA PRIMARIA,5,83,82,1,1,0
202223,RM1E086004,SCUOLA PRIMARIA,1,6,1,5,0,5
202223,PV1E003001,SCUOLA PRIMARIA,1,46,43,3,0,3
202223,RMPCT9500V,SCUOLA SECONDARIA II GRADO,1,4,4,0,0,0
202223,CERHP55001,SCUOLA SECONDARIA II GRADO,4,13,13,0,0,0
202223,RNTD02500G,SCUOLA SECONDARIA II GRADO,4,13,10,3,0,3
202223,NA1E355008,SCUOLA PRIMARIA,1,23,23,0,0,0
202223,UDPSBD500N,SCUOLA SECONDARIA II GRADO,5,28,28,0,0,0
202223,PA1E01500X,SCUOLA PRIMARIA,3,11,11,0,0,0
202223,MB1M020003,SCUOLA SECONDARIA I GRADO,1,42,40,2,2,0
202223,MI1M08000T,SCUOLA SECONDARIA I GRADO,2,124,117,7,0,7
202223,MO1E01000G,SCUOLA PRIMARIA,5,39,37,2,0,2
202223,BG1E001001,SCUOLA PRIMARIA,1,59,58,1,1,0
202223,TORI46500C,SCUOLA SECONDARIA II GRADO,4,7,7,0,0,0
202223,TO1E033003,SCUOLA PRIMARIA,4,51,51,0,0,0
202223,BO1M001004,SCUOLA SECONDARIA I GRADO,3,39,37,2,1,1
202223,TO1E038006,SCUOLA PRIMARIA,1,8,8,0,0,0
202223,VA1E01300Q,SCUOLA PRIMARIA,1,32,30,2,0,2
202223,BGRH005007,SCUOLA SECONDARIA II GRADO,3,18,18,0,0,0
202223,VR1ESU500Z,SCUOLA PRIMARIA,5,21,19,2,2,0
202223,BG1M008001,SCUOLA SECONDARIA I GRADO,1,46,46,0,0,0
202223,RMPM9P500H,SCUOLA SECONDARIA II GRADO,3,6,4,2,1,1
202223,NA1E03400C,SCUOLA PRIMARIA,2,62,61,1,0,1
202223,CORA025003,SCUOLA SECONDARIA II GRADO,5,18,18,0,0,0
202223,RM1E156005,SCUOLA PRIMARIA,2,16,16,0,0,0
202223,CO1M00200R,SCUOLA SECONDARIA I GRADO,2,54,54,0,0,0
202223,CAPS8T5007,SCUOLA SECONDARIA II GRADO,5,17,17,0,0,0
202223,MIPL0Z500D,SCUOLA SECONDARIA II GRADO,4,11,10,1,0,1
202223,FIPLFP5005,SCUOLA SECONDARIA II GRADO,1,21,9,12,0,12
202223,PD1E00200N,SCUOLA PRIMARIA,3,10,9,1,1,0
202223,MCPLMN500B,SCUOLA SECONDARIA II GRADO,1,2,0,2,0,2
202223,MITL485005,SCUOLA SECONDARIA II GRADO,1,38,33,5,0,5
202223,NATNCE5004,SCUOLA SECONDARIA II GRADO,3,1,1,0,0,0
202223,CA1E012007,SCUOLA PRIMARIA,5,32,30,2,1,1
202223,TO1E054004,SCUOLA PRIMARIA,3,17,17,0,0,0
202223,RMTNIF500Z,SCUOLA SECONDARIA II GRADO,2,2,1,1,0,1
202223,RM1E01200E,SCUOLA PRIMARIA,2,36,35,1,1,0
202223,BGPSRR5006,SCUOLA SECONDARIA II GRADO,2,27,27,0,0,0
202223,CE1E036006,SCUOLA PRIMARIA,2,11,5,6,1,5
202223,MEPS045007,SCUOLA SECONDARIA II GRADO,2,5,4,1,0,1
202223,BSPLPI500F,SCUOLA SECONDARIA II GRADO,1,15,15,0,0,0
202223,NATF6G5004,SCUOLA SECONDARIA II GRADO,2,11,11,0,0,0
202223,CSTD03500E,SCUOLA SECONDARIA II GRADO,4,2,2,0,0,0
202223,NAPMVM500H,SCUOLA SECONDARIA II GRADO,1,3,3,0,0,0
202223,BG1E02400N,SCUOLA PRIMARIA,4,15,15,0,0,0
202223,MIPS375001,SCUOLA SECONDARIA II GRADO,5,49,45,4,0,4
202223,MIPSDF5000,SCUOLA SECONDARIA II GRADO,2,42,42,0,0,0
202223,MITF11500N,SCUOLA SECONDARIA II GRADO,5,156,155,1,0,1
202223,MBPM145009,SCUOLA SECONDARIA II GRADO,2,17,17,0,0,0
202223,LCTB00500V,SCUOLA SECONDARIA II GRADO,3,7,6,1,0,1
202223,RGPL025009,SCUOLA SECONDARIA II GRADO,1,9,4,5,0,5
202223,VT1EM9500Q,SCUOLA PRIMARIA,2,10,10,0,0,0
202223,TO1E6M500I,SCUOLA PRIMARIA,5,28,23,5,2,3
202223,RM1E15800R,SCUOLA PRIMARIA,1,10,4,6,1,5
202223,NATF545002,SCUOLA SECONDARIA II GRADO,4,1,1,0,0,0
202223,CO1M02300T,SCUOLA SECONDARIA I GRADO,3,25,25,0,0,0
202223,GE1M03300E,SCUOLA SECONDARIA I GRADO,1,56,42,14,0,14
202223,CSTF6C500B,SCUOLA SECONDARIA II GRADO,4,2,2,0,0,0
202223,RMTD78500B,SCUOLA SECONDARIA II GRADO,5,10,10,0,0,0
202223,MB1EVP500T,SCUOLA PRIMARIA,1,25,25,0,0,0
202223,RMSL3E5005,SCUOLA SECONDARIA II GRADO,5,6,6,0,0,0
202223,RM1E19000L,SCUOLA PRIMARIA,2,24,24,0,0,0
202223,MI1M055005,SCUOLA SECONDARIA I GRADO,3,51,44,7,2,5
202223,VEPSAM500G,SCUOLA SECONDARIA II GRADO,1,9,9,0,0,0
202223,PN1M002009,SCUOLA SECONDARIA I GRADO,1,114,112,2,1,1
202223,RE1E008001,SCUOLA PRIMARIA,2,47,46,1,1,0
202223,MI1E01000A,SCUOLA PRIMARIA,3,34,32,2,1,1
202223,MI1E018001,SCUOLA PRIMARIA,1,22,21,1,0,1
202223,RGTD04500G,SCUOLA SECONDARIA II GRADO,3,3,2,1,0,1
202223,NARH065003,SCUOLA SECONDARIA II GRADO,1,8,8,0,0,0
202223,RM1E21400X,SCUOLA PRIMARIA,1,18,18,0,0,0
202223,CT1M00200E,SCUOLA SECONDARIA I GRADO,3,24,24,0,0,0
202223,RM1E056008,SCUOLA PRIMARIA,4,14,13,1,0,1
202223,CO1M019006,SCUOLA SECONDARIA I GRADO,1,29,29,0,0,0
202223,CE1E015005,SCUOLA PRIMARIA,3,14,12,2,0,2
202223,MBRFZ6500C,SCUOLA SECONDARIA II GRADO,3,21,20,1,0,1
202223,VAPSQF500T,SCUOLA SECONDARIA II GRADO,2,20,20,0,0,0
202223,AT1ENP5001,SCUOLA PRIMARIA,4,16,13,3,1,2
202223,NA1E194001,SCUOLA PRIMARIA,5,12,12,0,0,0
202223,VE1M6Q5004,SCUOLA SECONDARIA I GRADO,1,19,17,2,0,2
202223,RE1E00300T,SCUOLA PRIMARIA,5,43,41,2,2,0
202223,MI1E012002,SCUOLA PRIMARIA,4,15,10,5,0,5
202223,AGTD4U500B,SCUOLA SECONDARIA II GRADO,3,7,7,0,0,0
202223,RM1E10300L,SCUOLA PRIMARIA,3,53,53,0,0,0
202223,SATD4U500A,SCUOLA SECONDARIA II GRADO,4,6,6,0,0,0
202223,LC1E00500R,SCUOLA PRIMARIA,5,50,50,0,0,0
202223,CO1E00900A,SCUOLA PRIMARIA,2,14,13,1,0,1
202223,RC1M00500D,SCUOLA SECONDARIA I GRADO,2,3,2,1,1,0
202223,MIPLRL500B,SCUOLA SECONDARIA II GRADO,4,16,15,1,0,1
202223,NATDAT500E,SCUOLA SECONDARIA II GRADO,2,7,7,0,0,0
202223,MI1E038006,SCUOLA PRIMARIA,3,15,14,1,0,1
202223,MOPSMO5004,SCUOLA SECONDARIA II GRADO,3,12,11,1,1,0
202223,CHPMVZ5007,SCUOLA SECONDARIA II GRADO,4,5,5,0,0,0
202223,CA1E00800G,SCUOLA PRIMARIA,4,29,26,3,0,3
202223,NA1E18700T,SCUOLA PRIMARIA,3,22,16,6,5,1
202223,VIPS3I500B,SCUOLA SECONDARIA II GRADO,4,38,37,1,1,0
202223,CTTD315003,SCUOLA SECONDARIA II GRADO,2,5,5,0,0,0
202223,TV1E00200Q,SCUOLA PRIMARIA,1,58,49,9,0,9
202223,CE1E02500Q,SCUOLA PRIMARIA,4,13,12,1,0,1
202223,VI1E010002,SCUOLA PRIMARIA,3,18,15,3,0,3
202223,CETFAV500R,SCUOLA SECONDARIA II GRADO,3,9,8,1,0,1
202223,GRPS005002,SCUOLA SECONDARIA II GRADO,2,2,2,0,0,0
202223,BS1EU3500Q,SCUOLA PRIMARIA,3,29,24,5,0,5
202223,VRPS3P500M,SCUOLA SECONDARIA II GRADO,5,25,24,1,0,1
202223,RM1M082002,SCUOLA SECONDARIA I GRADO,3,23,22,1,0,1
202223,RMPS18500A,SCUOLA SECONDARIA II GRADO,2,8,8,0,0,0
202223,MIPSIG500R,SCUOLA SECONDARIA II GRADO,3,35,35,0,0,0
202223,BS1E016007,SCUOLA PRIMARIA,5,17,17,0,0,0
202223,MS1E00100B,SCUOLA PRIMARIA,2,20,20,0,0,0
202223,MS1EO3500D,SCUOLA PRIMARIA,5,9,8,1,0,1
202223,CETFS0500N,SCUOLA SECONDARIA II GRADO,5,70,70,0,0,0
202223,BSTN01500A,SCUOLA SECONDARIA II GRADO,5,16,15,1,1,0
202223,PVTL025009,SCUOLA SECONDARIA II GRADO,2,6,6,0,0,0
202223,RM1E163008,SCUOLA PRIMARIA,5,45,45,0,0,0
202223,MI1EGH5005,SCUOLA PRIMARIA,1,25,25,0,0,0
202223,LCPL025002,SCUOLA SECONDARIA II GRADO,1,12,12,0,0,0
202223,NAPMDC5007,SCUOLA SECONDARIA II GRADO,3,13,12,1,1,0
202223,FR1M003006,SCUOLA SECONDARIA I GRADO,2,8,8,0,0,0
202223,CTTF01500P,SCUOLA SECONDARIA II GRADO,1,3,3,0,0,0
202223,VA1M02100X,SCUOLA SECONDARIA I GRADO,3,6,6,0,0,0
202223,FI1E006004,SCUOLA PRIMARIA,3,27,26,1,0,1
202223,PR1M010004,SCUOLA SECONDARIA I GRADO,3,44,44,0,0,0
202223,PATD43500N,SCUOLA SECONDARIA II GRADO,3,14,14,0,0,0
202223,AQ1E00100E,SCUOLA PRIMARIA,3,19,19,0,0,0
202223,UD1E001008,SCUOLA PRIMARIA,1,12,12,0,0,0
202223,MIPS445002,SCUOLA SECONDARIA II GRADO,5,37,37,0,0,0
202223,BS1E003005,SCUOLA PRIMARIA,5,25,25,0,0,0
202223,NA1E214001,SCUOLA PRIMARIA,3,12,7,5,3,2
202223,NA1E22500B,SCUOLA PRIMARIA,4,18,16,2,0,2
202223,BS1E01200X,SCUOLA PRIMARIA,3,14,14,0,0,0
202223,RMTB035009,SCUOLA SECONDARIA II GRADO,2,47,36,11,5,6
202223,RM1E03800P,SCUOLA PRIMARIA,5,10,4,6,0,6
202223,TV1M00900Q,SCUOLA SECONDARIA I GRADO,1,36,36,0,0,0
202223,FO1M00500P,SCUOLA SECONDARIA I GRADO,1,19,18,1,1,0
202223,CTTD06500D,SCUOLA SECONDARIA II GRADO,2,1,1,0,0,0
202223,NARHHE500A,SCUOLA SECONDARIA II GRADO,2,2,2,0,0,0
202223,LU1EM35005,SCUOLA PRIMARIA,5,27,22,5,1,4
202223,TO1M04500E,SCUOLA SECONDARIA I GRADO,1,50,44,6,0,6
202223,TO1M00100R,SCUOLA SECONDARIA I GRADO,3,50,47,3,2,1
202223,FI1E01000Q,SCUOLA PRIMARIA,2,30,30,0,0,0
202223,VR1EEF5000,SCUOLA PRIMARIA,2,34,32,2,0,2
202223,SATFTV500U,SCUOLA SECONDARIA II GRADO,1,11,11,0,0,0
202223,GE1E033009,SCUOLA PRIMARIA,2,42,40,2,0,2
202223,RMPM7V500G,SCUOLA SECONDARIA II GRADO,2,24,24,0,0,0
202223,FIPSFU500L,SCUOLA SECONDARIA II GRADO,2,10,5,5,0,5
202223,AQ1E00600N,SCUOLA PRIMARIA,5,17,17,0,0,0
202223,CERH00500D,SCUOLA SECONDARIA II GRADO,3,13,11,2,0,2
202223,MI1M089008,SCUOLA SECONDARIA I GRADO,1,12,11,1,0,1
202223,RM1E04600N,SCUOLA PRIMARIA,2,18,17,1,0,1
202223,PERF71500A,SCUOLA SECONDARIA II GRADO,3,9,9,0,0,0
202223,GE1E01400X,SCUOLA PRIMARIA,3,17,17,0,0,0
202223,ALPMQR5008,SCUOLA SECONDARIA II GRADO,5,18,16,2,1,1
202223,CTSL0V500E,SCUOLA SECONDARIA II GRADO,2,11,10,1,1,0
202223,AGPC4A5009,SCUOLA SECONDARIA II GRADO,5,12,12,0,0,0
202223,NATDS2500B,SCUOLA SECONDARIA II GRADO,1,21,21,0,0,0
202223,TOPL66500H,SCUOLA SECONDARIA II GRADO,5,24,22,2,0,2
202223,NA1E270009,SCUOLA PRIMARIA,5,14,14,0,0,0
202223,FE1M00200P,SCUOLA SECONDARIA I GRADO,1,46,45,1,0,1
202223,BL1E00200B,SCUOLA PRIMARIA,5,40,40,0,0,0
202223,NA1E09700G,SCUOLA PRIMARIA,5,23,23,0,0,0
202223,AP1E005007,SCUOLA PRIMARIA,1,14,14,0,0,0
202223,NA1E23100P,SCUOLA PRIMARIA,2,14,14,0,0,0
202223,RM1E148006,SCUOLA PRIMARIA,3,40,40,0,0,0
202223,RM1E11000Q,SCUOLA PRIMARIA,1,33,33,0,0,0
202223,GEPS04500R,SCUOLA SECONDARIA II GRADO,2,35,35,0,0,0
202223,RM1M028009,SCUOLA SECONDARIA I GRADO,2,24,24,0,0,0
202223,MI1E04400D,SCUOLA PRIMARIA,4,23,22,1,1,0
202223,NATL265009,SCUOLA SECONDARIA II GRADO,1,5,5,0,0,0
202223,MI1E14100V,SCUOLA PRIMARIA,4,59,52,7,0,7
202223,SARFRL5003,SCUOLA SECONDARIA II GRADO,5,65,60,5,1,4
202223,CE1E043009,SCUOLA PRIMARIA,1,13,11,2,0,2
202223,PEPS0L5000,SCUOLA SECONDARIA II GRADO,1,15,15,0,0,0
202223,TS1E00500D,SCUOLA PRIMARIA,1,13,12,1,0,1
202223,ME1E01700T,SCUOLA PRIMARIA,3,9,9,0,0,0
202223,NA1M008005,SCUOLA SECONDARIA I GRADO,3,17,17,0,0,0
202223,VE1E00800P,SCUOLA PRIMARIA,5,26,26,0,0,0
202223,PR1E00300Q,SCUOLA PRIMARIA,2,13,11,2,0,2
202223,VBPM03500D,SCUOLA SECONDARIA II GRADO,3,15,15,0,0,0
202223,COPCCE5008,SCUOLA SECONDARIA II GRADO,4,15,14,1,0,1
202223,NA1E136001,SCUOLA PRIMARIA,1,14,13,1,0,1
202223,UD1E010003,SCUOLA PRIMARIA,5,20,20,0,0,0
202223,CT1E004001,SCUOLA PRIMARIA,3,24,21,3,0,3
202223,AT1MS75008,SCUOLA SECONDARIA I GRADO,1,14,14,0,0,0
202223,MB1M011008,SCUOLA SECONDARIA I GRADO,2,11,11,0,0,0
202223,AP1E00300G,SCUOLA PRIMARIA,1,13,12,1,0,1
202223,RM1E19600G,SCUOLA PRIMARIA,4,23,22,1,0,1
202223,SARIF2500L,SCUOLA SECONDARIA II GRADO,4,3,3,0,0,0
202223,RE1E00500D,SCUOLA PRIMARIA,5,39,36,3,1,2
202223,CS1E003002,SCUOLA PRIMARIA,4,19,19,0,0,0
202223,NA1E07700A,SCUOLA PRIMARIA,2,16,16,0,0,0
202223,TO1E016009,SCUOLA PRIMARIA,5,18,17,1,1,0
202223,RM1E06300B,SCUOLA PRIMARIA,2,33,33,0,0,0
202223,VVPS2U500I,SCUOLA SECONDARIA II GRADO,2,3,3,0,0,0
202223,VTPSP5500E,SCUOLA SECONDARIA II GRADO,2,3,3,0,0,0
202223,RM1E206001,SCUOLA PRIMARIA,5,21,21,0,0,0
202223,PO1M02000G,SCUOLA SECONDARIA I GRADO,3,68,57,11,0,11
202223,VC1E00200E,SCUOLA PRIMARIA,3,21,20,1,1,0
202223,BO1E005006,SCUOLA PRIMARIA,5,23,23,0,0,0
202223,RMPLB3500E,SCUOLA SECONDARIA II GRADO,4,7,7,0,0,0
202223,MIPM04500G,SCUOLA SECONDARIA II GRADO,4,28,28,0,0,0
202223,NATD59500D,SCUOLA SECONDARIA II GRADO,5,168,167,1,0,1
202223,SAPME1500D,SCUOLA SECONDARIA II GRADO,3,8,8,0,0,0
202223,BAPS035008,SCUOLA SECONDARIA II GRADO,2,4,4,0,0,0
202223,SA1M0B500F,SCUOLA SECONDARIA I GRADO,3,9,9,0,0,0
202223,RMPS485001,SCUOLA SECONDARIA II GRADO,1,6,4,2,1,1
202223,NOPC05500E,SCUOLA SECONDARIA II GRADO,1,57,56,1,0,1
202223,NA1E01100Q,SCUOLA PRIMARIA,3,8,8,0,0,0
202223,FI1M01200L,SCUOLA SECONDARIA I GRADO,3,23,19,4,0,4
202223,FIPCI25001,SCUOLA SECONDARIA II GRADO,3,21,21,0,0,0
202223,SATD295005,SCUOLA SECONDARIA II GRADO,2,8,8,0,0,0
202223,BG1M02100B,SCUOLA SECONDARIA I GRADO,2,20,20,0,0,0
202223,BS1MM05009,SCUOLA SECONDARIA I GRADO,3,16,15,1,0,1
202223,NA1E02500N,SCUOLA PRIMARIA,3,17,17,0,0,0
202223,COTAV75005,SCUOLA SECONDARIA II GRADO,3,22,22,0,0,0
202223,CO1E01100A,SCUOLA PRIMARIA,4,44,43,1,0,1
202223,TOPLRN500U,SCUOLA SECONDARIA II GRADO,3,6,5,1,0,1
202223,NA1E27800X,SCUOLA PRIMARIA,5,43,43,0,0,0
202223,CN1MMA500M,SCUOLA SECONDARIA I GRADO,1,29,27,2,0,2
202223,BLPM01500Q,SCUOLA SECONDARIA II GRADO,1,27,27,0,0,0
202223,FG1E02500R,SCUOLA PRIMARIA,4,20,19,1,0,1
202223,COTN025007,SCUOLA SECONDARIA II GRADO,5,26,26,0,0,0
202223,SAPMNI5000,SCUOLA SECONDARIA II GRADO,4,3,2,1,0,1
202223,BA1E026008,SCUOLA PRIMARIA,2,25,25,0,0,0
202223,BG1E005008,SCUOLA PRIMARIA,2,44,42,2,1,1
202223,TO1E04800R,SCUOLA PRIMARIA,4,13,13,0,0,0
202223,ME1E01200P,SCUOLA PRIMARIA,4,13,12,1,0,1
202223,BS1E0E500A,SCUOLA PRIMARIA,2,11,11,0,0,0
202223,VAPS4N5008,SCUOLA SECONDARIA II GRADO,3,17,17,0,0,0
202223,BS1M017008,SCUOLA SECONDARIA I GRADO,2,53,50,3,0,3
202223,RM1E163008,SCUOLA PRIMARIA,1,27,26,1,0,1
202223,RM1E128001,SCUOLA PRIMARIA,5,27,27,0,0,0
202223,MIPL245003,SCUOLA SECONDARIA II GRADO,4,5,5,0,0,0
202223,PC1MD1500G,SCUOLA SECONDARIA I GRADO,3,20,19,1,0,1
202223,GR1E00100D,SCUOLA PRIMARIA,1,23,23,0,0,0
202223,NA1E156006,SCUOLA PRIMARIA,3,9,7,2,0,2
202223,PVTD05500P,SCUOLA SECONDARIA II GRADO,1,9,9,0,0,0
202223,VI1M008007,SCUOLA SECONDARIA I GRADO,2,37,35,2,0,2
202223,TV1E01500T,SCUOLA PRIMARIA,2,50,50,0,0,0
202223,NA1E00900Q,SCUOLA PRIMARIA,5,17,16,1,0,1
202223,RGRHL4500A,SCUOLA SECONDARIA II GRADO,2,5,4,1,1,0
202223,BGPS505007,SCUOLA SECONDARIA II GRADO,4,22,22,0,0,0
202223,RM1E05400L,SCUOLA PRIMARIA,3,30,29,1,1,0
202223,TAPS02500A,SCUOLA SECONDARIA II GRADO,1,3,3,0,0,0
202223,CETDHG500L,SCUOLA SECONDARIA II GRADO,3,6,2,4,0,4
202223,BS1M00800D,SCUOLA SECONDARIA I GRADO,1,25,25,0,0,0
202223,VAPMV0500Q,SCUOLA SECONDARIA II GRADO,5,19,19,0,0,0
202223,VATF295009,SCUOLA SECONDARIA II GRADO,3,24,24,0,0,0
202223,PATD87500G,SCUOLA SECONDARIA II GRADO,5,51,51,0,0,0
202223,BG1E022002,SCUOLA PRIMARIA,3,20,20,0,0,0
202223,MB1M020003,SCUOLA SECONDARIA I GRADO,2,47,47,0,0,0
202223,RMPMSC500I,SCUOLA SECONDARIA II GRADO,2,17,15,2,1,1
202223,TO1E00700E,SCUOLA PRIMARIA,2,37,35,2,0,2
202223,RM1E16700G,SCUOLA PRIMARIA,1,24,24,0,0,0
202223,MI1E00800A,SCUOLA PRIMARIA,4,61,57,4,2,2
202223,GE1E00900C,SCUOLA PRIMARIA,5,23,23,0,0,0
202223,REPSRL500H,SCUOLA SECONDARIA II GRADO,5,6,5,1,0,1
202223,RGTD105002,SCUOLA SECONDARIA II GRADO,5,15,14,1,0,1
202223,RNPL01500X,SCUOLA SECONDARIA II GRADO,1,15,12,3,0,3
202223,PD1E021003,SCUOLA PRIMARIA,4,21,19,2,1,1
202223,PDPL02500A,SCUOLA SECONDARIA II GRADO,3,17,16,1,0,1
202223,PAPL6T500Q,SCUOLA SECONDARIA II GRADO,1,9,9,0,0,0
202223,CE1E016001,SCUOLA PRIMARIA,5,13,13,0,0,0
202223,FG1E01200P,SCUOLA PRIMARIA,4,25,25,0,0,0
202223,CERH4F500L,SCUOLA SECONDARIA II GRADO,1,8,8,0,0,0
202223,NA1E11000R,SCUOLA PRIMARIA,1,13,12,1,0,1
202223,RCTDPL500T,SCUOLA SECONDARIA II GRADO,1,4,4,0,0,0
202223,MO1E005004,SCUOLA PRIMARIA,3,39,34,5,0,5
202223,TOTD08500R,SCUOLA SECONDARIA II GRADO,4,13,13,0,0,0
202223,RM1E09600P,SCUOLA PRIMARIA,2,49,49,0,0,0
202223,FI1M008001,SCUOLA SECONDARIA I GRADO,3,14,13,1,1,0
202223,VA1E01900P,SCUOLA PRIMARIA,3,82,80,2,0,2
202223,BOTB02500D,SCUOLA SECONDARIA II GRADO,1,9,8,1,0,1
202223,NA1E205006,SCUOLA PRIMARIA,5,19,12,7,0,7
202223,LTTDPM500P,SCUOLA SECONDARIA II GRADO,5,45,37,8,2,6
202223,CT1M020004,SCUOLA SECONDARIA I GRADO,3,28,27,1,0,1
202223,PD1E019003,SCUOLA PRIMARIA,3,40,36,4,2,2
202223,RM1E114003,SCUOLA PRIMARIA,5,23,23,0,0,0
202223,RMPC185007,SCUOLA SECONDARIA II GRADO,2,28,28,0,0,0
202223,RM1M10900R,SCUOLA SECONDARIA I GRADO,3,25,23,2,0,2
202223,MITFDH5000,SCUOLA SECONDARIA II GRADO,1,29,29,0,0,0
202223,RM1M08300T,SCUOLA SECONDARIA I GRADO,3,19,19,0,0,0
202223,RMPSI6500C,SCUOLA SECONDARIA II GRADO,2,47,43,4,1,3
202223,NA1E19700C,SCUOLA PRIMARIA,1,29,29,0,0,0
202223,MI1M04300V,SCUOLA SECONDARIA I GRADO,2,48,45,3,2,1
202223,NAPMS6500L,SCUOLA SECONDARIA II GRADO,5,107,97,10,2,8
202223,MIPM0O500U,SCUOLA SECONDARIA II GRADO,1,22,20,2,0,2
202223,RM1E01200E,SCUOLA PRIMARIA,3,43,43,0,0,0
202223,CE1E03200V,SCUOLA PRIMARIA,4,16,12,4,1,3
202223,NARF6T500Q,SCUOLA SECONDARIA II GRADO,2,4,4,0,0,0
202223,MESL0P500H,SCUOLA SECONDARIA II GRADO,2,1,1,0,0,0
202223,BS1MM05009,SCUOLA SECONDARIA I GRADO,2,20,19,1,1,0
202223,ENRHA05008,SCUOLA SECONDARIA II GRADO,5,24,23,1,1,0
202223,BNTF2A500Q,SCUOLA SECONDARIA II GRADO,4,10,10,0,0,0
202223,VATB215007,SCUOLA SECONDARIA II GRADO,4,22,19,3,0,3
202223,MBPS8T500R,SCUOLA SECONDARIA II GRADO,1,29,29,0,0,0
202223,BLPS54500H,SCUOLA SECONDARIA II GRADO,3,22,22,0,0,0
202223,BG1E026009,SCUOLA PRIMARIA,5,20,19,1,0,1
202223,VRPC025006,SCUOLA SECONDARIA II GRADO,4,6,5,1,1,0
202223,RMSL3M5001,SCUOLA SECONDARIA II GRADO,2,11,11,0,0,0
202223,NATD455002,SCUOLA SECONDARIA II GRADO,4,3,3,0,0,0
202223,NA1E17000C,SCUOLA PRIMARIA,1,17,17,0,0,0
202223,LCPSU45004,SCUOLA SECONDARIA II GRADO,3,25,24,1,0,1
202223,MB1E03500G,SCUOLA PRIMARIA,4,41,38,3,2,1
202223,NAPC135007,SCUOLA SECONDARIA II GRADO,5,50,49,1,0,1
202223,NAPM05500Q,SCUOLA SECONDARIA II GRADO,2,29,28,1,0,1
202223,FRTD00500N,SCUOLA SECONDARIA II GRADO,1,3,2,1,0,1
202223,RNPS00500E,SCUOLA SECONDARIA II GRADO,3,17,16,1,0,1
202223,RM1E01000V,SCUOLA PRIMARIA,2,38,36,2,0,2
202223,CETF36500S,SCUOLA SECONDARIA II GRADO,4,10,10,0,0,0
202223,TO1M004008,SCUOLA SECONDARIA I GRADO,3,58,57,1,1,0
202223,PR1M00600C,SCUOLA SECONDARIA I GRADO,3,59,58,1,0,1
202223,VRPSN9500T,SCUOLA SECONDARIA II GRADO,1,20,18,2,1,1
202223,RCRH6N5009,SCUOLA SECONDARIA II GRADO,5,67,66,1,0,1
202223,NATD355005,SCUOLA SECONDARIA II GRADO,3,7,7,0,0,0
202223,MI1M056001,SCUOLA SECONDARIA I GRADO,1,35,34,1,0,1
202223,PI1E00300B,SCUOLA PRIMARIA,2,21,20,1,0,1
202223,MI1E012002,SCUOLA PRIMARIA,5,41,35,6,2,4
202223,GE1E02900N,SCUOLA PRIMARIA,2,20,20,0,0,0
202223,RGTD11500L,SCUOLA SECONDARIA II GRADO,5,18,17,1,1,0
202223,SA1E00200B,SCUOLA PRIMARIA,5,20,20,0,0,0
202223,NA1E04000Q,SCUOLA PRIMARIA,4,14,14,0,0,0
202223,VR1E01400N,SCUOLA PRIMARIA,3,25,25,0,0,0
202223,UD1E00300X,SCUOLA PRIMARIA,2,17,16,1,1,0
202223,NA1E12600A,SCUOLA PRIMARIA,1,10,10,0,0,0
202223,BNRHN2500D,SCUOLA SECONDARIA II GRADO,5,138,137,1,0,1
202223,CE1ELF5000,SCUOLA PRIMARIA,5,19,19,0,0,0
202223,BR1E00200T,SCUOLA PRIMARIA,1,11,11,0,0,0
202223,NA1E21000N,SCUOLA PRIMARIA,5,37,36,1,0,1
202223,BS1E00100D,SCUOLA PRIMARIA,3,24,21,3,0,3
202223,CRPS02500L,SCUOLA SECONDARIA II GRADO,3,20,20,0,0,0
202223,LITD02500G,SCUOLA SECONDARIA II GRADO,5,46,43,3,0,3
202223,AGTA6O500F,SCUOLA SECONDARIA II GRADO,2,3,3,0,0,0
202223,SP1E003004,SCUOLA PRIMARIA,4,19,19,0,0,0
202223,PG1E001003,SCUOLA PRIMARIA,4,16,16,0,0,0
202223,ANPS00500T,SCUOLA SECONDARIA II GRADO,1,5,5,0,0,0
202223,PGPC00500C,SCUOLA SECONDARIA II GRADO,1,1,1,0,0,0
202223,SA1E018001,SCUOLA PRIMARIA,4,8,8,0,0,0
202223,SSPS02500V,SCUOLA SECONDARIA II GRADO,4,2,2,0,0,0
202223,NA1E031001,SCUOLA PRIMARIA,3,25,25,0,0,0
202223,VR1M01100B,SCUOLA SECONDARIA I GRADO,2,15,14,1,0,1
202223,PAPC12500D,SCUOLA SECONDARIA II GRADO,1,32,32,0,0,0
202223,BSSL01500D,SCUOLA SECONDARIA II GRADO,5,27,26,1,0,1
202223,MI1E059007,SCUOLA PRIMARIA,4,44,42,2,0,2
202223,MI1E07300D,SCUOLA PRIMARIA,1,34,33,1,0,1
202223,CA1E00200L,SCUOLA PRIMARIA,5,18,18,0,0,0
202223,RM1E028004,SCUOLA PRIMARIA,1,19,19,0,0,0
202223,SRRHFP500H,SCUOLA SECONDARIA II GRADO,4,3,3,0,0,0
202223,FI1E02400N,SCUOLA PRIMARIA,1,15,14,1,0,1
202223,SSPQC7500O,SCUOLA SECONDARIA II GRADO,1,4,3,1,0,1
202223,BS1M00100P,SCUOLA SECONDARIA I GRADO,1,26,25,1,0,1
202223,SSTD00500D,SCUOLA SECONDARIA II GRADO,5,10,10,0,0,0
202223,VR1M01700A,SCUOLA SECONDARIA I GRADO,1,29,29,0,0,0
202223,TVPL07500D,SCUOLA SECONDARIA II GRADO,1,3,3,0,0,0
202223,BO1E012009,SCUOLA PRIMARIA,5,53,49,4,1,3
202223,VRTD04500A,SCUOLA SECONDARIA II GRADO,4,21,19,2,1,1
202223,AVTF6H500N,SCUOLA SECONDARIA II GRADO,5,36,33,3,0,3
202223,NA1E242005,SCUOLA PRIMARIA,5,12,10,2,0,2
202223,RM1E126009,SCUOLA PRIMARIA,2,16,15,1,0,1
202223,NA1E26100E,SCUOLA PRIMARIA,3,13,13,0,0,0
202223,BGTFMP5003,SCUOLA SECONDARIA II GRADO,4,12,11,1,1,0
202223,BI1M01000N,SCUOLA SECONDARIA I GRADO,3,8,8,0,0,0
202223,CT1E02100P,SCUOLA PRIMARIA,1,7,7,0,0,0
202223,RM1MZQ500O,SCUOLA SECONDARIA I GRADO,2,16,16,0,0,0
202223,MIPSO8500I,SCUOLA SECONDARIA II GRADO,1,16,16,0,0,0
202223,ANRFBS500Z,SCUOLA SECONDARIA II GRADO,1,2,2,0,0,0
202223,MBPS67500C,SCUOLA SECONDARIA II GRADO,2,22,22,0,0,0
202223,CHTD07500E,SCUOLA SECONDARIA II GRADO,5,4,3,1,1,0
202223,RN1E007001,SCUOLA PRIMARIA,3,19,19,0,0,0
202223,SAPSM3500V,SCUOLA SECONDARIA II GRADO,4,7,7,0,0,0
202223,PE1E009003,SCUOLA PRIMARIA,5,25,25,0,0,0
202223,CE1E049008,SCUOLA PRIMARIA,5,11,10,1,1,0
202223,TA1E003008,SCUOLA PRIMARIA,2,13,13,0,0,0
202223,PO1E01100G,SCUOLA PRIMARIA,3,25,23,2,0,2
202223,FO1E00400N,SCUOLA PRIMARIA,2,48,47,1,0,1
202223,MITD73500S,SCUOLA SECONDARIA II GRADO,2,17,16,1,0,1
202223,NATF34500R,SCUOLA SECONDARIA II GRADO,2,5,4,1,1,0
202223,BO1E01000N,SCUOLA PRIMARIA,4,26,24,2,0,2
202223,GE1E033009,SCUOLA PRIMARIA,3,32,27,5,0,5
202223,MIPC06500L,SCUOLA SECONDARIA II GRADO,1,29,29,0,0,0
202223,MI1E12000T,SCUOLA PRIMARIA,5,16,16,0,0,0
202223,RMTD43500Q,SCUOLA SECONDARIA II GRADO,4,2,2,0,0,0
202223,RMSLBH500V,SCUOLA SECONDARIA II GRADO,5,38,37,1,1,0
202223,NARIPC5009,SCUOLA SECONDARIA II GRADO,5,47,47,0,0,0
202223,BGPS12500G,SCUOLA SECONDARIA II GRADO,2,9,8,1,0,1
202223,CS1M00100G,SCUOLA SECONDARIA I GRADO,2,16,16,0,0,0
202223,CSTD03500E,SCUOLA SECONDARIA II GRADO,1,2,2,0,0,0
202223,TO1E02600X,SCUOLA PRIMARIA,1,30,25,5,1,4
202223,RM1E073002,SCUOLA PRIMARIA,3,37,35,2,2,0
202223,VA1E00600L,SCUOLA PRIMARIA,5,14,14,0,0,0
202223,LU1E002008,SCUOLA PRIMARIA,4,14,14,0,0,0
202223,NA1ESQ5001,SCUOLA PRIMARIA,5,4,4,0,0,0
202223,BSPSO5500G,SCUOLA SECONDARIA II GRADO,3,18,18,0,0,0
202223,VE1E006003,SCUOLA PRIMARIA,4,40,37,3,2,1
202223,SATL04500R,SCUOLA SECONDARIA II GRADO,2,10,10,0,0,0
202223,CO1EMI5009,SCUOLA PRIMARIA,4,16,16,0,0,0
202223,FIPM69500H,SCUOLA SECONDARIA II GRADO,1,10,10,0,0,0
202223,RMPL355003,SCUOLA SECONDARIA II GRADO,3,7,4,3,0,3
202223,PA1E006005,SCUOLA PRIMARIA,3,12,11,1,0,1
202223,RCTD5M5009,SCUOLA SECONDARIA II GRADO,4,11,11,0,0,0
202223,MIPS42500R,SCUOLA SECONDARIA II GRADO,5,58,56,2,0,2
202223,LOPS01500A,SCUOLA SECONDARIA II GRADO,5,8,8,0,0,0
202223,RM1E043006,SCUOLA PRIMARIA,3,37,36,1,0,1
202223,RMPS355008,SCUOLA SECONDARIA II GRADO,1,39,38,1,0,1
202223,AL1M00400B,SCUOLA SECONDARIA I GRADO,1,10,9,1,1,0
202223,MIPM1R500Q,SCUOLA SECONDARIA II GRADO,1,24,23,1,0,1
202223,FI1E06200C,SCUOLA PRIMARIA,5,54,49,5,0,5
202223,MIPS055005,SCUOLA SECONDARIA II GRADO,5,51,49,2,0,2
202223,PV1E00600C,SCUOLA PRIMARIA,5,15,13,2,1,1
202223,RM1EII500V,SCUOLA PRIMARIA,1,4,4,0,0,0
202223,NARHA8500Q,SCUOLA SECONDARIA II GRADO,5,137,136,1,0,1
202223,NATDLM500R,SCUOLA SECONDARIA II GRADO,4,18,17,1,0,1
202223,VA1E003005,SCUOLA PRIMARIA,3,15,15,0,0,0
202223,RM1E13100R,SCUOLA PRIMARIA,4,23,20,3,1,2
202223,CE1E008002,SCUOLA PRIMARIA,4,21,20,1,0,1
202223,RMPST6500P,SCUOLA SECONDARIA II GRADO,3,20,19,1,1,0
202223,MI1E04400D,SCUOLA PRIMARIA,5,20,20,0,0,0
202223,RA1M00200R,SCUOLA SECONDARIA I GRADO,2,53,47,6,3,3
202223,BO1M01000V,SCUOLA SECONDARIA I GRADO,2,23,22,1,0,1
202223,RM1EQM5004,SCUOLA PRIMARIA,4,21,21,0,0,0
202223,AVPSPT500F,SCUOLA SECONDARIA II GRADO,2,2,2,0,0,0
202223,COSL02500A,SCUOLA SECONDARIA II GRADO,3,1,0,1,0,1
202223,MI1M10600R,SCUOLA SECONDARIA I GRADO,1,6,4,2,1,1
202223,TOPQ475003,SCUOLA SECONDARIA II GRADO,2,7,6,1,1,0
202223,RM1E13900B,SCUOLA PRIMARIA,5,15,15,0,0,0
202223,PATD33500R,SCUOLA SECONDARIA II GRADO,5,24,24,0,0,0
202223,RMRFB3500L,SCUOLA SECONDARIA II GRADO,2,2,2,0,0,0
202223,NATL83500Z,SCUOLA SECONDARIA II GRADO,3,2,2,0,0,0
202223,PVPL045003,SCUOLA SECONDARIA II GRADO,5,10,10,0,0,0
202223,NA1E00400L,SCUOLA PRIMARIA,3,11,8,3,0,3
202223,PVPMF55003,SCUOLA SECONDARIA II GRADO,2,7,6,1,0,1
202223,APPSL05000,SCUOLA SECONDARIA II GRADO,3,4,4,0,0,0
202223,MI1E14300E,SCUOLA PRIMARIA,2,12,8,4,1,3
202223,NA1E065004,SCUOLA PRIMARIA,2,11,5,6,0,6
202223,CE1E044005,SCUOLA PRIMARIA,4,19,19,0,0,0
202223,TV1EDQ500C,SCUOLA PRIMARIA,3,21,21,0,0,0
202223,FRTFF6500V,SCUOLA SECONDARIA II GRADO,2,2,2,0,0,0
202223,VAPL06500C,SCUOLA SECONDARIA II GRADO,2,8,5,3,2,1
202223,VE1E00100X,SCUOLA PRIMARIA,5,19,17,2,1,1
202223,CETF8R5001,SCUOLA SECONDARIA II GRADO,2,9,9,0,0,0
202223,TO1EDV500F,SCUOLA PRIMARIA,3,13,12,1,0,1
202223,FI1E005008,SCUOLA PRIMARIA,4,17,15,2,0,2
202223,FI1E019006,SCUOLA PRIMARIA,4,25,21,4,0,4
202223,COPS04500P,SCUOLA SECONDARIA II GRADO,1,11,11,0,0,0
202223,NA1E13700R,SCUOLA PRIMARIA,4,12,12,0,0,0
202223,BG1E02000A,SCUOLA PRIMARIA,4,21,20,1,0,1
202223,AR1E006008,SCUOLA PRIMARIA,4,15,14,1,0,1
202223,RMPS285007,SCUOLA SECONDARIA II GRADO,3,3,3,0,0,0
202223,MBPS245005,SCUOLA SECONDARIA II GRADO,3,9,9,0,0,0
202223,NA1E07000G,SCUOLA PRIMARIA,1,40,35,5,0,5
202223,NA1E07700A,SCUOLA PRIMARIA,4,14,14,0,0,0
202223,RM1E09000Q,SCUOLA PRIMARIA,2,24,23,1,0,1
202223,TV1E01700D,SCUOLA PRIMARIA,4,45,45,0,0,0
202223,RGPM00500A,SCUOLA SECONDARIA II GRADO,1,3,3,0,0,0
202223,FRTD5O500I,SCUOLA SECONDARIA II GRADO,5,130,120,10,1,9
202223,LTPM4Q5001,SCUOLA SECONDARIA II GRADO,4,6,6,0,0,0
202223,CETD4C500S,SCUOLA SECONDARIA II GRADO,2,7,6,1,0,1
202223,VE1M006008,SCUOLA SECONDARIA I GRADO,3,23,17,6,2,4
202223,FI1E013007,SCUOLA PRIMARIA,5,18,17,1,0,1
202223,SATFU9500P,SCUOLA SECONDARIA II GRADO,1,3,3,0,0,0
202223,SATFP3500G,SCUOLA SECONDARIA II GRADO,3,10,8,2,0,2
202223,NATF2E500L,SCUOLA SECONDARIA II GRADO,3,9,9,0,0,0
202223,GE1M01700L,SCUOLA SECONDARIA I GRADO,2,39,33,6,1,5
202223,RMPLUU500N,SCUOLA SECONDARIA II GRADO,1,13,12,1,0,1
202223,CN1MMA500M,SCUOLA SECONDARIA I GRADO,2,22,20,2,1,1
202223,PA1E007001,SCUOLA PRIMARIA,3,12,12,0,0,0
202223,BA1E018009,SCUOLA PRIMARIA,5,46,46,0,0,0
202223,CAPQ00500E,SCUOLA SECONDARIA II GRADO,5,21,19,2,1,1
202223,TORI05500A,SCUOLA SECONDARIA II GRADO,4,3,3,0,0,0
202223,RMPS54500B,SCUOLA SECONDARIA II GRADO,4,2,2,0,0,0
202223,TV1M002001,SCUOLA SECONDARIA I GRADO,3,34,31,3,0,3
202223,SIPS01500C,SCUOLA SECONDARIA II GRADO,2,11,10,1,0,1
202223,BOPSHR500B,SCUOLA SECONDARIA II GRADO,5,27,27,0,0,0
202223,VA1E011004,SCUOLA PRIMARIA,3,21,21,0,0,0
202223,NARF2D500G,SCUOLA SECONDARIA II GRADO,5,56,53,3,0,3
202223,BS1M017008,SCUOLA SECONDARIA I GRADO,3,41,40,1,0,1
202223,PAPC07500N,SCUOLA SECONDARIA II GRADO,1,4,4,0,0,0
202223,AVTFN9500H,SCUOLA SECONDARIA II GRADO,5,34,32,2,1,1
202223,TOPS20500T,SCUOLA SECONDARIA II GRADO,3,30,28,2,1,1
202223,NATF215004,SCUOLA SECONDARIA II GRADO,2,10,10,0,0,0
202223,RM1MQH500U,SCUOLA SECONDARIA I GRADO,2,17,15,2,0,2
202223,MBTD35500C,SCUOLA SECONDARIA II GRADO,2,18,16,2,0,2
202223,NA1E086005,SCUOLA PRIMARIA,5,38,37,1,0,1
202223,NAPS7Q5000,SCUOLA SECONDARIA II GRADO,2,9,9,0,0,0
202223,BA1MD7500G,SCUOLA SECONDARIA I GRADO,3,10,10,0,0,0
202223,CN1E00200V,SCUOLA PRIMARIA,1,25,25,0,0,0
202223,NO1M01400B,SCUOLA SECONDARIA I GRADO,2,18,17,1,0,1
202223,RM1E100005,SCUOLA PRIMARIA,5,21,21,0,0,0
202223,RM1M01400B,SCUOLA SECONDARIA I GRADO,2,28,28,0,0,0
202223,SATDVQ500D,SCUOLA SECONDARIA II GRADO,1,6,6,0,0,0
202223,SATD30500E,SCUOLA SECONDARIA II GRADO,4,11,11,0,0,0
202223,KR1E002001,SCUOLA PRIMARIA,5,10,3,7,4,3
202223,PR1M003001,SCUOLA SECONDARIA I GRADO,1,53,50,3,1,2
202223,RARI015004,SCUOLA SECONDARIA II GRADO,1,3,3,0,0,0
202223,AVTF125004,SCUOLA SECONDARIA II GRADO,2,8,8,0,0,0
202223,MI1MP35007,SCUOLA SECONDARIA I GRADO,3,30,29,1,0,1
202223,MIPCCH5001,SCUOLA SECONDARIA II GRADO,4,18,17,1,0,1
202223,TO1MSF500T,SCUOLA SECONDARIA I GRADO,1,34,33,1,0,1
202223,PCPM79500U,SCUOLA SECONDARIA II GRADO,3,18,16,2,1,1
202223,RM1M074003,SCUOLA SECONDARIA I GRADO,2,77,75,2,1,1
202223,NAPS045004,SCUOLA SECONDARIA II GRADO,1,17,17,0,0,0
202223,NAPS4U500S,SCUOLA SECONDARIA II GRADO,4,20,18,2,0,2
202223,NA1E08900L,SCUOLA PRIMARIA,4,17,16,1,0,1
202223,RA1E00100Q,SCUOLA PRIMARIA,5,34,32,2,1,1
202223,MB1E032004,SCUOLA PRIMARIA,5,16,16,0,0,0
202223,SAPS11500B,SCUOLA SECONDARIA II GRADO,5,28,22,6,0,6
202223,VIPLVN5005,SCUOLA SECONDARIA II GRADO,2,9,8,1,0,1
202223,PATD12500C,SCUOLA SECONDARIA II GRADO,4,10,10,0,0,0
202223,CZ1E00400N,SCUOLA PRIMARIA,4,4,4,0,0,0
202223,MITF005006,SCUOLA SECONDARIA II GRADO,2,72,54,18,1,17
202223,TO1M02300N,SCUOLA SECONDARIA I GRADO,1,71,71,0,0,0
202223,VAPMCL500Q,SCUOLA SECONDARIA II GRADO,4,21,21,0,0,0
202223,CTPSPS5003,SCUOLA SECONDARIA II GRADO,2,15,15,0,0,0
202223,VT1E002002,SCUOLA PRIMARIA,5,24,23,1,0,1
202223,VRPS025009,SCUOLA SECONDARIA II GRADO,1,86,84,2,0,2
202223,TO1E01400N,SCUOLA PRIMARIA,2,25,25,0,0,0
202223,NATANI5007,SCUOLA SECONDARIA II GRADO,5,140,140,0,0,0
202223,NA1E07000G,SCUOLA PRIMARIA,2,20,18,2,0,2
202223,MI1M071003,SCUOLA SECONDARIA I GRADO,2,14,14,0,0,0
202223,MI1EAE500E,SCUOLA PRIMARIA,2,21,20,1,1,0
202223,SR1E00600R,SCUOLA PRIMARIA,1,21,21,0,0,0
202223,FR1E010004,SCUOLA PRIMARIA,4,11,10,1,0,1
202223,PAPS05500G,SCUOLA SECONDARIA II GRADO,4,25,25,0,0,0
202223,RNTL025002,SCUOLA SECONDARIA II GRADO,3,5,5,0,0,0
202223,NARHZ5500Q,SCUOLA SECONDARIA II GRADO,2,9,9,0,0,0
202223,NA1E028005,SCUOLA PRIMARIA,5,11,11,0,0,0
202223,CTPS09500D,SCUOLA SECONDARIA II GRADO,3,3,3,0,0,0
202223,FITB015001,SCUOLA SECONDARIA II GRADO,5,10,10,0,0,0
202223,NA1E106005,SCUOLA PRIMARIA,2,21,21,0,0,0
202223,RM1M114008,SCUOLA SECONDARIA I GRADO,1,37,37,0,0,0
202223,NA1E218008,SCUOLA PRIMARIA,2,15,15,0,0,0
202223,CR1E00900D,SCUOLA PRIMARIA,4,33,32,1,0,1
202223,TPTD80500R,SCUOLA SECONDARIA II GRADO,5,25,24,1,0,1
202223,BG1E00700X,SCUOLA PRIMARIA,5,49,47,2,1,1
202223,CA1E019002,SCUOLA PRIMARIA,4,10,9,1,0,1
202223,VEPL4H500R,SCUOLA SECONDARIA II GRADO,4,6,6,0,0,0
202223,TO1E03600E,SCUOLA PRIMARIA,1,40,21,19,7,12
202223,FI1E06200C,SCUOLA PRIMARIA,1,67,55,12,1,11
202223,SA1E011006,SCUOLA PRIMARIA,3,14,13,1,1,0
202223,RMPC29500P,SCUOLA SECONDARIA II GRADO,3,20,20,0,0,0
202223,CTPC01500D,SCUOLA SECONDARIA II GRADO,3,12,12,0,0,0
202223,BGPL055009,SCUOLA SECONDARIA II GRADO,2,12,12,0,0,0
202223,VR1E02100R,SCUOLA PRIMARIA,2,42,38,4,1,3
202223,VR1E017005,SCUOLA PRIMARIA,3,19,19,0,0,0
202223,RM1E126009,SCUOLA PRIMARIA,5,21,21,0,0,0
202223,CERHD15005,SCUOLA SECONDARIA II GRADO,2,11,11,0,0,0
202223,MI1E04200T,SCUOLA PRIMARIA,3,47,45,2,0,2
202223,RM1M09900B,SCUOLA SECONDARIA I GRADO,2,84,83,1,0,1
202223,NATL16500C,SCUOLA SECONDARIA II GRADO,2,4,4,0,0,0
202223,CRPL01500R,SCUOLA SECONDARIA II GRADO,4,9,9,0,0,0
202223,NO1E001004,SCUOLA PRIMARIA,2,28,26,2,0,2
202223,RMTN8V500Q,SCUOLA SECONDARIA II GRADO,1,2,2,0,0,0
202223,MB1E07100P,SCUOLA PRIMARIA,5,43,42,1,0,1
202223,SA1E02200L,SCUOLA PRIMARIA,3,17,17,0,0,0
202223,PG1E00300P,SCUOLA PRIMARIA,5,17,16,1,0,1
202223,PETF005003,SCUOLA SECONDARIA II GRADO,2,8,6,2,0,2
202223,BGRH005007,SCUOLA SECONDARIA II GRADO,2,14,14,0,0,0
202223,MERH015005,SCUOLA SECONDARIA II GRADO,3,3,3,0,0,0
202223,SSTD02500P,SCUOLA SECONDARIA II GRADO,4,3,3,0,0,0
202223,CZ1M002007,SCUOLA SECONDARIA I GRADO,3,18,18,0,0,0
202223,NA1E130002,SCUOLA PRIMARIA,1,21,21,0,0,0
202223,BNTDDC500S,SCUOLA SECONDARIA II GRADO,3,9,9,0,0,0
202223,NA1E10800R,SCUOLA PRIMARIA,4,37,36,1,0,1
202223,NATD53500N,SCUOLA SECONDARIA II GRADO,3,14,14,0,0,0
202223,CT1E053006,SCUOLA PRIMARIA,1,16,16,0,0,0
202223,VR1M92500T,SCUOLA SECONDARIA I GRADO,3,22,21,1,0,1
202223,NAPSF2500E,SCUOLA SECONDARIA II GRADO,3,9,8,1,0,1
202223,CR1E00800N,SCUOLA PRIMARIA,1,27,24,3,1,2
202223,VR1E00600P,SCUOLA PRIMARIA,2,43,40,3,1,2
202223,CSPM04500A,SCUOLA SECONDARIA II GRADO,4,13,13,0,0,0
202223,RMTNIF500Z,SCUOLA SECONDARIA II GRADO,3,4,4,0,0,0
202223,NAPLIA500F,SCUOLA SECONDARIA II GRADO,1,11,11,0,0,0
202223,MB1E09200Q,SCUOLA PRIMARIA,1,35,34,1,0,1
202223,RGPM05500B,SCUOLA SECONDARIA II GRADO,5,19,18,1,0,1
202223,RM1E01100P,SCUOLA PRIMARIA,5,20,19,1,0,1
202223,MEPS01500B,SCUOLA SECONDARIA II GRADO,5,7,6,1,1,0
202223,SV1E00400A,SCUOLA PRIMARIA,5,15,15,0,0,0
202223,NATF6G5004,SCUOLA SECONDARIA II GRADO,1,13,12,1,0,1
202223,UDPS01500B,SCUOLA SECONDARIA II GRADO,5,23,23,0,0,0
202223,MI1E083004,SCUOLA PRIMARIA,3,45,42,3,0,3
202223,BNTFOA500V,SCUOLA SECONDARIA II GRADO,4,7,7,0,0,0
202223,VRTF265002,SCUOLA SECONDARIA II GRADO,5,25,25,0,0,0
202223,CT1E010008,SCUOLA PRIMARIA,1,10,5,5,0,5
202223,MIPSPS500G,SCUOLA SECONDARIA II GRADO,4,11,11,0,0,0
202223,TATD055002,SCUOLA SECONDARIA II GRADO,5,50,49,1,0,1
202223,MI1E00700E,SCUOLA PRIMARIA,5,52,51,1,0,1
202223,RG1E00700Q,SCUOLA PRIMARIA,5,22,22,0,0,0
202223,VA1E01500B,SCUOLA PRIMARIA,3,43,41,2,1,1
202223,VATN01500A,SCUOLA SECONDARIA II GRADO,2,8,8,0,0,0
202223,NA1E05400N,SCUOLA PRIMARIA,2,48,48,0,0,0
202223,CO1M02300T,SCUOLA SECONDARIA I GRADO,2,25,25,0,0,0
202223,GE1M030003,SCUOLA SECONDARIA I GRADO,3,25,25,0,0,0
202223,CE1E015005,SCUOLA PRIMARIA,1,11,10,1,0,1
202223,UD1M009004,SCUOLA SECONDARIA I GRADO,3,10,9,1,0,1
202223,MB1EQT500D,SCUOLA PRIMARIA,4,23,22,1,0,1
202223,TO1E032007,SCUOLA PRIMARIA,1,12,12,0,0,0
202223,RM1E078005,SCUOLA PRIMARIA,2,35,31,4,2,2
202223,SA1E02600X,SCUOLA PRIMARIA,5,16,16,0,0,0
202223,LT1E00400C,SCUOLA PRIMARIA,5,6,6,0,0,0
202223,CERI59500T,SCUOLA SECONDARIA II GRADO,4,11,11,0,0,0
202223,RM1ES55005,SCUOLA PRIMARIA,5,22,22,0,0,0
202223,IM1E00600C,SCUOLA PRIMARIA,4,14,14,0,0,0
202223,LC1E008008,SCUOLA PRIMARIA,5,17,17,0,0,0
202223,MI1E07700R,SCUOLA PRIMARIA,1,27,26,1,0,1
202223,BG1M02500P,SCUOLA SECONDARIA I GRADO,3,38,38,0,0,0
202223,CTRCQ5500S,SCUOLA SECONDARIA II GRADO,1,3,2,1,1,0
202223,PD1E01000L,SCUOLA PRIMARIA,3,45,45,0,0,0
202223,MI1E06400P,SCUOLA PRIMARIA,1,25,21,4,1,3
202223,NA1E19000N,SCUOLA PRIMARIA,1,18,18,0,0,0
202223,ME1EOF500O,SCUOLA PRIMARIA,5,42,42,0,0,0
202223,RM1M00600C,SCUOLA SECONDARIA I GRADO,3,44,44,0,0,0
202223,BGSLQP500D,SCUOLA SECONDARIA II GRADO,4,8,8,0,0,0
202223,LC1E002009,SCUOLA PRIMARIA,5,54,54,0,0,0
202223,TVPM8T500U,SCUOLA SECONDARIA II GRADO,3,27,27,0,0,0
202223,COPSI65000,SCUOLA SECONDARIA II GRADO,5,13,13,0,0,0
202223,CO1E00800E,SCUOLA PRIMARIA,5,33,27,6,2,4
202223,NA1E25300G,SCUOLA PRIMARIA,1,16,16,0,0,0
202223,FE1E00200D,SCUOLA PRIMARIA,3,22,21,1,1,0
202223,FG1E010003,SCUOLA PRIMARIA,2,21,21,0,0,0
202223,BG1E01800A,SCUOLA PRIMARIA,3,17,17,0,0,0
202223,PV1E775009,SCUOLA PRIMARIA,1,9,8,1,0,1
202223,MN1E001004,SCUOLA PRIMARIA,5,11,9,2,0,2
202223,RMSL015004,SCUOLA SECONDARIA II GRADO,4,23,21,2,0,2
202223,CL1E00400X,SCUOLA PRIMARIA,3,21,21,0,0,0
202223,RA1E004007,SCUOLA PRIMARIA,4,47,45,2,2,0
202223,NA1MVQ500R,SCUOLA SECONDARIA I GRADO,2,7,7,0,0,0
202223,MI1E02100R,SCUOLA PRIMARIA,2,17,16,1,0,1
202223,PE1E002008,SCUOLA PRIMARIA,4,16,16,0,0,0
202223,VIPS01500A,SCUOLA SECONDARIA II GRADO,3,7,7,0,0,0
202223,ME1E00400Q,SCUOLA PRIMARIA,5,16,16,0,0,0
202223,MITDOT5002,SCUOLA SECONDARIA II GRADO,1,7,6,1,1,0
202223,BSPS125004,SCUOLA SECONDARIA II GRADO,4,14,13,1,1,0
202223,RMRH12500C,SCUOLA SECONDARIA II GRADO,4,10,8,2,2,0
202223,ATPL01500N,SCUOLA SECONDARIA II GRADO,5,10,10,0,0,0
202223,MIPS43500B,SCUOLA SECONDARIA II GRADO,1,31,30,1,0,1
202223,BS1E00600L,SCUOLA PRIMARIA,3,54,51,3,0,3
202223,BS1E016007,SCUOLA PRIMARIA,3,22,22,0,0,0
202223,VI1E00300V,SCUOLA PRIMARIA,4,24,23,1,0,1
202223,RMPS36500V,SCUOLA SECONDARIA II GRADO,3,10,10,0,0,0
202223,TV1M01100Q,SCUOLA SECONDARIA I GRADO,1,92,91,1,0,1
202223,RM1E08200R,SCUOLA PRIMARIA,4,14,9,5,0,5
202223,RMPL0L500V,SCUOLA SECONDARIA II GRADO,3,10,10,0,0,0
202223,VAPLB6500A,SCUOLA SECONDARIA II GRADO,1,7,6,1,0,1
202223,LTTD01500X,SCUOLA SECONDARIA II GRADO,5,15,15,0,0,0
202223,LU1M8R500T,SCUOLA SECONDARIA I GRADO,2,25,16,9,0,9
202223,NA1E8R5008,SCUOLA PRIMARIA,1,12,12,0,0,0
202223,BSPS06500N,SCUOLA SECONDARIA II GRADO,2,39,39,0,0,0
202223,NA1M03900R,SCUOLA SECONDARIA I GRADO,2,23,22,1,0,1
202223,BSPS6Z5004,SCUOLA SECONDARIA II GRADO,1,26,24,2,0,2
202223,FI1E00700X,SCUOLA PRIMARIA,4,17,15,2,0,2
202223,SATLRU500B,SCUOLA SECONDARIA II GRADO,4,6,5,1,1,0
202223,GE1E039008,SCUOLA PRIMARIA,2,29,27,2,0,2
202223,RMTB035009,SCUOLA SECONDARIA II GRADO,3,50,46,4,2,2
202223,MB1M01500G,SCUOLA SECONDARIA I GRADO,3,27,24,3,0,3
202223,RM1E03800P,SCUOLA PRIMARIA,3,3,0,3,0,3
202223,VEPS00500C,SCUOLA SECONDARIA II GRADO,5,38,36,2,1,1
202223,LC1M020004,SCUOLA SECONDARIA I GRADO,3,18,18,0,0,0
202223,AL1E00300A,SCUOLA PRIMARIA,1,15,13,2,1,1
202223,BO1E01700C,SCUOLA PRIMARIA,2,75,75,0,0,0
202223,MIPM1R500Q,SCUOLA SECONDARIA II GRADO,2,20,20,0,0,0
202223,MIPMZS500F,SCUOLA SECONDARIA II GRADO,4,24,24,0,0,0
202223,SATDGN500Z,SCUOLA SECONDARIA II GRADO,5,69,65,4,2,2
202223,RM1EQM5004,SCUOLA PRIMARIA,3,20,20,0,0,0
202223,NARH3Z5008,SCUOLA SECONDARIA II GRADO,5,60,56,4,2,2
202223,BLPC01500G,SCUOLA SECONDARIA II GRADO,2,8,8,0,0,0
202223,VARFIU5007,SCUOLA SECONDARIA II GRADO,4,21,20,1,0,1
202223,MI1E046005,SCUOLA PRIMARIA,4,78,77,1,1,0
202223,MS1E00400V,SCUOLA PRIMARIA,3,18,18,0,0,0
202223,CHTL31500X,SCUOLA SECONDARIA II GRADO,5,9,9,0,0,0
202223,MO1E01000G,SCUOLA PRIMARIA,2,33,27,6,1,5
202223,RM1E023001,SCUOLA PRIMARIA,1,39,32,7,0,7
202223,TOSL01500G,SCUOLA SECONDARIA II GRADO,5,20,20,0,0,0
202223,RMPS97500P,SCUOLA SECONDARIA II GRADO,5,16,16,0,0,0
202223,MB1E06800V,SCUOLA PRIMARIA,3,14,13,1,0,1
202223,AGTL415001,SCUOLA SECONDARIA II GRADO,5,69,69,0,0,0
202223,BO1M01000V,SCUOLA SECONDARIA I GRADO,3,23,21,2,0,2
202223,TS1E00400N,SCUOLA PRIMARIA,4,15,15,0,0,0
202223,SATF02500B,SCUOLA SECONDARIA II GRADO,5,69,68,1,1,0
202223,SV1E00300E,SCUOLA PRIMARIA,2,22,20,2,2,0
202223,PA1E035005,SCUOLA PRIMARIA,2,56,56,0,0,0
202223,PRPSAV500N,SCUOLA SECONDARIA II GRADO,1,17,17,0,0,0
202223,AVTDMI500Z,SCUOLA SECONDARIA II GRADO,3,1,1,0,0,0
202223,AVRH2Q500U,SCUOLA SECONDARIA II GRADO,4,12,12,0,0,0
202223,RC1E01000Q,SCUOLA PRIMARIA,2,17,16,1,0,1
202223,NA1E114004,SCUOLA PRIMARIA,1,11,11,0,0,0
202223,MBPSIE500B,SCUOLA SECONDARIA II GRADO,5,15,15,0,0,0
202223,PD1E00300D,SCUOLA PRIMARIA,5,23,23,0,0,0
202223,GERI015006,SCUOLA SECONDARIA II GRADO,3,27,22,5,0,5
202223,RM1M036008,SCUOLA SECONDARIA I GRADO,2,30,30,0,0,0
202223,MI1E047001,SCUOLA PRIMARIA,3,63,63,0,0,0
202223,MI1E14300E,SCUOLA PRIMARIA,3,11,8,3,0,3
202223,SARFD1500N,SCUOLA SECONDARIA II GRADO,1,1,1,0,0,0
202223,CE1E04100N,SCUOLA PRIMARIA,2,12,12,0,0,0
202223,TS1E006009,SCUOLA PRIMARIA,5,19,18,1,1,0
202223,SATDP9500M,SCUOLA SECONDARIA II GRADO,3,3,3,0,0,0
202223,AVTD06500A,SCUOLA SECONDARIA II GRADO,5,70,64,6,0,6
202223,MI1E08700B,SCUOLA PRIMARIA,5,95,93,2,0,2
202223,BO1E00100V,SCUOLA PRIMARIA,3,28,27,1,0,1
202223,AR1E001005,SCUOLA PRIMARIA,3,10,10,0,0,0
202223,RM1M028009,SCUOLA SECONDARIA I GRADO,3,25,24,1,1,0
202223,PV1MPM500O,SCUOLA SECONDARIA I GRADO,3,11,11,0,0,0
202223,TV1M002001,SCUOLA SECONDARIA I GRADO,2,25,23,2,0,2
202223,ALRH01500G,SCUOLA SECONDARIA II GRADO,5,27,27,0,0,0
202223,TV1E00900E,SCUOLA PRIMARIA,5,33,29,4,2,2
202223,VTPMI8500B,SCUOLA SECONDARIA II GRADO,3,12,12,0,0,0
202223,CETDA05001,SCUOLA SECONDARIA II GRADO,5,21,20,1,0,1
202223,LTTD595008,SCUOLA SECONDARIA II GRADO,1,9,9,0,0,0
202223,PR1E00200X,SCUOLA PRIMARIA,5,21,21,0,0,0
202223,MB1E029008,SCUOLA PRIMARIA,3,45,45,0,0,0
202223,RMPM045004,SCUOLA SECONDARIA II GRADO,5,84,73,11,3,8
202223,OR1E00100R,SCUOLA PRIMARIA,1,14,14,0,0,0
202223,MIPS735002,SCUOLA SECONDARIA II GRADO,4,12,12,0,0,0
202223,MI1E06500E,SCUOLA PRIMARIA,1,27,26,1,0,1
202223,LI1E006005,SCUOLA PRIMARIA,1,39,39,0,0,0
202223,RM1E04200A,SCUOLA PRIMARIA,4,17,17,0,0,0
202223,RMPS455005,SCUOLA SECONDARIA II GRADO,1,7,7,0,0,0
202223,BOPS02500L,SCUOLA SECONDARIA II GRADO,4,29,29,0,0,0
202223,SRTN2V5006,SCUOLA SECONDARIA II GRADO,5,59,59,0,0,0
202223,BG1M9L500G,SCUOLA SECONDARIA I GRADO,3,29,29,0,0,0
202223,COTAV75005,SCUOLA SECONDARIA II GRADO,2,28,28,0,0,0
202223,NA1E23700N,SCUOLA PRIMARIA,4,23,23,0,0,0
202223,MIPM04500G,SCUOLA SECONDARIA II GRADO,2,23,23,0,0,0
202223,VAPSVA500Z,SCUOLA SECONDARIA II GRADO,2,17,17,0,0,0
202223,CEPC015007,SCUOLA SECONDARIA II GRADO,2,22,22,0,0,0
202223,NA1E08900L,SCUOLA PRIMARIA,5,18,18,0,0,0
202223,LI1E00900L,SCUOLA PRIMARIA,3,26,24,2,1,1
202223,APPCV8500G,SCUOLA SECONDARIA II GRADO,3,2,2,0,0,0
202223,RN1E005009,SCUOLA PRIMARIA,3,44,42,2,1,1
202223,RMPS485001,SCUOLA SECONDARIA II GRADO,2,11,11,0,0,0
202223,MB1E03400Q,SCUOLA PRIMARIA,1,28,26,2,0,2
202223,AGPSFG5009,SCUOLA SECONDARIA II GRADO,3,7,7,0,0,0
202223,BO1M001004,SCUOLA SECONDARIA I GRADO,2,41,40,1,1,0
202223,TO1E038006,SCUOLA PRIMARIA,2,11,9,2,0,2
202223,PTPM02500D,SCUOLA SECONDARIA II GRADO,4,24,21,3,1,2
202223,RMPC3Q500Z,SCUOLA SECONDARIA II GRADO,2,20,19,1,1,0
202223,NATF1Z500S,SCUOLA SECONDARIA II GRADO,4,3,3,0,0,0
202223,MIPL0Z500D,SCUOLA SECONDARIA II GRADO,3,14,13,1,0,1
202223,PD1E00200N,SCUOLA PRIMARIA,2,5,5,0,0,0
202223,GO1MGQ500P,SCUOLA SECONDARIA I GRADO,3,6,6,0,0,0
202223,RMPS03500C,SCUOLA SECONDARIA II GRADO,3,20,20,0,0,0
202223,MBPS345002,SCUOLA SECONDARIA II GRADO,3,23,23,0,0,0
202223,BSTF01500P,SCUOLA SECONDARIA II GRADO,4,21,21,0,0,0
202223,TATDI4500D,SCUOLA SECONDARIA II GRADO,2,6,6,0,0,0
202223,CA1E012007,SCUOLA PRIMARIA,4,33,33,0,0,0
202223,MI1EAE500E,SCUOLA PRIMARIA,3,18,17,1,1,0
202223,VITB15500E,SCUOLA SECONDARIA II GRADO,5,11,11,0,0,0
202223,BSPMNI500T,SCUOLA SECONDARIA II GRADO,1,22,22,0,0,0
202223,VAPS06500N,SCUOLA SECONDARIA II GRADO,1,24,24,0,0,0
202223,BS1M00700N,SCUOLA SECONDARIA I GRADO,2,34,33,1,1,0
202223,RM1E14400V,SCUOLA PRIMARIA,4,20,20,0,0,0
202223,BG1E019006,SCUOLA PRIMARIA,5,21,19,2,0,2
202223,CT1E033001,SCUOLA PRIMARIA,5,21,20,1,0,1
202223,MIPS375001,SCUOLA SECONDARIA II GRADO,4,47,47,0,0,0
202223,GERI015006,SCUOLA SECONDARIA II GRADO,1,43,27,16,1,15
202223,MBPM145009,SCUOLA SECONDARIA II GRADO,1,14,14,0,0,0
202223,MS1EO3500D,SCUOLA PRIMARIA,2,14,13,1,0,1
202223,REPLP0500O,SCUOLA SECONDARIA II GRADO,1,11,10,1,0,1
202223,FR1E003001,SCUOLA PRIMARIA,4,16,15,1,0,1
202223,RMPCT9500V,SCUOLA SECONDARIA II GRADO,2,7,7,0,0,0
202223,PAPSTT500B,SCUOLA SECONDARIA II GRADO,2,3,3,0,0,0
202223,CERHP55001,SCUOLA SECONDARIA II GRADO,3,11,11,0,0,0
202223,VT1M003003,SCUOLA SECONDARIA I GRADO,1,21,21,0,0,0
202223,CTPSNQ5002,SCUOLA SECONDARIA II GRADO,1,6,6,0,0,0
202223,NATF545002,SCUOLA SECONDARIA II GRADO,3,1,1,0,0,0
202223,COPLNP500T,SCUOLA SECONDARIA II GRADO,4,12,11,1,0,1
202223,UDPSMD500L,SCUOLA SECONDARIA II GRADO,1,9,8,1,0,1
202223,CRPC035004,SCUOLA SECONDARIA II GRADO,2,19,19,0,0,0
202223,MB1M01900V,SCUOLA SECONDARIA I GRADO,3,73,71,2,0,2
202223,MO1E01000G,SCUOLA PRIMARIA,4,38,34,4,2,2
202223,BATD665005,SCUOLA SECONDARIA II GRADO,5,4,4,0,0,0
202223,TO1E033003,SCUOLA PRIMARIA,5,52,47,5,5,0
202223,REPSRL500H,SCUOLA SECONDARIA II GRADO,3,13,12,1,0,1
202223,RM1E077009,SCUOLA PRIMARIA,2,11,1,10,0,10
202223,RM1E21400X,SCUOLA PRIMARIA,2,16,16,0,0,0
202223,CT1M00200E,SCUOLA SECONDARIA I GRADO,2,11,8,3,0,3
202223,NA1E03400C,SCUOLA PRIMARIA,1,43,42,1,0,1
202223,CO1M01800A,SCUOLA SECONDARIA I GRADO,3,28,21,7,1,6
202223,CAPS8T5007,SCUOLA SECONDARIA II GRADO,4,16,16,0,0,0
202223,TOPC11500C,SCUOLA SECONDARIA II GRADO,3,2,2,0,0,0
202223,FIPL8A500L,SCUOLA SECONDARIA II GRADO,5,8,7,1,1,0
202223,NATDAR5000,SCUOLA SECONDARIA II GRADO,3,3,3,0,0,0
202223,MBRFZ6500C,SCUOLA SECONDARIA II GRADO,2,24,23,1,0,1
202223,AQ1E004002,SCUOLA PRIMARIA,2,20,20,0,0,0
202223,RM1M11600X,SCUOLA SECONDARIA I GRADO,3,58,54,4,0,4
202223,CR1E00800N,SCUOLA PRIMARIA,2,18,18,0,0,0
202223,SAPLLV500D,SCUOLA SECONDARIA II GRADO,5,65,61,4,1,3
202223,MO1E2A5008,SCUOLA PRIMARIA,4,18,16,2,2,0
202223,RMPS695009,SCUOLA SECONDARIA II GRADO,2,9,9,0,0,0
202223,RM1E10300L,SCUOLA PRIMARIA,4,45,45,0,0,0
202223,VI1M003004,SCUOLA SECONDARIA I GRADO,3,16,15,1,0,1
202223,CE1E036006,SCUOLA PRIMARIA,1,16,13,3,0,3
202223,MEPS045007,SCUOLA SECONDARIA II GRADO,1,9,9,0,0,0
202223,CT1ELO5000,SCUOLA PRIMARIA,4,21,20,1,1,0
202223,PA1EZG500F,SCUOLA PRIMARIA,5,4,4,0,0,0
202223,BSPLMR500P,SCUOLA SECONDARIA II GRADO,5,30,29,1,0,1
202223,TVPC48500H,SCUOLA SECONDARIA II GRADO,3,20,20,0,0,0
202223,NATDPG500E,SCUOLA SECONDARIA II GRADO,4,2,2,0,0,0
202223,MBRC4H500I,SCUOLA SECONDARIA II GRADO,1,6,6,0,0,0
202223,BG1EL2500G,SCUOLA PRIMARIA,2,9,6,3,2,1
202223,AVTN0D5004,SCUOLA SECONDARIA II GRADO,5,52,46,6,2,4
202223,TATD08500T,SCUOLA SECONDARIA II GRADO,2,19,19,0,0,0
202223,NA1E164005,SCUOLA PRIMARIA,4,19,19,0,0,0
202223,NATD455002,SCUOLA SECONDARIA II GRADO,3,4,4,0,0,0
202223,NAPCFD500P,SCUOLA SECONDARIA II GRADO,4,10,9,1,0,1
202223,VR1E011006,SCUOLA PRIMARIA,3,24,24,0,0,0
202223,VR1E009006,SCUOLA PRIMARIA,1,23,23,0,0,0
202223,RG1E0O5005,SCUOLA PRIMARIA,5,14,14,0,0,0
202223,CE1E02500Q,SCUOLA PRIMARIA,3,9,7,2,0,2
202223,ME1M010008,SCUOLA SECONDARIA I GRADO,3,21,20,1,1,0
202223,VI1E010002,SCUOLA PRIMARIA,4,18,15,3,2,1
202223,BS1EU3500Q,SCUOLA PRIMARIA,2,30,25,5,0,5
202223,TO1E6R5003,SCUOLA PRIMARIA,1,42,41,1,1,0
202223,RM1E15800R,SCUOLA PRIMARIA,2,14,9,5,0,5
202223,NA1E14000L,SCUOLA PRIMARIA,2,22,22,0,0,0
202223,VT1E00300T,SCUOLA PRIMARIA,5,10,10,0,0,0
202223,VRPSEM5005,SCUOLA SECONDARIA II GRADO,1,4,4,0,0,0
202223,MB1EQT500D,SCUOLA PRIMARIA,5,19,17,2,1,1
202223,MIPSIG500R,SCUOLA SECONDARIA II GRADO,2,37,37,0,0,0
202223,TEPS335003,SCUOLA SECONDARIA II GRADO,5,13,13,0,0,0
202223,RM1E19000L,SCUOLA PRIMARIA,3,24,24,0,0,0
202223,NATD305004,SCUOLA SECONDARIA II GRADO,1,3,3,0,0,0
202223,MI1M055005,SCUOLA SECONDARIA I GRADO,2,47,44,3,1,2
202223,NA1E165001,SCUOLA PRIMARIA,4,10,10,0,0,0
202223,VEPSAM500G,SCUOLA SECONDARIA II GRADO,4,7,7,0,0,0
202223,SARHRM500C,SCUOLA SECONDARIA II GRADO,1,3,3,0,0,0
202223,TV1E01200A,SCUOLA PRIMARIA,2,19,19,0,0,0
202223,RGPM0A500T,SCUOLA SECONDARIA II GRADO,5,16,13,3,0,3
202223,VA1M4Z500Q,SCUOLA SECONDARIA I GRADO,1,45,42,3,0,3
202223,NARH05500C,SCUOLA SECONDARIA II GRADO,5,8,8,0,0,0
202223,CTPM315008,SCUOLA SECONDARIA II GRADO,5,40,39,1,1,0
202223,VBRH155008,SCUOLA SECONDARIA II GRADO,5,14,14,0,0,0
202223,BGPMDF500L,SCUOLA SECONDARIA II GRADO,1,15,15,0,0,0
202223,PATD43500N,SCUOLA SECONDARIA II GRADO,2,10,9,1,0,1
202223,AQ1E00100E,SCUOLA PRIMARIA,2,24,23,1,0,1
202223,VAPSQF500T,SCUOLA SECONDARIA II GRADO,3,27,27,0,0,0
202223,AT1ENP5001,SCUOLA PRIMARIA,3,13,12,1,0,1
202223,NA1E10400D,SCUOLA PRIMARIA,3,8,8,0,0,0
202223,BA1M006008,SCUOLA SECONDARIA I GRADO,3,27,27,0,0,0
202223,RM1E177006,SCUOLA PRIMARIA,1,16,15,1,0,1
202223,VE1M6Q5004,SCUOLA SECONDARIA I GRADO,2,47,42,5,0,5
202223,CS1ENE5005,SCUOLA PRIMARIA,4,21,21,0,0,0
202223,MI1E012002,SCUOLA PRIMARIA,3,19,12,7,1,6
202223,AGTD4U500B,SCUOLA SECONDARIA II GRADO,2,6,6,0,0,0
202223,SO1M00100Q,SCUOLA SECONDARIA I GRADO,3,16,15,1,0,1
202223,GE1E013004,SCUOLA PRIMARIA,4,15,12,3,0,3
202223,GE1E02900N,SCUOLA PRIMARIA,1,23,23,0,0,0
202223,MIPMU4500Z,SCUOLA SECONDARIA II GRADO,4,14,12,2,0,2
202223,PS1M00200L,SCUOLA SECONDARIA I GRADO,2,23,21,2,1,1
202223,SATD4U500A,SCUOLA SECONDARIA II GRADO,5,69,69,0,0,0
202223,BG1M3M5006,SCUOLA SECONDARIA I GRADO,2,18,18,0,0,0
202223,PD1M00500A,SCUOLA SECONDARIA I GRADO,1,34,33,1,0,1
202223,CO1E00900A,SCUOLA PRIMARIA,1,18,18,0,0,0
202223,NA1E12500E,SCUOLA PRIMARIA,5,30,30,0,0,0
202223,FG1E016002,SCUOLA PRIMARIA,3,9,3,6,5,1
202223,CERH00500D,SCUOLA SECONDARIA II GRADO,2,8,6,2,2,0
202223,NO1E006007,SCUOLA PRIMARIA,5,52,48,4,0,4
202223,CA1M01500X,SCUOLA SECONDARIA I GRADO,1,23,23,0,0,0
202223,NA1E18700T,SCUOLA PRIMARIA,2,33,19,14,9,5
202223,RM1E03400B,SCUOLA PRIMARIA,3,25,25,0,0,0
202223,VIPS3I500B,SCUOLA SECONDARIA II GRADO,5,33,32,1,0,1
202223,CE1E058003,SCUOLA PRIMARIA,3,13,12,1,0,1
202223,CTTD315003,SCUOLA SECONDARIA II GRADO,1,4,4,0,0,0
202223,SSPS02500V,SCUOLA SECONDARIA II GRADO,5,10,9,1,0,1
202223,NA1E24400R,SCUOLA PRIMARIA,4,15,12,3,0,3
202223,AVTN0D5004,SCUOLA SECONDARIA II GRADO,4,4,3,1,1,0
202223,TOPLM6500B,SCUOLA SECONDARIA II GRADO,1,2,2,0,0,0
202223,FE1E8D500F,SCUOLA PRIMARIA,5,36,36,0,0,0
202223,BL1E00200B,SCUOLA PRIMARIA,4,36,34,2,1,1
202223,RMPC24500N,SCUOLA SECONDARIA II GRADO,1,9,9,0,0,0
202223,NATFZE5004,SCUOLA SECONDARIA II GRADO,2,3,3,0,0,0
202223,RM1E16500X,SCUOLA PRIMARIA,1,15,14,1,1,0
202223,NAPMDC5007,SCUOLA SECONDARIA II GRADO,2,11,11,0,0,0
202223,PS1E00100G,SCUOLA PRIMARIA,3,15,15,0,0,0
202223,PR1M010004,SCUOLA SECONDARIA I GRADO,2,41,39,2,0,2
202223,BO1E012009,SCUOLA PRIMARIA,4,55,50,5,0,5
202223,RM1E12300T,SCUOLA PRIMARIA,4,62,59,3,1,2
202223,RM1E11000Q,SCUOLA PRIMARIA,2,35,33,2,0,2
202223,MI1E11900N,SCUOLA PRIMARIA,4,21,20,1,0,1
202223,NA1E214001,SCUOLA PRIMARIA,2,11,5,6,2,4
202223,BS1E003005,SCUOLA PRIMARIA,4,25,23,2,0,2
202223,BS1E01200X,SCUOLA PRIMARIA,2,19,18,1,1,0
202223,NATHES5002,SCUOLA SECONDARIA II GRADO,2,7,7,0,0,0
202223,LC1E010008,SCUOLA PRIMARIA,4,32,31,1,0,1
202223,LCTAB3500P,SCUOLA SECONDARIA II GRADO,2,8,8,0,0,0
202223,CTTD06500D,SCUOLA SECONDARIA II GRADO,1,4,4,0,0,0
202223,MIRC1N500Z,SCUOLA SECONDARIA II GRADO,2,6,6,0,0,0
202223,TA1E003008,SCUOLA PRIMARIA,4,23,23,0,0,0
202223,VE1M00500C,SCUOLA SECONDARIA I GRADO,1,34,32,2,1,1
202223,VE1E00900E,SCUOLA PRIMARIA,1,21,20,1,0,1
202223,FI1E01000Q,SCUOLA PRIMARIA,1,31,31,0,0,0
202223,BGPMIZ500F,SCUOLA SECONDARIA II GRADO,1,6,6,0,0,0
202223,GE1E033009,SCUOLA PRIMARIA,1,51,49,2,0,2
202223,RMPM7V500G,SCUOLA SECONDARIA II GRADO,3,30,29,1,1,0
202223,PA1E00900L,SCUOLA PRIMARIA,3,22,17,5,0,5
202223,RMTD43500Q,SCUOLA SECONDARIA II GRADO,5,25,20,5,0,5
202223,BS1E00700C,SCUOLA PRIMARIA,3,21,19,2,0,2
202223,MI1M085001,SCUOLA SECONDARIA I GRADO,3,104,101,3,1,2
202223,LO1M02000T,SCUOLA SECONDARIA I GRADO,2,31,30,1,1,0
202223,RM1E04000P,SCUOLA PRIMARIA,5,21,19,2,0,2
202223,LE1MO05005,SCUOLA SECONDARIA I GRADO,1,20,19,1,1,0
202223,MI1M06400X,SCUOLA SECONDARIA I GRADO,2,43,41,2,0,2
202223,SASD00500E,SCUOLA SECONDARIA II GRADO,1,3,3,0,0,0
202223,CS1E003002,SCUOLA PRIMARIA,3,17,17,0,0,0
202223,LC1M08000Q,SCUOLA SECONDARIA I GRADO,3,38,38,0,0,0
202223,AGTL4P500L,SCUOLA SECONDARIA II GRADO,1,1,1,0,0,0
202223,BR1E001002,SCUOLA PRIMARIA,4,17,15,2,0,2
202223,CTSL0V500E,SCUOLA SECONDARIA II GRADO,1,16,16,0,0,0
202223,AGPC4A5009,SCUOLA SECONDARIA II GRADO,4,6,6,0,0,0
202223,TVPL75500A,SCUOLA SECONDARIA II GRADO,3,16,16,0,0,0
202223,PGPM02500T,SCUOLA SECONDARIA II GRADO,2,9,7,2,0,2
202223,FIPCI25001,SCUOLA SECONDARIA II GRADO,2,16,16,0,0,0
202223,VR1M00100R,SCUOLA SECONDARIA I GRADO,1,40,40,0,0,0
202223,CO1E00800E,SCUOLA PRIMARIA,1,19,16,3,1,2
202223,RM1E148006,SCUOLA PRIMARIA,4,32,31,1,0,1
202223,RC1E00300L,SCUOLA PRIMARIA,1,23,21,2,1,1
202223,NA1E27800X,SCUOLA PRIMARIA,4,38,36,2,0,2
202223,BLPL49500T,SCUOLA SECONDARIA II GRADO,5,14,13,1,1,0
202223,FG1E02500R,SCUOLA PRIMARIA,3,21,20,1,0,1
202223,GEPS04500R,SCUOLA SECONDARIA II GRADO,1,25,25,0,0,0
202223,MI1E04400D,SCUOLA PRIMARIA,3,16,15,1,0,1
202223,NATL25500P,SCUOLA SECONDARIA II GRADO,5,64,61,3,1,2
202223,SARFTV500I,SCUOLA SECONDARIA II GRADO,1,3,3,0,0,0
202223,PEPS005001,SCUOLA SECONDARIA II GRADO,5,35,35,0,0,0
202223,TS1E00500D,SCUOLA PRIMARIA,2,11,11,0,0,0
202223,ME1E01700T,SCUOLA PRIMARIA,1,8,8,0,0,0
202223,NA1M008005,SCUOLA SECONDARIA I GRADO,2,19,19,0,0,0
202223,RM1E155009,SCUOLA PRIMARIA,2,30,30,0,0,0
202223,NA1E134009,SCUOLA PRIMARIA,5,8,8,0,0,0
202223,CT1E004001,SCUOLA PRIMARIA,2,22,21,1,0,1
202223,PVPL045003,SCUOLA SECONDARIA II GRADO,3,9,9,0,0,0
202223,NA1E00400L,SCUOLA PRIMARIA,2,10,7,3,0,3
202223,AP1E00200Q,SCUOLA PRIMARIA,5,20,19,1,0,1
202223,RE1E00500D,SCUOLA PRIMARIA,4,35,34,1,1,0
202223,LCTB00500V,SCUOLA SECONDARIA II GRADO,2,8,4,4,0,4
202223,TO1E018001,SCUOLA PRIMARIA,1,53,53,0,0,0
202223,RM1E06300B,SCUOLA PRIMARIA,3,23,23,0,0,0
202223,FR1EZQ500N,SCUOLA PRIMARIA,4,11,11,0,0,0
202223,RGRHL4500A,SCUOLA SECONDARIA II GRADO,1,5,4,1,0,1
202223,CERIH2500T,SCUOLA SECONDARIA II GRADO,5,54,51,3,1,2
202223,RM1E20800L,SCUOLA PRIMARIA,1,23,21,2,0,2
202223,PO1E005008,SCUOLA PRIMARIA,4,24,21,3,0,3
202223,PO1M02000G,SCUOLA SECONDARIA I GRADO,2,78,62,16,0,16
202223,NA1M03400N,SCUOLA SECONDARIA I GRADO,2,39,34,5,0,5
202223,VC1E00200E,SCUOLA PRIMARIA,4,20,20,0,0,0
202223,BO1E005006,SCUOLA PRIMARIA,4,26,26,0,0,0
202223,SATFTL5007,SCUOLA SECONDARIA II GRADO,1,8,7,1,0,1
202223,CE1E010002,SCUOLA PRIMARIA,5,14,13,1,0,1
202223,RMPLB3500E,SCUOLA SECONDARIA II GRADO,5,51,45,6,1,5
202223,NOPL6T5005,SCUOLA SECONDARIA II GRADO,1,14,13,1,1,0
202223,RMTD7E500U,SCUOLA SECONDARIA II GRADO,2,2,1,1,1,0
202223,RMPS25500B,SCUOLA SECONDARIA II GRADO,4,15,15,0,0,0
202223,RMSL3L500Q,SCUOLA SECONDARIA II GRADO,1,10,9,1,0,1
202223,PN1M00100D,SCUOLA SECONDARIA I GRADO,3,81,79,2,0,2
202223,MI1E004003,SCUOLA PRIMARIA,1,46,42,4,0,4
202223,MI1E01000A,SCUOLA PRIMARIA,2,25,23,2,2,0
202223,NO1M015007,SCUOLA SECONDARIA I GRADO,3,27,27,0,0,0
202223,BO1MUE500U,SCUOLA SECONDARIA I GRADO,3,21,20,1,0,1
202223,FI1M01200L,SCUOLA SECONDARIA I GRADO,2,20,19,1,1,0
202223,CERHT0500Q,SCUOLA SECONDARIA II GRADO,4,13,1,12,0,12
202223,LTPM4Q5001,SCUOLA SECONDARIA II GRADO,2,2,2,0,0,0
202223,RM1E056008,SCUOLA PRIMARIA,5,15,15,0,0,0
202223,PAPL595005,SCUOLA SECONDARIA II GRADO,4,3,3,0,0,0
202223,CE1E016001,SCUOLA PRIMARIA,4,6,4,2,1,1
202223,CN1M00400Q,SCUOLA SECONDARIA I GRADO,3,28,26,2,2,0
202223,AR1E002001,SCUOLA PRIMARIA,4,13,11,2,0,2
202223,CERH325008,SCUOLA SECONDARIA II GRADO,5,69,69,0,0,0
202223,RE1E001006,SCUOLA PRIMARIA,3,25,25,0,0,0
202223,SAPMNI5000,SCUOLA SECONDARIA II GRADO,5,42,39,3,0,3
202223,MO1E005004,SCUOLA PRIMARIA,2,38,36,2,0,2
202223,MO1E00700Q,SCUOLA PRIMARIA,3,46,46,0,0,0
202223,TOTD08500R,SCUOLA SECONDARIA II GRADO,5,15,13,2,0,2
202223,RMPS54500B,SCUOLA SECONDARIA II GRADO,5,49,45,4,2,2
202223,RM1E09600P,SCUOLA PRIMARIA,3,46,46,0,0,0
202223,PT1E00300A,SCUOLA PRIMARIA,5,13,12,1,0,1
202223,LT1E00900G,SCUOLA PRIMARIA,5,46,43,3,0,3
202223,BS1E02600T,SCUOLA PRIMARIA,5,21,21,0,0,0
202223,PAPC00500B,SCUOLA SECONDARIA II GRADO,5,15,15,0,0,0
202223,PD1E019003,SCUOLA PRIMARIA,2,40,32,8,1,7
202223,COTEA1500D,SCUOLA SECONDARIA II GRADO,4,4,4,0,0,0
202223,MIPC005001,SCUOLA SECONDARIA II GRADO,1,30,30,0,0,0
202223,RM1E14400V,SCUOLA PRIMARIA,3,11,10,1,0,1
202223,TOPLRN500U,SCUOLA SECONDARIA II GRADO,1,11,10,1,0,1
202223,RM1E12900R,SCUOLA PRIMARIA,1,22,22,0,0,0
202223,RMPSPN500P,SCUOLA SECONDARIA II GRADO,4,24,23,1,1,0
202223,NAPS7Q5000,SCUOLA SECONDARIA II GRADO,1,10,10,0,0,0
202223,MO1E00300C,SCUOLA PRIMARIA,1,39,34,5,0,5
202223,PVPSTA500Q,SCUOLA SECONDARIA II GRADO,1,5,4,1,0,1
202223,RMPSI6500C,SCUOLA SECONDARIA II GRADO,3,53,49,4,1,3
202223,PVTBDH500G,SCUOLA SECONDARIA II GRADO,5,2,2,0,0,0
202223,MI1EES500O,SCUOLA PRIMARIA,1,42,40,2,1,1
202223,NA1E19600L,SCUOLA PRIMARIA,5,11,11,0,0,0
202223,NA1E07500P,SCUOLA PRIMARIA,2,16,16,0,0,0
202223,TV1E01500T,SCUOLA PRIMARIA,3,54,54,0,0,0
202223,NA1E00900Q,SCUOLA PRIMARIA,4,15,15,0,0,0
202223,CTTDHQ5002,SCUOLA SECONDARIA II GRADO,3,4,4,0,0,0
202223,RM1E05400L,SCUOLA PRIMARIA,2,21,17,4,3,1
202223,CE1E03200V,SCUOLA PRIMARIA,3,22,17,5,1,4
202223,MISL025006,SCUOLA SECONDARIA II GRADO,5,50,50,0,0,0
202223,CETDHG500L,SCUOLA SECONDARIA II GRADO,2,7,1,6,0,6
202223,BS1M00700N,SCUOLA SECONDARIA I GRADO,3,31,31,0,0,0
202223,VAPS025007,SCUOLA SECONDARIA II GRADO,1,24,23,1,0,1
202223,COPS04500P,SCUOLA SECONDARIA II GRADO,5,10,10,0,0,0
202223,MI1MP35007,SCUOLA SECONDARIA I GRADO,2,35,33,2,2,0
202223,PATD87500G,SCUOLA SECONDARIA II GRADO,4,10,10,0,0,0
202223,MBPS67500C,SCUOLA SECONDARIA II GRADO,5,18,18,0,0,0
202223,RM1M08300T,SCUOLA SECONDARIA I GRADO,1,18,16,2,0,2
202223,BG1E026009,SCUOLA PRIMARIA,4,15,13,2,0,2
202223,BG1E022002,SCUOLA PRIMARIA,2,20,20,0,0,0
202223,RMSL3M5001,SCUOLA SECONDARIA II GRADO,3,5,5,0,0,0
202223,RMPMSC500I,SCUOLA SECONDARIA II GRADO,3,20,19,1,0,1
202223,TO1E00700E,SCUOLA PRIMARIA,3,23,23,0,0,0
202223,PVTL025009,SCUOLA SECONDARIA II GRADO,1,6,5,1,0,1
202223,RM1E16700G,SCUOLA PRIMARIA,2,22,22,0,0,0
202223,MI1EES500O,SCUOLA PRIMARIA,5,6,6,0,0,0
202223,NAPC135007,SCUOLA SECONDARIA II GRADO,4,4,4,0,0,0
202223,REPSRL500H,SCUOLA SECONDARIA II GRADO,4,16,16,0,0,0
202223,RNPS00500E,SCUOLA SECONDARIA II GRADO,4,12,12,0,0,0
202223,RNPL01500X,SCUOLA SECONDARIA II GRADO,2,13,13,0,0,0
202223,RM1E01000V,SCUOLA PRIMARIA,1,29,29,0,0,0
202223,NARH96500S,SCUOLA SECONDARIA II GRADO,5,65,65,0,0,0
202223,CETF36500S,SCUOLA SECONDARIA II GRADO,3,9,9,0,0,0
202223,PDPL02500A,SCUOLA SECONDARIA II GRADO,2,14,14,0,0,0
202223,CTPSNQ5002,SCUOLA SECONDARIA II GRADO,5,5,5,0,0,0
202223,NATF30500A,SCUOLA SECONDARIA II GRADO,5,70,68,2,0,2
202223,BG1E02400N,SCUOLA PRIMARIA,3,19,17,2,0,2
202223,RCRH6N5009,SCUOLA SECONDARIA II GRADO,3,4,4,0,0,0
202223,MB1M009008,SCUOLA SECONDARIA I GRADO,1,84,84,0,0,0
202223,BS1E011004,SCUOLA PRIMARIA,2,24,23,1,0,1
202223,NARI01500D,SCUOLA SECONDARIA II GRADO,5,25,22,3,1,2
202223,VI1E00300V,SCUOLA PRIMARIA,2,21,17,4,0,4
202223,NATD355005,SCUOLA SECONDARIA II GRADO,2,12,12,0,0,0
202223,RE1EE9500Z,SCUOLA PRIMARIA,2,22,21,1,1,0
202223,AL1M01000P,SCUOLA SECONDARIA I GRADO,2,34,32,2,0,2
202223,BORI03500C,SCUOLA SECONDARIA II GRADO,5,23,23,0,0,0
202223,LTTDPM500P,SCUOLA SECONDARIA II GRADO,3,4,3,1,1,0
202223,TO1M04500E,SCUOLA SECONDARIA I GRADO,2,49,49,0,0,0
202223,CT1M020004,SCUOLA SECONDARIA I GRADO,2,32,29,3,0,3
202223,NA1E04000Q,SCUOLA PRIMARIA,3,12,12,0,0,0
202223,VR1E01400N,SCUOLA PRIMARIA,4,25,25,0,0,0
202223,CO1M022002,SCUOLA SECONDARIA I GRADO,2,21,21,0,0,0
202223,FIPLZD500L,SCUOLA SECONDARIA II GRADO,2,2,2,0,0,0
202223,RMPLCV500U,SCUOLA SECONDARIA II GRADO,5,20,18,2,2,0
202223,FIPSFU500L,SCUOLA SECONDARIA II GRADO,1,4,1,3,0,3
202223,CE1ELF5000,SCUOLA PRIMARIA,4,10,10,0,0,0
202223,VAPSZC500T,SCUOLA SECONDARIA II GRADO,5,45,45,0,0,0
202223,RM1M129002,SCUOLA SECONDARIA I GRADO,2,8,6,2,0,2
202223,CA1E01400V,SCUOLA PRIMARIA,4,19,19,0,0,0
202223,MI1M04300V,SCUOLA SECONDARIA I GRADO,1,49,48,1,1,0
202223,MB1E037007,SCUOLA PRIMARIA,4,27,27,0,0,0
202223,PERFNA5005,SCUOLA SECONDARIA II GRADO,4,4,4,0,0,0
202223,MIPM07500B,SCUOLA SECONDARIA II GRADO,5,26,26,0,0,0
202223,PG1E001003,SCUOLA PRIMARIA,3,14,14,0,0,0
202223,SA1E018001,SCUOLA PRIMARIA,5,12,12,0,0,0
202223,NARF5I500H,SCUOLA SECONDARIA II GRADO,5,16,16,0,0,0
202223,MESL0P500H,SCUOLA SECONDARIA II GRADO,1,2,1,1,0,1
202223,CTPC01500D,SCUOLA SECONDARIA II GRADO,1,12,10,2,0,2
202223,BS1MM05009,SCUOLA SECONDARIA I GRADO,1,19,19,0,0,0
202223,MIPL265008,SCUOLA SECONDARIA II GRADO,5,17,17,0,0,0
202223,VRPQ02500E,SCUOLA SECONDARIA II GRADO,5,26,26,0,0,0
202223,VRPC025006,SCUOLA SECONDARIA II GRADO,5,9,9,0,0,0
202223,BLPS54500H,SCUOLA SECONDARIA II GRADO,2,11,11,0,0,0
202223,VATB215007,SCUOLA SECONDARIA II GRADO,5,15,14,1,1,0
202223,VARFS2500Z,SCUOLA SECONDARIA II GRADO,5,17,17,0,0,0
202223,NA1E09700G,SCUOLA PRIMARIA,4,30,30,0,0,0
202223,MSPSI35008,SCUOLA SECONDARIA II GRADO,2,7,7,0,0,0
202223,CL1E00500Q,SCUOLA PRIMARIA,5,9,9,0,0,0
202223,CA1E020006,SCUOLA PRIMARIA,4,21,20,1,1,0
202223,NA1E165001,SCUOLA PRIMARIA,5,8,8,0,0,0
202223,MB1E04100V,SCUOLA PRIMARIA,5,56,55,1,0,1
202223,MB1E03500G,SCUOLA PRIMARIA,3,41,40,1,0,1
202223,BGSLN6500G,SCUOLA SECONDARIA II GRADO,3,28,27,1,1,0
202223,TO1M00600X,SCUOLA SECONDARIA I GRADO,1,24,22,2,1,1
202223,BS1EUE5000,SCUOLA PRIMARIA,5,5,5,0,0,0
202223,SSTD015004,SCUOLA SECONDARIA II GRADO,1,3,3,0,0,0
202223,PR1M00600C,SCUOLA SECONDARIA I GRADO,2,41,41,0,0,0
202223,RMPC44500B,SCUOLA SECONDARIA II GRADO,5,32,32,0,0,0
202223,NA1E134009,SCUOLA PRIMARIA,1,12,12,0,0,0
202223,CT1E016007,SCUOLA PRIMARIA,5,45,45,0,0,0
202223,MIPSN6500B,SCUOLA SECONDARIA II GRADO,5,20,20,0,0,0
202223,MBPS67500C,SCUOLA SECONDARIA II GRADO,1,22,22,0,0,0
202223,SO1M00100Q,SCUOLA SECONDARIA I GRADO,2,18,18,0,0,0
202223,CE1E049008,SCUOLA PRIMARIA,4,11,10,1,0,1
202223,VA1M018004,SCUOLA SECONDARIA I GRADO,2,3,2,1,0,1
202223,SA1E004003,SCUOLA PRIMARIA,1,19,19,0,0,0
202223,VAPS92500G,SCUOLA SECONDARIA II GRADO,2,22,22,0,0,0
202223,BO1E01000N,SCUOLA PRIMARIA,3,24,24,0,0,0
202223,CB1E00100B,SCUOLA PRIMARIA,4,13,11,2,0,2
202223,CO1E00200G,SCUOLA PRIMARIA,5,26,26,0,0,0
202223,VRTN01500C,SCUOLA SECONDARIA II GRADO,1,5,5,0,0,0
202223,UD1E00300X,SCUOLA PRIMARIA,3,18,16,2,1,1
202223,BR1E001002,SCUOLA PRIMARIA,5,16,16,0,0,0
202223,CRPS02500L,SCUOLA SECONDARIA II GRADO,2,19,18,1,1,0
202223,TO1E00800A,SCUOLA PRIMARIA,3,16,16,0,0,0
202223,LITD02500G,SCUOLA SECONDARIA II GRADO,4,15,14,1,0,1
202223,NARI11500A,SCUOLA SECONDARIA II GRADO,5,10,10,0,0,0
202223,RM1E19600G,SCUOLA PRIMARIA,5,16,15,1,0,1
202223,CA1M01500X,SCUOLA SECONDARIA I GRADO,2,32,32,0,0,0
202223,CS1E00500N,SCUOLA PRIMARIA,2,15,12,3,2,1
202223,AGTA56500L,SCUOLA SECONDARIA II GRADO,5,35,35,0,0,0
202223,NA1E07700A,SCUOLA PRIMARIA,1,18,18,0,0,0
202223,SP1E003004,SCUOLA PRIMARIA,5,25,25,0,0,0
202223,ANPM3A500M,SCUOLA SECONDARIA II GRADO,5,22,21,1,1,0
202223,PG1MB2500Q,SCUOLA SECONDARIA I GRADO,3,21,21,0,0,0
202223,VA1E00700C,SCUOLA PRIMARIA,1,32,31,1,1,0
202223,NA1E023002,SCUOLA PRIMARIA,3,9,7,2,0,2
202223,PDPC01500T,SCUOLA SECONDARIA II GRADO,2,16,16,0,0,0
202223,NATD59500D,SCUOLA SECONDARIA II GRADO,4,19,19,0,0,0
202223,PA1E006005,SCUOLA PRIMARIA,2,12,8,4,1,3
202223,SAPMP9500T,SCUOLA SECONDARIA II GRADO,5,70,66,4,1,3
202223,BSSL01500D,SCUOLA SECONDARIA II GRADO,4,13,13,0,0,0
202223,MI1E070002,SCUOLA PRIMARIA,5,30,27,3,1,2
202223,RM1E015002,SCUOLA PRIMARIA,4,28,26,2,0,2
202223,SRRHFP500H,SCUOLA SECONDARIA II GRADO,5,28,28,0,0,0
202223,PG1E00500A,SCUOLA PRIMARIA,3,15,13,2,0,2
202223,SSPQC7500O,SCUOLA SECONDARIA II GRADO,2,2,2,0,0,0
202223,NARHA8500Q,SCUOLA SECONDARIA II GRADO,4,12,12,0,0,0
202223,RM1E21500Q,SCUOLA PRIMARIA,4,17,15,2,0,2
202223,BG1M02500P,SCUOLA SECONDARIA I GRADO,1,16,16,0,0,0
202223,NA1E24900X,SCUOLA PRIMARIA,3,19,19,0,0,0
202223,NA1E242005,SCUOLA PRIMARIA,4,11,11,0,0,0
202223,RM1E13100R,SCUOLA PRIMARIA,5,20,17,3,0,3
202223,ENSD01500A,SCUOLA SECONDARIA II GRADO,5,23,23,0,0,0
202223,NA1E11600Q,SCUOLA PRIMARIA,4,15,15,0,0,0
202223,RM1MZQ500O,SCUOLA SECONDARIA I GRADO,3,17,17,0,0,0
202223,GO1E002006,SCUOLA PRIMARIA,1,5,5,0,0,0
202223,COTN025007,SCUOLA SECONDARIA II GRADO,4,14,14,0,0,0
202223,BA1E026008,SCUOLA PRIMARIA,1,18,17,1,0,1
202223,LISL00500B,SCUOLA SECONDARIA II GRADO,1,5,4,1,0,1
202223,PVSL015009,SCUOLA SECONDARIA II GRADO,5,3,3,0,0,0
202223,APPS9N5001,SCUOLA SECONDARIA II GRADO,4,5,5,0,0,0
202223,TO1E04800R,SCUOLA PRIMARIA,5,16,16,0,0,0
202223,NAPMRP500S,SCUOLA SECONDARIA II GRADO,4,2,2,0,0,0
202223,PG1M001008,SCUOLA SECONDARIA I GRADO,1,17,16,1,0,1
202223,TA1E003008,SCUOLA PRIMARIA,3,18,18,0,0,0
202223,FO1E00400N,SCUOLA PRIMARIA,1,50,50,0,0,0
202223,MESD01500T,SCUOLA SECONDARIA II GRADO,1,21,18,3,2,1
202223,MITD73500S,SCUOLA SECONDARIA II GRADO,1,24,22,2,0,2
202223,VATFME500R,SCUOLA SECONDARIA II GRADO,3,10,9,1,0,1
202223,TVPM8T500U,SCUOLA SECONDARIA II GRADO,4,13,13,0,0,0
202223,NATFIQ500E,SCUOLA SECONDARIA II GRADO,3,2,2,0,0,0
202223,MIPC04500B,SCUOLA SECONDARIA II GRADO,5,47,47,0,0,0
202223,ENRH5C5006,SCUOLA SECONDARIA II GRADO,4,1,1,0,0,0
202223,PC1MD1500G,SCUOLA SECONDARIA I GRADO,2,6,6,0,0,0
202223,MI1E12000T,SCUOLA PRIMARIA,4,10,10,0,0,0
202223,NATFUA500M,SCUOLA SECONDARIA II GRADO,1,3,3,0,0,0
202223,NATL83500Z,SCUOLA SECONDARIA II GRADO,2,10,10,0,0,0
202223,NA1E065004,SCUOLA PRIMARIA,1,23,19,4,0,4
202223,CSRH5I5000,SCUOLA SECONDARIA II GRADO,5,40,39,1,0,1
202223,VR1E01000A,SCUOLA PRIMARIA,2,24,20,4,3,1
202223,TAPS02500A,SCUOLA SECONDARIA II GRADO,2,6,6,0,0,0
202223,CETF8R5001,SCUOLA SECONDARIA II GRADO,1,8,7,1,0,1
202223,BSPS01500L,SCUOLA SECONDARIA II GRADO,5,22,21,1,0,1
202223,VE1E01100E,SCUOLA PRIMARIA,5,21,21,0,0,0
202223,BSPSO5500G,SCUOLA SECONDARIA II GRADO,2,12,12,0,0,0
202223,VATD18500G,SCUOLA SECONDARIA II GRADO,2,8,8,0,0,0
202223,SATL04500R,SCUOLA SECONDARIA II GRADO,3,7,7,0,0,0
202223,RMPL355003,SCUOLA SECONDARIA II GRADO,4,6,5,1,1,0
202223,APTFZ6500L,SCUOLA SECONDARIA II GRADO,3,5,5,0,0,0
202223,AR1E006008,SCUOLA PRIMARIA,3,16,15,1,0,1
202223,RCTD5M5009,SCUOLA SECONDARIA II GRADO,3,12,11,1,0,1
202223,NA1E22400G,SCUOLA PRIMARIA,4,47,46,1,0,1
202223,MI1M069003,SCUOLA SECONDARIA I GRADO,1,55,52,3,1,2
202223,VI1E00500E,SCUOLA PRIMARIA,3,22,22,0,0,0
202223,GE1E00900C,SCUOLA PRIMARIA,4,33,33,0,0,0
202223,MI1E016009,SCUOLA PRIMARIA,2,32,32,0,0,0
202223,AL1E6U500H,SCUOLA PRIMARIA,5,6,6,0,0,0
202223,MIPM1C500T,SCUOLA SECONDARIA II GRADO,5,26,26,0,0,0
202223,FR1E007008,SCUOLA PRIMARIA,3,15,15,0,0,0
202223,NA1E20200P,SCUOLA PRIMARIA,2,10,10,0,0,0
202223,RGTD105002,SCUOLA SECONDARIA II GRADO,4,1,1,0,0,0
202223,SA1E00600P,SCUOLA PRIMARIA,1,11,11,0,0,0
202223,RM1EII500V,SCUOLA PRIMARIA,2,2,2,0,0,0
202223,SATLO6500Z,SCUOLA SECONDARIA II GRADO,1,2,2,0,0,0
202223,PAPMB55005,SCUOLA SECONDARIA II GRADO,3,12,12,0,0,0
202223,NATDLM500R,SCUOLA SECONDARIA II GRADO,3,10,10,0,0,0
202223,SATFU9500P,SCUOLA SECONDARIA II GRADO,2,2,2,0,0,0
202223,RMPST6500P,SCUOLA SECONDARIA II GRADO,4,11,11,0,0,0
202223,FG1E01200P,SCUOLA PRIMARIA,3,13,13,0,0,0
202223,BA1E018009,SCUOLA PRIMARIA,4,58,57,1,0,1
202223,BG1E006004,SCUOLA PRIMARIA,4,45,41,4,0,4
202223,RA1M00200R,SCUOLA SECONDARIA I GRADO,1,34,30,4,2,2
202223,TORI05500A,SCUOLA SECONDARIA II GRADO,5,5,4,1,1,0
202223,TO1E02700Q,SCUOLA PRIMARIA,5,50,42,8,3,5
202223,SIPS01500C,SCUOLA SECONDARIA II GRADO,3,12,11,1,0,1
202223,NARF2D500G,SCUOLA SECONDARIA II GRADO,4,5,5,0,0,0
202223,RM1ERR500T,SCUOLA PRIMARIA,2,15,11,4,0,4
202223,RM1EQM5004,SCUOLA PRIMARIA,5,16,16,0,0,0
202223,AVPSPT500F,SCUOLA SECONDARIA II GRADO,1,1,1,0,0,0
202223,PAPL6T500Q,SCUOLA SECONDARIA II GRADO,5,14,14,0,0,0
202223,MI1M104005,SCUOLA SECONDARIA I GRADO,3,20,19,1,0,1
202223,TOPQ475003,SCUOLA SECONDARIA II GRADO,3,17,16,1,0,1
202223,RM1E11500V,SCUOLA PRIMARIA,1,78,77,1,0,1
202223,BLPMMN5000,SCUOLA SECONDARIA II GRADO,3,8,8,0,0,0
202223,RM1M04100Q,SCUOLA SECONDARIA I GRADO,2,26,24,2,0,2
202223,RM1M110001,SCUOLA SECONDARIA I GRADO,1,14,9,5,0,5
202223,PVPL045003,SCUOLA SECONDARIA II GRADO,4,2,2,0,0,0
202223,CN1E001003,SCUOLA PRIMARIA,5,33,30,3,0,3
202223,NARF0C5004,SCUOLA SECONDARIA II GRADO,5,96,87,9,0,9
202223,CE1E044005,SCUOLA PRIMARIA,3,16,16,0,0,0
202223,NAPM015009,SCUOLA SECONDARIA II GRADO,2,20,20,0,0,0
202223,VE1E00200Q,SCUOLA PRIMARIA,1,22,22,0,0,0
202223,TS1M003003,SCUOLA SECONDARIA I GRADO,2,11,10,1,0,1
202223,FRTFF6500V,SCUOLA SECONDARIA II GRADO,1,2,2,0,0,0
202223,VAPL06500C,SCUOLA SECONDARIA II GRADO,3,5,3,2,0,2
202223,RM1M01400B,SCUOLA SECONDARIA I GRADO,3,27,23,4,0,4
202223,TO1EDV500F,SCUOLA PRIMARIA,4,15,15,0,0,0
202223,SATDVQ500D,SCUOLA SECONDARIA II GRADO,2,6,6,0,0,0
202223,PR1M002005,SCUOLA SECONDARIA I GRADO,3,35,35,0,0,0
202223,KR1E002001,SCUOLA PRIMARIA,4,15,13,2,2,0
202223,FI1E005008,SCUOLA PRIMARIA,2,14,10,4,1,3
202223,PA1MB95007,SCUOLA SECONDARIA I GRADO,1,53,51,2,0,2
202223,NA1E13700R,SCUOLA PRIMARIA,3,14,14,0,0,0
202223,NAPMVM500H,SCUOLA SECONDARIA II GRADO,5,9,9,0,0,0
202223,LCPSU45004,SCUOLA SECONDARIA II GRADO,2,10,10,0,0,0
202223,FRRFL1500I,SCUOLA SECONDARIA II GRADO,5,68,64,4,2,2
202223,LTPM4Q5001,SCUOLA SECONDARIA II GRADO,3,2,2,0,0,0
202223,GE1M01700L,SCUOLA SECONDARIA I GRADO,1,38,30,8,0,8
202223,RMPLUU500N,SCUOLA SECONDARIA II GRADO,2,19,15,4,1,3
202223,MI1E08700B,SCUOLA PRIMARIA,3,70,69,1,0,1
202223,RE1E001006,SCUOLA PRIMARIA,4,24,24,0,0,0
202223,RMSLVB5007,SCUOLA SECONDARIA II GRADO,2,8,8,0,0,0
202223,PI1E00300B,SCUOLA PRIMARIA,1,16,16,0,0,0
202223,RM1E044002,SCUOLA PRIMARIA,3,39,39,0,0,0
202223,TV1M00400L,SCUOLA SECONDARIA I GRADO,1,157,156,1,0,1
202223,BO1M007003,SCUOLA SECONDARIA I GRADO,1,105,94,11,2,9
202223,FI1M028006,SCUOLA SECONDARIA I GRADO,3,17,10,7,0,7
202223,PAPS05500G,SCUOLA SECONDARIA II GRADO,3,21,20,1,0,1
202223,LT1E00800Q,SCUOLA PRIMARIA,3,14,14,0,0,0
202223,MB1E029008,SCUOLA PRIMARIA,2,56,56,0,0,0
202223,BG1M00900R,SCUOLA SECONDARIA I GRADO,3,54,53,1,1,0
202223,NA1E028005,SCUOLA PRIMARIA,3,12,12,0,0,0
202223,CTPS09500D,SCUOLA SECONDARIA II GRADO,2,5,5,0,0,0
202223,BNRHN2500D,SCUOLA SECONDARIA II GRADO,4,16,15,1,0,1
202223,RM1MST500V,SCUOLA SECONDARIA I GRADO,2,9,7,2,0,2
202223,BS1E00100D,SCUOLA PRIMARIA,2,25,23,2,0,2
202223,BG1E00700X,SCUOLA PRIMARIA,4,49,44,5,1,4
202223,TPTDS9500A,SCUOLA SECONDARIA II GRADO,1,3,3,0,0,0
202223,RMPS655007,SCUOLA SECONDARIA II GRADO,2,6,6,0,0,0
202223,TO1E053008,SCUOLA PRIMARIA,3,27,27,0,0,0
202223,TO1E04200T,SCUOLA PRIMARIA,5,42,40,2,0,2
202223,NO1M01400B,SCUOLA SECONDARIA I GRADO,1,22,20,2,1,1
202223,RM1E10200R,SCUOLA PRIMARIA,1,29,29,0,0,0
202223,FIPC05500B,SCUOLA SECONDARIA II GRADO,3,4,4,0,0,0
202223,MIPMGC500D,SCUOLA SECONDARIA II GRADO,1,25,24,1,1,0
202223,MIPS055005,SCUOLA SECONDARIA II GRADO,3,34,34,0,0,0
202223,SA1E011006,SCUOLA PRIMARIA,4,13,12,1,0,1
202223,LTPLCG500C,SCUOLA SECONDARIA II GRADO,5,32,32,0,0,0
202223,RMPC29500P,SCUOLA SECONDARIA II GRADO,4,20,20,0,0,0
202223,PA1E048007,SCUOLA PRIMARIA,2,46,44,2,0,2
202223,AVTF125004,SCUOLA SECONDARIA II GRADO,1,7,7,0,0,0
202223,FIPL085005,SCUOLA SECONDARIA II GRADO,4,3,3,0,0,0
202223,VAPSVA500Z,SCUOLA SECONDARIA II GRADO,3,24,23,1,0,1
202223,NAPS4U500S,SCUOLA SECONDARIA II GRADO,3,18,16,2,0,2
202223,CA1E012007,SCUOLA PRIMARIA,2,20,19,1,0,1
202223,TR1M00100X,SCUOLA SECONDARIA I GRADO,2,18,18,0,0,0
202223,RM1E02600C,SCUOLA PRIMARIA,5,66,64,2,0,2
202223,MB1E032004,SCUOLA PRIMARIA,4,23,22,1,0,1
202223,SAPS8F500U,SCUOLA SECONDARIA II GRADO,1,4,3,1,0,1
202223,FI1E02300T,SCUOLA PRIMARIA,5,19,16,3,1,2
202223,VIPLVN5005,SCUOLA SECONDARIA II GRADO,3,18,17,1,1,0
202223,CTTD37500P,SCUOLA SECONDARIA II GRADO,5,10,10,0,0,0
202223,PATD12500C,SCUOLA SECONDARIA II GRADO,3,7,7,0,0,0
202223,MITD25500P,SCUOLA SECONDARIA II GRADO,1,13,12,1,0,1
202223,VAPMCL500Q,SCUOLA SECONDARIA II GRADO,5,21,21,0,0,0
202223,VAPLVL5003,SCUOLA SECONDARIA II GRADO,1,11,11,0,0,0
202223,AVTF6H500N,SCUOLA SECONDARIA II GRADO,4,3,3,0,0,0
202223,BNTDDC500S,SCUOLA SECONDARIA II GRADO,2,2,2,0,0,0
202223,VRPS09500G,SCUOLA SECONDARIA II GRADO,4,18,17,1,1,0
202223,GO1MGQ500P,SCUOLA SECONDARIA I GRADO,2,7,7,0,0,0
202223,MOPS02500E,SCUOLA SECONDARIA II GRADO,1,15,15,0,0,0
202223,NAPSF2500E,SCUOLA SECONDARIA II GRADO,2,14,14,0,0,0
202223,UD1E001008,SCUOLA PRIMARIA,3,19,19,0,0,0
202223,ANPS025003,SCUOLA SECONDARIA II GRADO,5,4,4,0,0,0
202223,TO1E01400N,SCUOLA PRIMARIA,3,22,18,4,2,2
202223,MI1EAE500E,SCUOLA PRIMARIA,1,16,14,2,1,1
202223,SAPSM3500V,SCUOLA SECONDARIA II GRADO,5,55,51,4,1,3
202223,SAPS9B500T,SCUOLA SECONDARIA II GRADO,2,4,3,1,0,1
202223,RM1E01100P,SCUOLA PRIMARIA,4,27,26,1,0,1
202223,RNTL025002,SCUOLA SECONDARIA II GRADO,4,3,3,0,0,0
202223,CETF6B500H,SCUOLA SECONDARIA II GRADO,1,4,3,1,0,1
202223,PR1E00900P,SCUOLA PRIMARIA,5,22,21,1,0,1
202223,NA1E218008,SCUOLA PRIMARIA,1,9,9,0,0,0
202223,SAPC005001,SCUOLA SECONDARIA II GRADO,1,4,4,0,0,0
202223,TO1E03600E,SCUOLA PRIMARIA,2,48,30,18,8,10
202223,RE1M002007,SCUOLA SECONDARIA I GRADO,2,44,44,0,0,0
202223,AL1E005002,SCUOLA PRIMARIA,3,35,32,3,0,3
202223,FI1E06100L,SCUOLA PRIMARIA,5,24,23,1,0,1
202223,RM1E086004,SCUOLA PRIMARIA,2,6,2,4,0,4
202223,VA1E01500B,SCUOLA PRIMARIA,4,47,46,1,0,1
202223,BOPSPA5006,SCUOLA SECONDARIA II GRADO,1,28,28,0,0,0
202223,VT1M003003,SCUOLA SECONDARIA I GRADO,3,17,17,0,0,0
202223,RNTD02500G,SCUOLA SECONDARIA II GRADO,5,25,20,5,1,4
202223,LU1E002008,SCUOLA PRIMARIA,3,15,14,1,1,0
202223,NA1ESQ5001,SCUOLA PRIMARIA,4,2,2,0,0,0
202223,CTPC01500D,SCUOLA SECONDARIA II GRADO,2,7,7,0,0,0
202223,BGPL055009,SCUOLA SECONDARIA II GRADO,1,6,6,0,0,0
202223,NA1E05400N,SCUOLA PRIMARIA,1,46,44,2,1,1
202223,VR1E017005,SCUOLA PRIMARIA,4,23,22,1,1,0
202223,RM1E127005,SCUOLA PRIMARIA,1,38,36,2,0,2
202223,NATDB75009,SCUOLA SECONDARIA II GRADO,3,11,11,0,0,0
202223,MI1E04200T,SCUOLA PRIMARIA,2,48,46,2,0,2
202223,RM1M09900B,SCUOLA SECONDARIA I GRADO,3,84,84,0,0,0
202223,MI1M08000T,SCUOLA SECONDARIA I GRADO,1,133,128,5,0,5
202223,LI1M00600A,SCUOLA SECONDARIA I GRADO,3,34,32,2,0,2
202223,RMPSHQ500O,SCUOLA SECONDARIA II GRADO,3,15,15,0,0,0
202223,LOPS01500A,SCUOLA SECONDARIA II GRADO,4,16,16,0,0,0
202223,RMPS355008,SCUOLA SECONDARIA II GRADO,2,40,40,0,0,0
202223,TO1E032007,SCUOLA PRIMARIA,2,14,12,2,0,2
202223,SA1E02900B,SCUOLA PRIMARIA,1,43,41,2,0,2
202223,RM1E078005,SCUOLA PRIMARIA,3,39,38,1,0,1
202223,PG1E00300P,SCUOLA PRIMARIA,4,30,30,0,0,0
202223,PV1E00600C,SCUOLA PRIMARIA,4,17,15,2,1,1
202223,SA1E02200L,SCUOLA PRIMARIA,4,12,12,0,0,0
202223,MERH015005,SCUOLA SECONDARIA II GRADO,2,3,3,0,0,0
202223,NA1E03200R,SCUOLA PRIMARIA,5,14,13,1,0,1
202223,NA1E24000D,SCUOLA PRIMARIA,4,9,9,0,0,0
202223,CZ1M002007,SCUOLA SECONDARIA I GRADO,2,16,16,0,0,0
202223,PD1E01000L,SCUOLA PRIMARIA,2,46,46,0,0,0
202223,CR1E00700T,SCUOLA PRIMARIA,5,23,22,1,0,1
202223,APPMOI500F,SCUOLA SECONDARIA II GRADO,3,2,2,0,0,0
202223,RMPS285007,SCUOLA SECONDARIA II GRADO,5,19,18,1,0,1
202223,RMTNIF500Z,SCUOLA SECONDARIA II GRADO,4,5,5,0,0,0
202223,VR1E00600P,SCUOLA PRIMARIA,3,45,43,2,1,1
202223,BO1M01000V,SCUOLA SECONDARIA I GRADO,1,46,45,1,0,1
202223,BGSLQP500D,SCUOLA SECONDARIA II GRADO,3,10,10,0,0,0
202223,MEPS01500B,SCUOLA SECONDARIA II GRADO,4,10,9,1,0,1
202223,RMPC355005,SCUOLA SECONDARIA II GRADO,2,15,15,0,0,0
202223,NATF6F5005,SCUOLA SECONDARIA II GRADO,5,140,140,0,0,0
202223,COSL02500A,SCUOLA SECONDARIA II GRADO,2,3,3,0,0,0
202223,RM1E15200T,SCUOLA PRIMARIA,4,26,23,3,1,2
202223,SATF795007,SCUOLA SECONDARIA II GRADO,4,9,9,0,0,0
202223,PATD33500R,SCUOLA SECONDARIA II GRADO,4,3,3,0,0,0
202223,PD1E00200N,SCUOLA PRIMARIA,4,14,12,2,1,1
202223,MIPSPS500G,SCUOLA SECONDARIA II GRADO,3,10,10,0,0,0
202223,RMSL5N500U,SCUOLA SECONDARIA II GRADO,3,5,5,0,0,0
202223,MBPS23500E,SCUOLA SECONDARIA II GRADO,4,13,13,0,0,0
202223,PVPMF55003,SCUOLA SECONDARIA II GRADO,1,7,7,0,0,0
202223,TO1E00800A,SCUOLA PRIMARIA,2,9,8,1,0,1
202223,NATD455002,SCUOLA SECONDARIA II GRADO,2,3,3,0,0,0
202223,MI1E14300E,SCUOLA PRIMARIA,1,16,11,5,2,3
202223,TATD06500L,SCUOLA SECONDARIA II GRADO,1,3,3,0,0,0
202223,MI1E02100R,SCUOLA PRIMARIA,1,28,28,0,0,0
202223,RG1E00700Q,SCUOLA PRIMARIA,4,22,22,0,0,0
202223,FO1E002002,SCUOLA PRIMARIA,1,12,11,1,0,1
202223,VATN01500A,SCUOLA SECONDARIA II GRADO,3,13,11,2,0,2
202223,CO1M02300T,SCUOLA SECONDARIA I GRADO,1,27,27,0,0,0
202223,NATFD05003,SCUOLA SECONDARIA II GRADO,5,137,137,0,0,0
202223,COPM02500E,SCUOLA SECONDARIA II GRADO,5,23,23,0,0,0
202223,CN1E00300P,SCUOLA PRIMARIA,5,21,20,1,0,1
202223,VT1E00500D,SCUOLA PRIMARIA,1,23,21,2,0,2
202223,UD1MC15002,SCUOLA SECONDARIA I GRADO,1,17,17,0,0,0
202223,CSTF6C500B,SCUOLA SECONDARIA II GRADO,3,2,2,0,0,0
202223,ATPL01500N,SCUOLA SECONDARIA II GRADO,4,9,9,0,0,0
202223,MIPS445002,SCUOLA SECONDARIA II GRADO,3,23,23,0,0,0
202223,MIPSI5500T,SCUOLA SECONDARIA II GRADO,1,8,8,0,0,0
202223,MBPC215006,SCUOLA SECONDARIA II GRADO,2,16,16,0,0,0
202223,RM1E19500Q,SCUOLA PRIMARIA,2,20,18,2,0,2
202223,RMPS36500V,SCUOLA SECONDARIA II GRADO,4,12,11,1,0,1
202223,NA1E05900R,SCUOLA PRIMARIA,2,27,27,0,0,0
202223,RE1E002002,SCUOLA PRIMARIA,5,73,67,6,2,4
202223,GE1E01500Q,SCUOLA PRIMARIA,4,10,9,1,1,0
202223,RGPL025009,SCUOLA SECONDARIA II GRADO,5,10,7,3,0,3
202223,CERI59500T,SCUOLA SECONDARIA II GRADO,3,34,34,0,0,0
202223,NARH05500C,SCUOLA SECONDARIA II GRADO,4,2,1,1,1,0
202223,MI1E076001,SCUOLA PRIMARIA,5,24,24,0,0,0
202223,BG1M02500P,SCUOLA SECONDARIA I GRADO,2,32,31,1,0,1
202223,COPL01500N,SCUOLA SECONDARIA II GRADO,4,11,11,0,0,0
202223,RMPSPG500N,SCUOLA SECONDARIA II GRADO,4,22,22,0,0,0
202223,FG1E023005,SCUOLA PRIMARIA,3,22,22,0,0,0
202223,RMTD70500E,SCUOLA SECONDARIA II GRADO,2,13,13,0,0,0
202223,MI1E06300V,SCUOLA PRIMARIA,5,23,5,18,0,18
202223,RM1E022005,SCUOLA PRIMARIA,2,14,12,2,0,2
202223,CAPQ00500E,SCUOLA SECONDARIA II GRADO,4,14,14,0,0,0
202223,NA1E18900D,SCUOLA PRIMARIA,5,43,43,0,0,0
202223,RM1E03800P,SCUOLA PRIMARIA,2,8,3,5,0,5
202223,NAPSP85001,SCUOLA SECONDARIA II GRADO,4,2,2,0,0,0
202223,BO1E01700C,SCUOLA PRIMARIA,1,53,52,1,1,0
202223,NAPMRP500S,SCUOLA SECONDARIA II GRADO,5,140,129,11,1,10
202223,VI1E008002,SCUOLA PRIMARIA,3,9,7,2,0,2
202223,VA1E011004,SCUOLA PRIMARIA,4,18,18,0,0,0
202223,RM1M00900X,SCUOLA SECONDARIA I GRADO,1,31,25,6,3,3
202223,NARFRT500R,SCUOLA SECONDARIA II GRADO,5,105,95,10,0,10
202223,CT1M02400B,SCUOLA SECONDARIA I GRADO,3,26,25,1,0,1
202223,NA1E25200Q,SCUOLA PRIMARIA,5,11,10,1,0,1
202223,RMPSMF500G,SCUOLA SECONDARIA II GRADO,3,25,25,0,0,0
202223,FE1E00200D,SCUOLA PRIMARIA,2,24,24,0,0,0
202223,NA1E121007,SCUOLA PRIMARIA,1,19,19,0,0,0
202223,CE1E07100D,SCUOLA PRIMARIA,1,8,8,0,0,0
202223,MBTD35500C,SCUOLA SECONDARIA II GRADO,1,15,15,0,0,0
202223,NA1E086005,SCUOLA PRIMARIA,4,24,24,0,0,0
202223,RM1M2E5007,SCUOLA SECONDARIA I GRADO,3,8,8,0,0,0
202223,MS1E00400V,SCUOLA PRIMARIA,2,12,12,0,0,0
202223,MN1E001004,SCUOLA PRIMARIA,4,10,8,2,0,2
202223,CHTL31500X,SCUOLA SECONDARIA II GRADO,4,3,3,0,0,0
202223,NO1E006007,SCUOLA PRIMARIA,4,51,49,2,1,1
202223,NA1MVQ500R,SCUOLA SECONDARIA I GRADO,1,1,1,0,0,0
202223,LETD075009,SCUOLA SECONDARIA II GRADO,4,4,4,0,0,0
202223,CE1E052004,SCUOLA PRIMARIA,4,19,18,1,0,1
202223,SATF09500P,SCUOLA SECONDARIA II GRADO,3,8,8,0,0,0
202223,MITDGN5002,SCUOLA SECONDARIA II GRADO,5,29,24,5,0,5
202223,PR1M00500L,SCUOLA SECONDARIA I GRADO,1,48,46,2,0,2
202223,PA1E035005,SCUOLA PRIMARIA,1,38,38,0,0,0
202223,PRPS70500U,SCUOLA SECONDARIA II GRADO,2,17,17,0,0,0
202223,RMRH12500C,SCUOLA SECONDARIA II GRADO,5,13,12,1,1,0
202223,FE1E8D500F,SCUOLA PRIMARIA,3,19,18,1,0,1
202223,MS1E00100B,SCUOLA PRIMARIA,1,22,22,0,0,0
202223,CHTD07500E,SCUOLA SECONDARIA II GRADO,3,1,1,0,0,0
202223,MI1M069003,SCUOLA SECONDARIA I GRADO,2,42,37,5,1,4
202223,NA1E17900V,SCUOLA PRIMARIA,4,10,10,0,0,0
202223,LCTDVP5000,SCUOLA SECONDARIA II GRADO,2,15,14,1,1,0
202223,CE1E04100N,SCUOLA PRIMARIA,1,11,11,0,0,0
202223,TV1E01000P,SCUOLA PRIMARIA,4,48,46,2,2,0
202223,RMPL0L500V,SCUOLA SECONDARIA II GRADO,4,6,6,0,0,0
202223,TS1E007005,SCUOLA PRIMARIA,1,10,10,0,0,0
202223,FGTD095004,SCUOLA SECONDARIA II GRADO,4,8,7,1,0,1
202223,BSPS3I500U,SCUOLA SECONDARIA II GRADO,4,18,17,1,0,1
202223,VE1E00400B,SCUOLA PRIMARIA,2,35,25,10,0,10
202223,SATLRU500B,SCUOLA SECONDARIA II GRADO,5,66,61,5,2,3
202223,RM1E12300T,SCUOLA PRIMARIA,5,54,54,0,0,0
202223,RMPLA95002,SCUOLA SECONDARIA II GRADO,4,17,15,2,0,2
202223,APTD5L500H,SCUOLA SECONDARIA II GRADO,5,59,58,1,0,1
202223,VRPS025009,SCUOLA SECONDARIA II GRADO,2,75,73,2,1,1
202223,RM1M07100G,SCUOLA SECONDARIA I GRADO,3,75,72,3,2,1
202223,RMTB035009,SCUOLA SECONDARIA II GRADO,4,36,32,4,1,3
202223,MB1M01500G,SCUOLA SECONDARIA I GRADO,2,27,27,0,0,0
202223,MI1M05800L,SCUOLA SECONDARIA I GRADO,1,38,35,3,0,3
202223,MI1M070007,SCUOLA SECONDARIA I GRADO,3,31,25,6,0,6
202223,SR1E00600R,SCUOLA PRIMARIA,2,19,19,0,0,0
202223,LC1M020004,SCUOLA SECONDARIA I GRADO,2,22,21,1,1,0
202223,NA1MTL500Q,SCUOLA SECONDARIA I GRADO,2,25,25,0,0,0
202223,MI1E018001,SCUOLA PRIMARIA,3,19,19,0,0,0
202223,AL1E00100P,SCUOLA PRIMARIA,5,56,55,1,1,0
202223,PAPSVD500Q,SCUOLA SECONDARIA II GRADO,4,14,14,0,0,0
202223,CTTD045008,SCUOLA SECONDARIA II GRADO,5,10,9,1,0,1
202223,PO1E005008,SCUOLA PRIMARIA,2,17,11,6,0,6
202223,NARH3Z5008,SCUOLA SECONDARIA II GRADO,4,1,1,0,0,0
202223,PR1E00200X,SCUOLA PRIMARIA,4,25,25,0,0,0
202223,UDTBCH500I,SCUOLA SECONDARIA II GRADO,2,15,13,2,0,2
202223,AQ1E00600N,SCUOLA PRIMARIA,4,19,18,1,1,0
202223,VARFIU5007,SCUOLA SECONDARIA II GRADO,5,9,8,1,0,1
202223,CR1M00300Q,SCUOLA SECONDARIA I GRADO,2,58,55,3,1,2
202223,CA1E019002,SCUOLA PRIMARIA,3,14,12,2,0,2
202223,TOTB025006,SCUOLA SECONDARIA II GRADO,3,17,15,2,1,1
202223,RM1E04200A,SCUOLA PRIMARIA,3,18,16,2,0,2
202223,SRPL005001,SCUOLA SECONDARIA II GRADO,3,8,8,0,0,0
202223,MB1E06800V,SCUOLA PRIMARIA,2,12,10,2,0,2
202223,AGTF825005,SCUOLA SECONDARIA II GRADO,5,44,44,0,0,0
202223,FI1M010001,SCUOLA SECONDARIA I GRADO,2,17,10,7,1,6
202223,SATD295005,SCUOLA SECONDARIA II GRADO,4,8,7,1,0,1
202223,TV1M01100Q,SCUOLA SECONDARIA I GRADO,3,104,103,1,0,1
202223,COTAV75005,SCUOLA SECONDARIA II GRADO,1,20,20,0,0,0
202223,NA1E23700N,SCUOLA PRIMARIA,3,16,16,0,0,0
202223,RC1E01000Q,SCUOLA PRIMARIA,1,15,15,0,0,0
202223,MIPM04500G,SCUOLA SECONDARIA II GRADO,1,39,38,1,0,1
202223,RM1M04900A,SCUOLA SECONDARIA I GRADO,2,32,31,1,0,1
202223,GERI015006,SCUOLA SECONDARIA II GRADO,2,41,31,10,1,9
202223,MI1E024008,SCUOLA PRIMARIA,4,27,26,1,0,1
202223,NAPS92500P,SCUOLA SECONDARIA II GRADO,5,49,43,6,0,6
202223,CERHD15005,SCUOLA SECONDARIA II GRADO,1,9,9,0,0,0
202223,NATL145007,SCUOLA SECONDARIA II GRADO,5,19,18,1,0,1
202223,APPCV8500G,SCUOLA SECONDARIA II GRADO,2,2,2,0,0,0
202223,RN1E001002,SCUOLA PRIMARIA,4,34,33,1,0,1
202223,AGPSFG5009,SCUOLA SECONDARIA II GRADO,2,5,5,0,0,0
202223,PETF005003,SCUOLA SECONDARIA II GRADO,1,3,3,0,0,0
202223,SATDP9500M,SCUOLA SECONDARIA II GRADO,4,2,2,0,0,0
202223,VRPS055005,SCUOLA SECONDARIA II GRADO,4,51,49,2,0,2
202223,BNTDOO5001,SCUOLA SECONDARIA II GRADO,1,5,0,5,0,5
202223,NATF15500N,SCUOLA SECONDARIA II GRADO,5,192,191,1,0,1
202223,BO1E00100V,SCUOLA PRIMARIA,2,24,22,2,0,2
202223,MI1E08700B,SCUOLA PRIMARIA,4,94,94,0,0,0
202223,NA1E10800R,SCUOLA PRIMARIA,3,25,24,1,0,1
202223,BLPL49500T,SCUOLA SECONDARIA II GRADO,2,10,10,0,0,0
202223,GEPQ015006,SCUOLA SECONDARIA II GRADO,5,10,10,0,0,0
202223,RM1M029005,SCUOLA SECONDARIA I GRADO,1,20,18,2,0,2
202223,PV1MPM500O,SCUOLA SECONDARIA I GRADO,2,20,19,1,0,1
202223,TATDI4500D,SCUOLA SECONDARIA II GRADO,3,10,10,0,0,0
202223,AP1MUQ500M,SCUOLA SECONDARIA I GRADO,3,2,2,0,0,0
202223,LCPL025002,SCUOLA SECONDARIA II GRADO,3,17,17,0,0,0
202223,CETDA05001,SCUOLA SECONDARIA II GRADO,4,15,13,2,1,1
202223,BSPMN8500Q,SCUOLA SECONDARIA II GRADO,5,19,19,0,0,0
202223,SV1E005006,SCUOLA PRIMARIA,1,33,33,0,0,0
202223,GE1ELE500C,SCUOLA PRIMARIA,2,17,13,4,2,2
202223,RMPM195002,SCUOLA SECONDARIA II GRADO,3,21,20,1,0,1
202223,MI1E083004,SCUOLA PRIMARIA,2,69,65,4,0,4
202223,NOTD035008,SCUOLA SECONDARIA II GRADO,4,3,3,0,0,0
202223,GEPL01500Q,SCUOLA SECONDARIA II GRADO,2,148,141,7,1,6
202223,MIPS735002,SCUOLA SECONDARIA II GRADO,3,20,20,0,0,0
202223,RMPS455005,SCUOLA SECONDARIA II GRADO,2,10,10,0,0,0
202223,SARHGL500M,SCUOLA SECONDARIA II GRADO,4,28,28,0,0,0
202223,TO1E018001,SCUOLA PRIMARIA,2,56,55,1,1,0
202223,RMPL00500B,SCUOLA SECONDARIA II GRADO,1,9,8,1,0,1
202223,VA1E009004,SCUOLA PRIMARIA,4,45,45,0,0,0
202223,VVPS2U500I,SCUOLA SECONDARIA II GRADO,3,9,9,0,0,0
202223,CTPS10500V,SCUOLA SECONDARIA II GRADO,5,7,7,0,0,0
202223,RMPM3Q500P,SCUOLA SECONDARIA II GRADO,4,14,13,1,0,1
202223,COPLNP500T,SCUOLA SECONDARIA II GRADO,3,10,9,1,0,1
202223,MI1E07900C,SCUOLA PRIMARIA,3,18,15,3,0,3
202223,NOPS03500C,SCUOLA SECONDARIA II GRADO,2,50,45,5,0,5
202223,MN1E00300Q,SCUOLA PRIMARIA,4,38,36,2,0,2
202223,MB1M01900V,SCUOLA SECONDARIA I GRADO,2,76,75,1,0,1
202223,LI1E00900L,SCUOLA PRIMARIA,2,24,24,0,0,0
202223,BATD665005,SCUOLA SECONDARIA II GRADO,4,1,1,0,0,0
202223,TO1E05100L,SCUOLA PRIMARIA,1,14,14,0,0,0
202223,TO1E03400V,SCUOLA PRIMARIA,1,47,45,2,2,0
202223,IM1E00600C,SCUOLA PRIMARIA,3,17,13,4,1,3
202223,RMPC3Q500Z,SCUOLA SECONDARIA II GRADO,3,8,8,0,0,0
202223,PA1EDC5004,SCUOLA PRIMARIA,4,13,13,0,0,0
202223,TOPS005004,SCUOLA SECONDARIA II GRADO,2,22,22,0,0,0
202223,RM1E142007,SCUOLA PRIMARIA,4,58,58,0,0,0
202223,MIPL0Z500D,SCUOLA SECONDARIA II GRADO,2,27,24,3,0,3
202223,FIPL8A500L,SCUOLA SECONDARIA II GRADO,4,8,6,2,1,1
202223,NATDAR5000,SCUOLA SECONDARIA II GRADO,2,13,13,0,0,0
202223,MITN03500N,SCUOLA SECONDARIA II GRADO,3,15,12,3,1,2
202223,RMPS03500C,SCUOLA SECONDARIA II GRADO,4,28,28,0,0,0
202223,BATD07500E,SCUOLA SECONDARIA II GRADO,3,15,14,1,0,1
202223,BSTF01500P,SCUOLA SECONDARIA II GRADO,3,21,21,0,0,0
202223,RMPSI6500C,SCUOLA SECONDARIA II GRADO,5,53,50,3,2,1
202223,VITD015006,SCUOLA SECONDARIA II GRADO,5,9,9,0,0,0
202223,SS1E01100Q,SCUOLA PRIMARIA,2,11,10,1,0,1
202223,BSPLMR500P,SCUOLA SECONDARIA II GRADO,4,28,28,0,0,0
202223,RM1E163008,SCUOLA PRIMARIA,2,29,28,1,1,0
202223,COTEA1500D,SCUOLA SECONDARIA II GRADO,3,3,2,1,0,1
202223,NA1E235002,SCUOLA PRIMARIA,5,25,25,0,0,0
202223,MI1MVA500E,SCUOLA SECONDARIA I GRADO,2,57,55,2,2,0
202223,RM1E14400V,SCUOLA PRIMARIA,5,13,11,2,0,2
202223,NA1E14400X,SCUOLA PRIMARIA,5,26,26,0,0,0
202223,BG1E019006,SCUOLA PRIMARIA,4,17,17,0,0,0
202223,MIPS375001,SCUOLA SECONDARIA II GRADO,3,51,50,1,1,0
202223,GEPSC85001,SCUOLA SECONDARIA II GRADO,5,18,17,1,0,1
202223,MBPM005002,SCUOLA SECONDARIA II GRADO,5,22,21,1,0,1
202223,TO1E012002,SCUOLA PRIMARIA,1,16,16,0,0,0
202223,RE1M002007,SCUOLA SECONDARIA I GRADO,3,46,46,0,0,0
202223,NAPCFD500P,SCUOLA SECONDARIA II GRADO,3,7,7,0,0,0
202223,SARF195006,SCUOLA SECONDARIA II GRADO,5,70,69,1,0,1
202223,FR1E003001,SCUOLA PRIMARIA,3,18,18,0,0,0
202223,RGTDCA500P,SCUOLA SECONDARIA II GRADO,5,6,5,1,1,0
202223,PAPSTT500B,SCUOLA SECONDARIA II GRADO,1,4,4,0,0,0
202223,VT1M003003,SCUOLA SECONDARIA I GRADO,2,15,15,0,0,0
202223,VAPS025007,SCUOLA SECONDARIA II GRADO,2,12,12,0,0,0
202223,RM1E15800R,SCUOLA PRIMARIA,3,16,6,10,0,10
202223,NATF545002,SCUOLA SECONDARIA II GRADO,2,4,4,0,0,0
202223,PCTD015006,SCUOLA SECONDARIA II GRADO,3,14,13,1,1,0
202223,NA1E219004,SCUOLA PRIMARIA,4,14,13,1,0,1
202223,NATABS5008,SCUOLA SECONDARIA II GRADO,1,5,5,0,0,0
202223,VEPSAM500G,SCUOLA SECONDARIA II GRADO,5,9,8,1,1,0
202223,BGPS065005,SCUOLA SECONDARIA II GRADO,1,16,15,1,1,0
202223,RM1E08200R,SCUOLA PRIMARIA,5,18,13,5,1,4
202223,VA1E02100P,SCUOLA PRIMARIA,3,81,79,2,1,1
202223,LTTD01500X,SCUOLA SECONDARIA II GRADO,4,3,3,0,0,0
202223,NA1E6E500B,SCUOLA PRIMARIA,5,17,17,0,0,0
202223,RM1E21400X,SCUOLA PRIMARIA,3,16,16,0,0,0
202223,CT1M00200E,SCUOLA SECONDARIA I GRADO,1,20,17,3,0,3
202223,BGPMC0500F,SCUOLA SECONDARIA II GRADO,4,10,10,0,0,0
202223,CO1M01800A,SCUOLA SECONDARIA I GRADO,2,43,38,5,1,4
202223,TOPC11500C,SCUOLA SECONDARIA II GRADO,4,3,3,0,0,0
202223,VASLQ8500T,SCUOLA SECONDARIA II GRADO,5,13,13,0,0,0
202223,MBRFZ6500C,SCUOLA SECONDARIA II GRADO,1,22,17,5,2,3
202223,AQ1E004002,SCUOLA PRIMARIA,1,25,24,1,1,0
202223,RCRH6N5009,SCUOLA SECONDARIA II GRADO,1,9,8,1,1,0
202223,NA1E10400D,SCUOLA PRIMARIA,2,17,17,0,0,0
202223,RM1M11800G,SCUOLA SECONDARIA I GRADO,1,77,74,3,0,3
202223,SAPM3S500H,SCUOLA SECONDARIA II GRADO,1,6,5,1,1,0
202223,MO1E2A5008,SCUOLA PRIMARIA,3,23,22,1,0,1
202223,MI1E012002,SCUOLA PRIMARIA,2,25,21,4,0,4
202223,GE1E01000L,SCUOLA PRIMARIA,4,30,29,1,0,1
202223,GE1E013004,SCUOLA PRIMARIA,3,8,8,0,0,0
202223,PTPS3N5004,SCUOLA SECONDARIA II GRADO,4,26,24,2,0,2
202223,VI1M00400X,SCUOLA SECONDARIA I GRADO,1,25,25,0,0,0
202223,PA1E034009,SCUOLA PRIMARIA,2,16,14,2,0,2
202223,CT1ELO5000,SCUOLA PRIMARIA,3,20,20,0,0,0
202223,PD1M001003,SCUOLA SECONDARIA I GRADO,3,26,24,2,0,2
202223,PAPM72500D,SCUOLA SECONDARIA II GRADO,1,2,2,0,0,0
202223,FG1E016002,SCUOLA PRIMARIA,2,12,4,8,8,0
202223,BG1EL2500G,SCUOLA PRIMARIA,1,10,10,0,0,0
202223,MNPS00500L,SCUOLA SECONDARIA II GRADO,2,17,15,2,0,2
202223,MO1E01000G,SCUOLA PRIMARIA,1,29,23,6,3,3
202223,NA1E18700T,SCUOLA PRIMARIA,1,23,15,8,7,1
202223,TOTA015004,SCUOLA SECONDARIA II GRADO,1,20,20,0,0,0
202223,VR1E011006,SCUOLA PRIMARIA,4,24,21,3,0,3
202223,CTTD215006,SCUOLA SECONDARIA II GRADO,5,15,13,2,1,1
202223,ME1M010008,SCUOLA SECONDARIA I GRADO,2,20,17,3,0,3
202223,VI1E010002,SCUOLA PRIMARIA,5,18,17,1,0,1
202223,SV1E00200P,SCUOLA PRIMARIA,1,17,17,0,0,0
202223,BNTLN2500A,SCUOLA SECONDARIA II GRADO,3,8,8,0,0,0
202223,NA1E14000L,SCUOLA PRIMARIA,1,18,18,0,0,0
202223,RM1E11100G,SCUOLA PRIMARIA,1,13,13,0,0,0
202223,RMPC24500N,SCUOLA SECONDARIA II GRADO,2,5,5,0,0,0
202223,BG1E028001,SCUOLA PRIMARIA,2,26,26,0,0,0
202223,MIPSIG500R,SCUOLA SECONDARIA II GRADO,1,35,34,1,0,1
202223,TETD00500B,SCUOLA SECONDARIA II GRADO,2,6,6,0,0,0
202223,NATD2T5008,SCUOLA SECONDARIA II GRADO,5,46,45,1,0,1
202223,NA1E165001,SCUOLA PRIMARIA,3,7,7,0,0,0
202223,SARHRM500C,SCUOLA SECONDARIA II GRADO,2,6,6,0,0,0
202223,TV1E01200A,SCUOLA PRIMARIA,3,17,17,0,0,0
202223,CE1E049008,SCUOLA PRIMARIA,2,25,25,0,0,0
202223,NAPMDC5007,SCUOLA SECONDARIA II GRADO,1,16,16,0,0,0
202223,VA1M4Z500Q,SCUOLA SECONDARIA I GRADO,2,30,27,3,1,2
202223,VBSLCH500S,SCUOLA SECONDARIA II GRADO,1,7,7,0,0,0
202223,FI1E00900G,SCUOLA PRIMARIA,2,25,21,4,0,4
202223,NA1E13300D,SCUOLA PRIMARIA,4,19,19,0,0,0
202223,UD1M00700C,SCUOLA SECONDARIA I GRADO,2,37,36,1,1,0
202223,PATD43500N,SCUOLA SECONDARIA II GRADO,1,10,1,9,0,9
202223,UD1EM3500M,SCUOLA PRIMARIA,5,21,19,2,0,2
202223,BG1E030001,SCUOLA PRIMARIA,3,70,68,2,0,2
202223,BS1E003005,SCUOLA PRIMARIA,3,18,18,0,0,0
202223,MBPL73500N,SCUOLA SECONDARIA II GRADO,4,9,8,1,0,1
202223,PNPS9G5000,SCUOLA SECONDARIA II GRADO,5,12,12,0,0,0
202223,LCTAB3500P,SCUOLA SECONDARIA II GRADO,1,7,7,0,0,0
202223,SP1E002008,SCUOLA PRIMARIA,1,25,25,0,0,0
202223,AN1E002005,SCUOLA PRIMARIA,2,15,15,0,0,0
202223,CERHFI5007,SCUOLA SECONDARIA II GRADO,2,7,6,1,0,1
202223,LT1M001006,SCUOLA SECONDARIA I GRADO,2,24,24,0,0,0
202223,PS1M00200L,SCUOLA SECONDARIA I GRADO,1,25,25,0,0,0
202223,RN1M030007,SCUOLA SECONDARIA I GRADO,3,47,46,1,0,1
202223,RN1E01000R,SCUOLA PRIMARIA,2,21,21,0,0,0
202223,BG1M3M5006,SCUOLA SECONDARIA I GRADO,1,19,18,1,0,1
202223,SI1E001009,SCUOLA PRIMARIA,2,14,13,1,0,1
202223,GE1E03100N,SCUOLA PRIMARIA,5,21,19,2,2,0
202223,RMPM08500E,SCUOLA SECONDARIA II GRADO,1,18,18,0,0,0
202223,CE1E07100D,SCUOLA PRIMARIA,2,15,14,1,1,0
202223,CERH00500D,SCUOLA SECONDARIA II GRADO,1,25,23,2,0,2
202223,RM1M2E5007,SCUOLA SECONDARIA I GRADO,2,40,39,1,1,0
202223,CA1M013008,SCUOLA SECONDARIA I GRADO,3,19,19,0,0,0
202223,RM1E04000P,SCUOLA PRIMARIA,4,16,12,4,0,4
202223,PN1E002004,SCUOLA PRIMARIA,2,23,23,0,0,0
202223,SSPSNU500Q,SCUOLA SECONDARIA II GRADO,1,1,1,0,0,0
202223,SS1E00400L,SCUOLA PRIMARIA,1,10,8,2,0,2
202223,BG1M00300T,SCUOLA SECONDARIA I GRADO,1,26,26,0,0,0
202223,TVPL75500A,SCUOLA SECONDARIA II GRADO,4,18,18,0,0,0
202223,TVPL07500D,SCUOLA SECONDARIA II GRADO,2,4,4,0,0,0
202223,NA1E24400R,SCUOLA PRIMARIA,3,11,11,0,0,0
202223,AVTN0D5004,SCUOLA SECONDARIA II GRADO,3,4,4,0,0,0
202223,FE1E8D500F,SCUOLA PRIMARIA,4,28,28,0,0,0
202223,BN1ES9500O,SCUOLA PRIMARIA,4,14,12,2,0,2
202223,VARH01500A,SCUOLA SECONDARIA II GRADO,4,32,31,1,0,1
202223,CEPC015007,SCUOLA SECONDARIA II GRADO,1,18,17,1,1,0
202223,APPSNE500L,SCUOLA SECONDARIA II GRADO,4,11,11,0,0,0
202223,MI1E445002,SCUOLA PRIMARIA,2,32,29,3,1,2
202223,SRTD06500N,SCUOLA SECONDARIA II GRADO,1,10,10,0,0,0
202223,PG1E00500A,SCUOLA PRIMARIA,2,9,8,1,1,0
202223,MIRF6M5002,SCUOLA SECONDARIA II GRADO,2,18,13,5,1,4
202223,SSPL015003,SCUOLA SECONDARIA II GRADO,3,1,1,0,0,0
202223,PS1E00100G,SCUOLA PRIMARIA,2,21,21,0,0,0
202223,BGTFMP5003,SCUOLA SECONDARIA II GRADO,3,12,11,1,1,0
202223,NA1E11600Q,SCUOLA PRIMARIA,3,12,11,1,0,1
202223,SATF6H500T,SCUOLA SECONDARIA II GRADO,3,1,1,0,0,0
202223,NATHES5002,SCUOLA SECONDARIA II GRADO,1,12,12,0,0,0
202223,LC1E010008,SCUOLA PRIMARIA,3,17,17,0,0,0
202223,NAPC00500E,SCUOLA SECONDARIA II GRADO,4,12,12,0,0,0
202223,RMPL085008,SCUOLA SECONDARIA II GRADO,1,10,9,1,0,1
202223,CTTD195006,SCUOLA SECONDARIA II GRADO,2,13,13,0,0,0
202223,TS1E00500D,SCUOLA PRIMARIA,3,20,20,0,0,0
202223,MIRC1N500Z,SCUOLA SECONDARIA II GRADO,1,3,3,0,0,0
202223,VE1E00900E,SCUOLA PRIMARIA,2,22,22,0,0,0
202223,NA1M008005,SCUOLA SECONDARIA I GRADO,1,23,23,0,0,0
202223,VAPS06500N,SCUOLA SECONDARIA II GRADO,2,17,17,0,0,0
202223,BS1M00700N,SCUOLA SECONDARIA I GRADO,1,14,14,0,0,0
202223,MI1E082008,SCUOLA PRIMARIA,2,38,34,4,0,4
202223,VRPSI5500C,SCUOLA SECONDARIA II GRADO,3,29,28,1,1,0
202223,MI1E12000T,SCUOLA PRIMARIA,3,24,22,2,2,0
202223,PA1E00900L,SCUOLA PRIMARIA,2,25,23,2,0,2
202223,CT1E033001,SCUOLA PRIMARIA,4,30,29,1,0,1
202223,RMTD49500B,SCUOLA SECONDARIA II GRADO,1,5,5,0,0,0
202223,RMTAPV5005,SCUOLA SECONDARIA II GRADO,5,48,47,1,0,1
202223,MB1M018003,SCUOLA SECONDARIA I GRADO,1,102,102,0,0,0
202223,NATFU9500E,SCUOLA SECONDARIA II GRADO,4,3,3,0,0,0
202223,LO1M02000T,SCUOLA SECONDARIA I GRADO,1,25,24,1,0,1
202223,AP1E00200Q,SCUOLA PRIMARIA,4,18,17,1,0,1
202223,MI1M06400X,SCUOLA SECONDARIA I GRADO,1,45,42,3,0,3
202223,SASD00500E,SCUOLA SECONDARIA II GRADO,2,2,2,0,0,0
202223,LC1M08000Q,SCUOLA SECONDARIA I GRADO,2,43,42,1,1,0
202223,RE1M8H500D,SCUOLA SECONDARIA I GRADO,3,16,14,2,0,2
202223,BR1E001002,SCUOLA PRIMARIA,3,13,12,1,0,1
202223,RM1E20800L,SCUOLA PRIMARIA,3,13,9,4,0,4
202223,PO1E005008,SCUOLA PRIMARIA,3,15,9,6,0,6
202223,PO1M02000G,SCUOLA SECONDARIA I GRADO,1,50,34,16,0,16
202223,GE1E03800C,SCUOLA PRIMARIA,2,15,15,0,0,0
202223,NA1E25700V,SCUOLA PRIMARIA,5,15,15,0,0,0
202223,APTFZ6500L,SCUOLA SECONDARIA II GRADO,1,3,3,0,0,0
202223,RMTB04500X,SCUOLA SECONDARIA II GRADO,4,15,14,1,1,0
202223,BG1E00800Q,SCUOLA PRIMARIA,4,53,52,1,1,0
202223,LO1E00400P,SCUOLA PRIMARIA,3,45,44,1,0,1
202223,PGPM02500T,SCUOLA SECONDARIA II GRADO,1,10,10,0,0,0
202223,AGTD2M5007,SCUOLA SECONDARIA II GRADO,5,45,45,0,0,0
202223,AL1E6U500H,SCUOLA PRIMARIA,4,8,8,0,0,0
202223,BOPS3D500P,SCUOLA SECONDARIA II GRADO,1,9,9,0,0,0
202223,RM1E065003,SCUOLA PRIMARIA,5,27,24,3,1,2
202223,CERHT0500Q,SCUOLA SECONDARIA II GRADO,3,16,7,9,0,9
202223,RM1EII500V,SCUOLA PRIMARIA,3,2,2,0,0,0
202223,NARHSC500S,SCUOLA SECONDARIA II GRADO,4,3,3,0,0,0
202223,VR1M00100R,SCUOLA SECONDARIA I GRADO,2,43,41,2,0,2
202223,CORF8L5003,SCUOLA SECONDARIA II GRADO,1,5,3,2,2,0
202223,CO1E00700P,SCUOLA PRIMARIA,5,27,26,1,0,1
202223,NATDLM500R,SCUOLA SECONDARIA II GRADO,2,8,8,0,0,0
202223,RMPST6500P,SCUOLA SECONDARIA II GRADO,5,28,28,0,0,0
202223,RC1E00200R,SCUOLA PRIMARIA,5,18,18,0,0,0
202223,MIPLAM5002,SCUOLA SECONDARIA II GRADO,2,6,5,1,1,0
202223,NA1E27800X,SCUOLA PRIMARIA,3,44,44,0,0,0
202223,FIPMT8500I,SCUOLA SECONDARIA II GRADO,4,18,18,0,0,0
202223,BLPL49500T,SCUOLA SECONDARIA II GRADO,4,13,13,0,0,0
202223,MI1M04000B,SCUOLA SECONDARIA I GRADO,1,50,49,1,0,1
202223,IM1E00400R,SCUOLA PRIMARIA,1,20,19,1,0,1
202223,BS1E02600T,SCUOLA PRIMARIA,4,8,8,0,0,0
202223,BSPS88500T,SCUOLA SECONDARIA II GRADO,5,13,13,0,0,0
202223,AG1E006007,SCUOLA PRIMARIA,2,16,16,0,0,0
202223,TVPC48500H,SCUOLA SECONDARIA II GRADO,4,18,18,0,0,0
202223,RM1E155009,SCUOLA PRIMARIA,3,34,34,0,0,0
202223,TOPC10500T,SCUOLA SECONDARIA II GRADO,4,13,13,0,0,0
202223,NA1E00400L,SCUOLA PRIMARIA,1,7,3,4,0,4
202223,NA1E164005,SCUOLA PRIMARIA,3,14,14,0,0,0
202223,NA1E07500P,SCUOLA PRIMARIA,1,21,21,0,0,0
202223,VR1E009006,SCUOLA PRIMARIA,2,23,23,0,0,0
202223,TV1E01500T,SCUOLA PRIMARIA,4,49,49,0,0,0
202223,FR1EZQ500N,SCUOLA PRIMARIA,3,11,11,0,0,0
202223,NA1E00900Q,SCUOLA PRIMARIA,3,12,12,0,0,0
202223,RGRHH6500Z,SCUOLA SECONDARIA II GRADO,5,13,12,1,0,1
202223,BGPS0D500U,SCUOLA SECONDARIA II GRADO,4,33,32,1,0,1
202223,CERIH2500T,SCUOLA SECONDARIA II GRADO,4,8,8,0,0,0
202223,CETD135008,SCUOLA SECONDARIA II GRADO,3,5,5,0,0,0
202223,SATFTL5007,SCUOLA SECONDARIA II GRADO,2,7,7,0,0,0
202223,CE1E010002,SCUOLA PRIMARIA,4,13,12,1,0,1
202223,PATD87500G,SCUOLA SECONDARIA II GRADO,3,12,12,0,0,0
202223,NOPL015002,SCUOLA SECONDARIA II GRADO,5,17,17,0,0,0
202223,RMTD7E500U,SCUOLA SECONDARIA II GRADO,3,2,2,0,0,0
202223,RMPS25500B,SCUOLA SECONDARIA II GRADO,5,15,15,0,0,0
202223,RMSL3L500Q,SCUOLA SECONDARIA II GRADO,2,13,13,0,0,0
202223,MI1M055005,SCUOLA SECONDARIA I GRADO,1,61,58,3,0,3
202223,PN1M00100D,SCUOLA SECONDARIA I GRADO,2,83,76,7,2,5
202223,MI1E003007,SCUOLA PRIMARIA,5,56,56,0,0,0
202223,NA1E06800G,SCUOLA PRIMARIA,5,17,12,5,0,5
202223,MI1E01000A,SCUOLA PRIMARIA,1,27,22,5,2,3
202223,TV1E01700D,SCUOLA PRIMARIA,5,43,42,1,0,1
202223,RM1E057004,SCUOLA PRIMARIA,1,43,40,3,0,3
202223,NA1E05500D,SCUOLA PRIMARIA,1,48,48,0,0,0
202223,PAPL595005,SCUOLA SECONDARIA II GRADO,3,6,6,0,0,0
202223,RMPLUU500N,SCUOLA SECONDARIA II GRADO,3,13,12,1,0,1
202223,CE1E016001,SCUOLA PRIMARIA,3,14,14,0,0,0
202223,TO1MB25008,SCUOLA SECONDARIA I GRADO,1,39,33,6,1,5
202223,AT1ENP5001,SCUOLA PRIMARIA,2,12,12,0,0,0
202223,RE1E001006,SCUOLA PRIMARIA,2,27,27,0,0,0
202223,MITN03500N,SCUOLA SECONDARIA II GRADO,4,14,14,0,0,0
202223,MO1E005004,SCUOLA PRIMARIA,1,27,24,3,0,3
202223,BATD07500E,SCUOLA SECONDARIA II GRADO,4,23,23,0,0,0
202223,RMPS555002,SCUOLA SECONDARIA II GRADO,1,41,40,1,0,1
202223,CS1ENE5005,SCUOLA PRIMARIA,3,13,13,0,0,0
202223,GE1E01100C,SCUOLA PRIMARIA,4,48,48,0,0,0
202223,RM1E09600P,SCUOLA PRIMARIA,4,38,38,0,0,0
202223,MIPMU4500Z,SCUOLA SECONDARIA II GRADO,3,13,13,0,0,0
202223,BORI03500C,SCUOLA SECONDARIA II GRADO,4,26,25,1,1,0
202223,LT1E00900G,SCUOLA PRIMARIA,4,35,34,1,1,0
202223,SATD9H500H,SCUOLA SECONDARIA II GRADO,1,8,8,0,0,0
202223,RM1E7V500S,SCUOLA PRIMARIA,1,14,14,0,0,0
202223,TOPLRN500U,SCUOLA SECONDARIA II GRADO,2,4,4,0,0,0
202223,MI1MVA500E,SCUOLA SECONDARIA I GRADO,3,44,43,1,0,1
202223,NATDR0500L,SCUOLA SECONDARIA II GRADO,4,5,5,0,0,0
202223,FIPLZD500L,SCUOLA SECONDARIA II GRADO,1,3,3,0,0,0
202223,RMPM17500R,SCUOLA SECONDARIA II GRADO,2,24,22,2,0,2
202223,RMPSPN500P,SCUOLA SECONDARIA II GRADO,5,22,22,0,0,0
202223,NAPS68500Q,SCUOLA SECONDARIA II GRADO,5,25,25,0,0,0
202223,BA1MD7500G,SCUOLA SECONDARIA I GRADO,2,17,17,0,0,0
202223,BSTF8F5009,SCUOLA SECONDARIA II GRADO,1,6,4,2,1,1
202223,TOPS955001,SCUOLA SECONDARIA II GRADO,4,11,10,1,0,1
202223,RMPSI6500C,SCUOLA SECONDARIA II GRADO,4,25,24,1,0,1
202223,NA1E19600L,SCUOLA PRIMARIA,4,12,11,1,0,1
202223,MI1M041007,SCUOLA SECONDARIA I GRADO,3,176,171,5,2,3
202223,RM1E10200R,SCUOLA PRIMARIA,2,22,22,0,0,0
202223,CE1E058003,SCUOLA PRIMARIA,2,9,8,1,0,1
202223,CTTDHQ5002,SCUOLA SECONDARIA II GRADO,2,1,1,0,0,0
202223,CE1E03200V,SCUOLA PRIMARIA,2,23,19,4,0,4
202223,FO1M00100B,SCUOLA SECONDARIA I GRADO,3,44,44,0,0,0
202223,BS1M6C500D,SCUOLA SECONDARIA I GRADO,3,24,22,2,0,2
202223,TOPS09500G,SCUOLA SECONDARIA II GRADO,4,42,42,0,0,0
202223,PAPC1H500H,SCUOLA SECONDARIA II GRADO,5,9,9,0,0,0
202223,TOPM085002,SCUOLA SECONDARIA II GRADO,4,9,9,0,0,0
202223,AVTF005001,SCUOLA SECONDARIA II GRADO,5,70,66,4,1,3
202223,MI1MP35007,SCUOLA SECONDARIA I GRADO,1,37,30,7,2,5
202223,BNTDC1500F,SCUOLA SECONDARIA II GRADO,5,34,32,2,1,1
202223,RM1E11200B,SCUOLA PRIMARIA,5,22,22,0,0,0
202223,NA1E149003,SCUOLA PRIMARIA,2,3,3,0,0,0
202223,VRPS005004,SCUOLA SECONDARIA II GRADO,1,16,15,1,1,0
202223,VATD05500V,SCUOLA SECONDARIA II GRADO,1,6,6,0,0,0
202223,CT1E03900X,SCUOLA PRIMARIA,4,19,19,0,0,0
202223,VRPC04500B,SCUOLA SECONDARIA II GRADO,1,24,23,1,0,1
202223,RM1M074003,SCUOLA SECONDARIA I GRADO,3,76,76,0,0,0
202223,SATFET500V,SCUOLA SECONDARIA II GRADO,2,8,7,1,0,1
202223,PVPS01500C,SCUOLA SECONDARIA II GRADO,3,25,25,0,0,0
202223,PVTD065009,SCUOLA SECONDARIA II GRADO,5,4,4,0,0,0
202223,MI1EES500O,SCUOLA PRIMARIA,4,15,14,1,0,1
202223,SARH13500E,SCUOLA SECONDARIA II GRADO,2,3,3,0,0,0
202223,MB1E03500G,SCUOLA PRIMARIA,2,44,43,1,0,1
202223,NAPC135007,SCUOLA SECONDARIA II GRADO,3,9,9,0,0,0
202223,PAPS02500Q,SCUOLA SECONDARIA II GRADO,4,59,59,0,0,0
202223,PATD12500C,SCUOLA SECONDARIA II GRADO,2,5,5,0,0,0
202223,CETF36500S,SCUOLA SECONDARIA II GRADO,2,9,9,0,0,0
202223,VAPMSE500O,SCUOLA SECONDARIA II GRADO,4,20,20,0,0,0
202223,TO1M00600X,SCUOLA SECONDARIA I GRADO,2,24,24,0,0,0
202223,PR1M010004,SCUOLA SECONDARIA I GRADO,1,34,34,0,0,0
202223,NATF30500A,SCUOLA SECONDARIA II GRADO,4,9,9,0,0,0
202223,NA1E14400X,SCUOLA PRIMARIA,2,17,16,1,0,1
202223,MI1E11900N,SCUOLA PRIMARIA,3,23,22,1,0,1
202223,BG1E02400N,SCUOLA PRIMARIA,2,23,21,2,1,1
202223,RCRH6N5009,SCUOLA SECONDARIA II GRADO,2,6,6,0,0,0
202223,NAPS265003,SCUOLA SECONDARIA II GRADO,5,86,82,4,3,1
202223,BS1E011004,SCUOLA PRIMARIA,1,25,25,0,0,0
202223,RE1EE9500Z,SCUOLA PRIMARIA,1,8,8,0,0,0
202223,AL1M01000P,SCUOLA SECONDARIA I GRADO,1,37,31,6,1,5
202223,VR1M01500P,SCUOLA SECONDARIA I GRADO,1,36,35,1,0,1
202223,TO1M04500E,SCUOLA SECONDARIA I GRADO,3,39,35,4,1,3
202223,NA1E03700X,SCUOLA PRIMARIA,5,44,43,1,0,1
202223,NA1E04000Q,SCUOLA PRIMARIA,2,10,10,0,0,0
202223,VR1E01400N,SCUOLA PRIMARIA,5,25,25,0,0,0
202223,RMPM7V500G,SCUOLA SECONDARIA II GRADO,4,16,16,0,0,0
202223,CO1M022002,SCUOLA SECONDARIA I GRADO,1,17,17,0,0,0
202223,CB1E00100B,SCUOLA PRIMARIA,3,12,10,2,2,0
202223,RMPLG55006,SCUOLA SECONDARIA II GRADO,1,13,9,4,1,3
202223,CRPS02500L,SCUOLA SECONDARIA II GRADO,1,22,21,1,1,0
202223,SAPL65500L,SCUOLA SECONDARIA II GRADO,3,6,5,1,0,1
202223,SAPC005001,SCUOLA SECONDARIA II GRADO,2,4,4,0,0,0
202223,CA1E01400V,SCUOLA PRIMARIA,3,19,19,0,0,0
202223,SP1E00400X,SCUOLA PRIMARIA,1,24,23,1,0,1
202223,BGPL04500P,SCUOLA SECONDARIA II GRADO,5,25,24,1,0,1
202223,VR1E02100R,SCUOLA PRIMARIA,3,24,24,0,0,0
202223,NA1E27300R,SCUOLA PRIMARIA,1,15,13,2,0,2
202223,FG1E022009,SCUOLA PRIMARIA,5,29,28,1,0,1
202223,TVTD02500D,SCUOLA SECONDARIA II GRADO,4,16,16,0,0,0
202223,RM1M15000B,SCUOLA SECONDARIA I GRADO,2,25,25,0,0,0
202223,CERH015004,SCUOLA SECONDARIA II GRADO,3,22,22,0,0,0
202223,NA1E09700G,SCUOLA PRIMARIA,3,33,33,0,0,0
202223,SAPMSZ500D,SCUOLA SECONDARIA II GRADO,1,9,9,0,0,0
202223,RM1M101006,SCUOLA SECONDARIA I GRADO,1,16,14,2,0,2
202223,BSSL01500D,SCUOLA SECONDARIA II GRADO,3,43,43,0,0,0
202223,CRPL01500R,SCUOLA SECONDARIA II GRADO,3,7,6,1,0,1
202223,CA1E020006,SCUOLA PRIMARIA,3,27,25,2,0,2
202223,TOTF055007,SCUOLA SECONDARIA II GRADO,2,4,4,0,0,0
202223,MB1E04100V,SCUOLA PRIMARIA,4,45,45,0,0,0
202223,NO1E00800V,SCUOLA PRIMARIA,3,17,15,2,0,2
202223,PEPMDE500O,SCUOLA SECONDARIA II GRADO,2,13,12,1,0,1
202223,PG1E00300P,SCUOLA PRIMARIA,3,31,30,1,0,1
202223,ME1E00500G,SCUOLA PRIMARIA,5,18,17,1,0,1
202223,BGSLN6500G,SCUOLA SECONDARIA II GRADO,2,28,28,0,0,0
202223,MERH015005,SCUOLA SECONDARIA II GRADO,1,4,4,0,0,0
202223,SSPQC7500O,SCUOLA SECONDARIA II GRADO,3,3,3,0,0,0
202223,BS1EUE5000,SCUOLA PRIMARIA,4,3,3,0,0,0
202223,SSTD015004,SCUOLA SECONDARIA II GRADO,2,3,3,0,0,0
202223,RMPC455002,SCUOLA SECONDARIA II GRADO,1,3,3,0,0,0
202223,RMPC24500N,SCUOLA SECONDARIA II GRADO,3,19,19,0,0,0
202223,COPS055009,SCUOLA SECONDARIA II GRADO,5,15,15,0,0,0
202223,RM1E148006,SCUOLA PRIMARIA,5,45,45,0,0,0
202223,NA1E13300D,SCUOLA PRIMARIA,5,20,20,0,0,0
202223,MIPSN6500B,SCUOLA SECONDARIA II GRADO,4,8,8,0,0,0
202223,MBPM005002,SCUOLA SECONDARIA II GRADO,1,26,25,1,0,1
202223,NATL27500X,SCUOLA SECONDARIA II GRADO,2,9,9,0,0,0
202223,MBPS40500C,SCUOLA SECONDARIA II GRADO,5,18,18,0,0,0
202223,TO1E00600P,SCUOLA PRIMARIA,3,20,19,1,0,1
202223,SASD00500E,SCUOLA SECONDARIA II GRADO,5,15,15,0,0,0
202223,SARFTV500I,SCUOLA SECONDARIA II GRADO,2,3,3,0,0,0
202223,CE1E03400E,SCUOLA PRIMARIA,1,24,23,1,0,1
202223,CE1E049008,SCUOLA PRIMARIA,3,15,15,0,0,0
202223,BGPS1G5008,SCUOLA SECONDARIA II GRADO,4,19,19,0,0,0
202223,VA1M018004,SCUOLA SECONDARIA I GRADO,3,3,3,0,0,0
202223,FO1E00300T,SCUOLA PRIMARIA,5,20,17,3,1,2
202223,VE1E00300G,SCUOLA PRIMARIA,2,16,16,0,0,0
202223,VAPLDB5003,SCUOLA SECONDARIA II GRADO,4,12,10,2,1,1
202223,GE1M030003,SCUOLA SECONDARIA I GRADO,2,17,17,0,0,0
202223,NATFIQ500E,SCUOLA SECONDARIA II GRADO,2,10,10,0,0,0
202223,MIPC04500B,SCUOLA SECONDARIA II GRADO,4,46,46,0,0,0
202223,BNTFOA500V,SCUOLA SECONDARIA II GRADO,3,9,9,0,0,0
202223,NA1E134009,SCUOLA PRIMARIA,4,19,18,1,0,1
202223,CSTD71500B,SCUOLA SECONDARIA II GRADO,4,5,4,1,1,0
202223,VRTN01500C,SCUOLA SECONDARIA II GRADO,2,15,15,0,0,0
202223,MIPS535008,SCUOLA SECONDARIA II GRADO,4,9,9,0,0,0
202223,RMSL5N500U,SCUOLA SECONDARIA II GRADO,4,5,5,0,0,0
202223,TO1E00800A,SCUOLA PRIMARIA,4,16,16,0,0,0
202223,RM1E19700B,SCUOLA PRIMARIA,1,56,55,1,0,1
202223,PIPS02500D,SCUOLA SECONDARIA II GRADO,5,24,24,0,0,0
202223,LEPS02500C,SCUOLA SECONDARIA II GRADO,2,14,14,0,0,0
202223,RE1E00500D,SCUOLA PRIMARIA,3,23,21,2,0,2
202223,MI1E00700E,SCUOLA PRIMARIA,4,48,44,4,0,4
202223,NA1E07600E,SCUOLA PRIMARIA,5,26,26,0,0,0
202223,CSRH5I5000,SCUOLA SECONDARIA II GRADO,4,7,6,1,1,0
202223,VR1E01000A,SCUOLA PRIMARIA,3,21,21,0,0,0
202223,VA1E00700C,SCUOLA PRIMARIA,2,40,38,2,0,2
202223,RNPM015006,SCUOLA SECONDARIA II GRADO,4,50,28,22,1,21
202223,FO1E001006,SCUOLA PRIMARIA,4,16,12,4,1,3
202223,BG1M00300T,SCUOLA SECONDARIA I GRADO,2,19,19,0,0,0
202223,PDPC01500T,SCUOLA SECONDARIA II GRADO,1,17,16,1,0,1
202223,UD1MC15002,SCUOLA SECONDARIA I GRADO,2,8,8,0,0,0
202223,NATD59500D,SCUOLA SECONDARIA II GRADO,3,13,13,0,0,0
202223,PA1E006005,SCUOLA PRIMARIA,1,14,12,2,0,2
202223,MI1E011006,SCUOLA PRIMARIA,3,18,15,3,0,3
202223,NA1E20200P,SCUOLA PRIMARIA,1,15,15,0,0,0
202223,VI1E008002,SCUOLA PRIMARIA,5,5,2,3,0,3
202223,NARHA8500Q,SCUOLA SECONDARIA II GRADO,3,9,9,0,0,0
202223,RM1E21500Q,SCUOLA PRIMARIA,5,12,11,1,0,1
202223,PD1E018007,SCUOLA PRIMARIA,2,46,46,0,0,0
202223,TVPMRQ500V,SCUOLA SECONDARIA II GRADO,3,16,16,0,0,0
202223,NA1E24900X,SCUOLA PRIMARIA,2,16,16,0,0,0
202223,RM1E13200L,SCUOLA PRIMARIA,1,20,20,0,0,0
202223,ENSD01500A,SCUOLA SECONDARIA II GRADO,4,26,25,1,0,1
202223,MBRH02500X,SCUOLA SECONDARIA II GRADO,5,30,30,0,0,0
202223,NATD48500T,SCUOLA SECONDARIA II GRADO,5,65,63,2,0,2
202223,BNPS3O5006,SCUOLA SECONDARIA II GRADO,3,8,7,1,0,1
202223,BA1E02500C,SCUOLA PRIMARIA,5,15,15,0,0,0
202223,LIPL035005,SCUOLA SECONDARIA II GRADO,5,18,17,1,1,0
202223,PVSL015009,SCUOLA SECONDARIA II GRADO,4,6,6,0,0,0
202223,NA1E186002,SCUOLA PRIMARIA,2,12,12,0,0,0
202223,RMTF285009,SCUOLA SECONDARIA II GRADO,2,6,5,1,0,1
202223,NAPMGU500T,SCUOLA SECONDARIA II GRADO,1,14,14,0,0,0
202223,NAPMRP500S,SCUOLA SECONDARIA II GRADO,3,3,3,0,0,0
202223,PG1EPF500P,SCUOLA PRIMARIA,5,21,20,1,0,1
202223,MERHOV500E,SCUOLA SECONDARIA II GRADO,4,5,4,1,0,1
202223,RM1ERB5004,SCUOLA PRIMARIA,1,10,7,3,2,1
202223,ISTDGG500C,SCUOLA SECONDARIA II GRADO,5,22,21,1,0,1
202223,VATFME500R,SCUOLA SECONDARIA II GRADO,4,18,17,1,1,0
202223,PAPL6T500Q,SCUOLA SECONDARIA II GRADO,4,17,14,3,1,2
202223,NATFFL500P,SCUOLA SECONDARIA II GRADO,5,99,95,4,1,3
202223,NATDGE5008,SCUOLA SECONDARIA II GRADO,1,10,9,1,0,1
202223,PATD7N500Z,SCUOLA SECONDARIA II GRADO,4,16,15,1,1,0
202223,ENRH5C5006,SCUOLA SECONDARIA II GRADO,3,2,2,0,0,0
202223,PC1MD1500G,SCUOLA SECONDARIA I GRADO,1,6,3,3,1,2
202223,NATD53500N,SCUOLA SECONDARIA II GRADO,5,176,171,5,3,2
202223,PD1E01700B,SCUOLA PRIMARIA,1,24,22,2,1,1
202223,MI1E024008,SCUOLA PRIMARIA,2,21,18,3,0,3
202223,NATFU9500E,SCUOLA SECONDARIA II GRADO,5,105,103,2,1,1
202223,VR1E00200B,SCUOLA PRIMARIA,4,20,19,1,0,1
202223,VIPS01500A,SCUOLA SECONDARIA II GRADO,4,14,12,2,0,2
202223,NAPM015009,SCUOLA SECONDARIA II GRADO,1,20,20,0,0,0
202223,VE1E014002,SCUOLA PRIMARIA,3,19,19,0,0,0
202223,TV1E00800P,SCUOLA PRIMARIA,4,38,36,2,0,2
202223,RM1E00900P,SCUOLA PRIMARIA,1,19,18,1,0,1
202223,GE1E006001,SCUOLA PRIMARIA,3,77,69,8,0,8
202223,BSPMS9500M,SCUOLA SECONDARIA II GRADO,3,40,40,0,0,0
202223,MIRF105007,SCUOLA SECONDARIA II GRADO,4,21,19,2,0,2
202223,MITDGN5002,SCUOLA SECONDARIA II GRADO,4,19,15,4,0,4
202223,CETDHL500C,SCUOLA SECONDARIA II GRADO,4,9,9,0,0,0
202223,NA1M031006,SCUOLA SECONDARIA I GRADO,3,13,8,5,0,5
202223,CETF6B500H,SCUOLA SECONDARIA II GRADO,5,103,102,1,0,1
202223,FI1E005008,SCUOLA PRIMARIA,1,27,26,1,0,1
202223,VATD18500G,SCUOLA SECONDARIA II GRADO,3,18,16,2,0,2
202223,APTFZ6500L,SCUOLA SECONDARIA II GRADO,2,2,2,0,0,0
202223,BG1E01600P,SCUOLA PRIMARIA,5,57,56,1,0,1
202223,BG1E022002,SCUOLA PRIMARIA,1,31,31,0,0,0
202223,MIPS20500T,SCUOLA SECONDARIA II GRADO,2,23,23,0,0,0
202223,RMTD325008,SCUOLA SECONDARIA II GRADO,2,4,4,0,0,0
202223,NA1E22400G,SCUOLA PRIMARIA,3,43,42,1,0,1
202223,PV1MF4500I,SCUOLA SECONDARIA I GRADO,3,20,19,1,0,1
202223,MI1M068007,SCUOLA SECONDARIA I GRADO,3,25,24,1,0,1
202223,GE1E00900C,SCUOLA PRIMARIA,3,29,27,2,0,2
202223,FR1E00400R,SCUOLA PRIMARIA,5,15,15,0,0,0
202223,FR1E007008,SCUOLA PRIMARIA,2,17,17,0,0,0
202223,BOPSVN5005,SCUOLA SECONDARIA II GRADO,2,14,14,0,0,0
202223,RGTD105002,SCUOLA SECONDARIA II GRADO,3,4,2,2,0,2
202223,SA1E00600P,SCUOLA PRIMARIA,2,11,11,0,0,0
202223,NARH96500S,SCUOLA SECONDARIA II GRADO,4,26,26,0,0,0
202223,PAPMB55005,SCUOLA SECONDARIA II GRADO,2,14,13,1,0,1
202223,SATFU9500P,SCUOLA SECONDARIA II GRADO,3,3,3,0,0,0
202223,GE1M015001,SCUOLA SECONDARIA I GRADO,3,25,25,0,0,0
202223,FG1E01200P,SCUOLA PRIMARIA,2,18,18,0,0,0
202223,AV1E007009,SCUOLA PRIMARIA,4,21,21,0,0,0
202223,NA1E099007,SCUOLA PRIMARIA,3,10,5,5,1,4
202223,NA1E21600L,SCUOLA PRIMARIA,5,16,16,0,0,0
202223,BA1E018009,SCUOLA PRIMARIA,3,43,43,0,0,0
202223,NARI01500D,SCUOLA SECONDARIA II GRADO,4,6,6,0,0,0
202223,VI1E00300V,SCUOLA PRIMARIA,3,28,24,4,0,4
202223,TORI46500C,SCUOLA SECONDARIA II GRADO,1,11,11,0,0,0
202223,RM1E044002,SCUOLA PRIMARIA,2,35,34,1,1,0
202223,TV1M00400L,SCUOLA SECONDARIA I GRADO,2,141,139,2,0,2
202223,AL1E00100P,SCUOLA PRIMARIA,4,45,41,4,0,4
202223,BO1M00400G,SCUOLA SECONDARIA I GRADO,3,4,3,1,0,1
202223,FI1E035004,SCUOLA PRIMARIA,4,32,28,4,0,4
202223,SIPS01500C,SCUOLA SECONDARIA II GRADO,4,17,17,0,0,0
202223,RM1E07500N,SCUOLA PRIMARIA,1,85,79,6,0,6
202223,PV1E00900X,SCUOLA PRIMARIA,2,16,16,0,0,0
202223,NARF2D500G,SCUOLA SECONDARIA II GRADO,2,4,4,0,0,0
202223,LTTFOH5004,SCUOLA SECONDARIA II GRADO,5,26,26,0,0,0
202223,SATD25500P,SCUOLA SECONDARIA II GRADO,4,9,9,0,0,0
202223,RC1E005008,SCUOLA PRIMARIA,3,27,26,1,1,0
202223,RMPSRP5006,SCUOLA SECONDARIA II GRADO,4,10,8,2,0,2
202223,RM1E11500V,SCUOLA PRIMARIA,2,78,76,2,0,2
202223,BLPMMN5000,SCUOLA SECONDARIA II GRADO,2,6,6,0,0,0
202223,TO1MUU5007,SCUOLA SECONDARIA I GRADO,3,29,29,0,0,0
202223,RM1M129002,SCUOLA SECONDARIA I GRADO,3,18,17,1,1,0
202223,RM1M04100Q,SCUOLA SECONDARIA I GRADO,3,29,29,0,0,0
202223,MI1E046005,SCUOLA PRIMARIA,3,83,81,2,2,0
202223,MI1E067006,SCUOLA PRIMARIA,4,18,16,2,1,1
202223,CN1E001003,SCUOLA PRIMARIA,4,21,19,2,0,2
202223,TOTB025006,SCUOLA SECONDARIA II GRADO,4,15,14,1,1,0
202223,RM1E04200A,SCUOLA PRIMARIA,1,24,21,3,2,1
202223,NARF0C5004,SCUOLA SECONDARIA II GRADO,4,11,11,0,0,0
202223,GE1E00700R,SCUOLA PRIMARIA,5,22,22,0,0,0
202223,BO1EL9500N,SCUOLA PRIMARIA,5,17,15,2,0,2
202223,PE1M5C500R,SCUOLA SECONDARIA I GRADO,3,25,23,2,0,2
202223,CE1E065006,SCUOLA PRIMARIA,3,36,36,0,0,0
202223,TS1M003003,SCUOLA SECONDARIA I GRADO,3,17,16,1,1,0
202223,MEPLZL500L,SCUOLA SECONDARIA II GRADO,4,11,11,0,0,0
202223,NARF5I500H,SCUOLA SECONDARIA II GRADO,4,22,22,0,0,0
202223,SATDVQ500D,SCUOLA SECONDARIA II GRADO,3,6,6,0,0,0
202223,SATDBD5007,SCUOLA SECONDARIA II GRADO,2,1,1,0,0,0
202223,PA1E048007,SCUOLA PRIMARIA,1,45,44,1,0,1
202223,PA1M02400X,SCUOLA SECONDARIA I GRADO,3,28,24,4,0,4
202223,RMPSVA5006,SCUOLA SECONDARIA II GRADO,4,21,21,0,0,0
202223,BLPS54500H,SCUOLA SECONDARIA II GRADO,1,13,13,0,0,0
202223,NAPMVM500H,SCUOLA SECONDARIA II GRADO,4,7,6,1,0,1
202223,NAPS4U500S,SCUOLA SECONDARIA II GRADO,1,13,10,3,0,3
202223,MI1E054004,SCUOLA PRIMARIA,2,15,15,0,0,0
202223,MSPSI35008,SCUOLA SECONDARIA II GRADO,1,2,2,0,0,0
202223,MI1E13300X,SCUOLA PRIMARIA,4,28,28,0,0,0
202223,CL1E00500Q,SCUOLA PRIMARIA,4,8,8,0,0,0
202223,CLTD095008,SCUOLA SECONDARIA II GRADO,3,17,16,1,1,0
202223,LCPSU45004,SCUOLA SECONDARIA II GRADO,1,26,26,0,0,0
202223,SATDP9500M,SCUOLA SECONDARIA II GRADO,5,133,118,15,3,12
202223,PS1E00200B,SCUOLA PRIMARIA,5,25,24,1,0,1
202223,NARHZL500O,SCUOLA SECONDARIA II GRADO,1,12,12,0,0,0
202223,MI1E125001,SCUOLA PRIMARIA,5,51,51,0,0,0
202223,PI1E00200G,SCUOLA PRIMARIA,5,25,25,0,0,0
202223,SATD125002,SCUOLA SECONDARIA II GRADO,5,45,44,1,0,1
202223,MI1EA8500G,SCUOLA PRIMARIA,5,49,47,2,1,1
202223,LCPMEE500S,SCUOLA SECONDARIA II GRADO,2,27,27,0,0,0
202223,FI1M028006,SCUOLA SECONDARIA I GRADO,2,27,27,0,0,0
202223,LT1E00800Q,SCUOLA PRIMARIA,2,18,18,0,0,0
202223,PAPS05500G,SCUOLA SECONDARIA II GRADO,2,14,13,1,0,1
202223,MB1E029008,SCUOLA PRIMARIA,1,53,53,0,0,0
202223,NA1E028005,SCUOLA PRIMARIA,2,10,10,0,0,0
202223,TO1M02200T,SCUOLA SECONDARIA I GRADO,3,25,25,0,0,0
202223,CTPS09500D,SCUOLA SECONDARIA II GRADO,1,8,8,0,0,0
202223,NA1E28100Q,SCUOLA PRIMARIA,3,51,51,0,0,0
202223,UDPC00500N,SCUOLA SECONDARIA II GRADO,2,14,14,0,0,0
202223,CO1E00200G,SCUOLA PRIMARIA,4,21,20,1,0,1
202223,BNRHN2500D,SCUOLA SECONDARIA II GRADO,3,15,15,0,0,0
202223,AR1E00500C,SCUOLA PRIMARIA,1,22,19,3,2,1
202223,TO1E053008,SCUOLA PRIMARIA,4,22,21,1,1,0
202223,TO1E04400D,SCUOLA PRIMARIA,1,25,24,1,1,0
202223,RMPS655007,SCUOLA SECONDARIA II GRADO,3,3,3,0,0,0
202223,RMPS4A500Z,SCUOLA SECONDARIA II GRADO,5,20,20,0,0,0
202223,MB1E128009,SCUOLA PRIMARIA,2,42,42,0,0,0
202223,AL1E00600T,SCUOLA PRIMARIA,4,38,33,5,1,4
202223,FI1E02300T,SCUOLA PRIMARIA,1,25,18,7,1,6
202223,ANPM3A500M,SCUOLA SECONDARIA II GRADO,4,12,12,0,0,0
202223,FI1E06100L,SCUOLA PRIMARIA,4,12,11,1,1,0
202223,BOPSP8500H,SCUOLA SECONDARIA II GRADO,1,21,21,0,0,0
202223,MIPMEO500H,SCUOLA SECONDARIA II GRADO,5,32,32,0,0,0
202223,MIPS055005,SCUOLA SECONDARIA II GRADO,2,24,23,1,0,1
202223,FIPC05500B,SCUOLA SECONDARIA II GRADO,2,7,7,0,0,0
202223,SA1E011006,SCUOLA PRIMARIA,5,8,8,0,0,0
202223,LTPLCG500C,SCUOLA SECONDARIA II GRADO,4,5,4,1,0,1
202223,RM1E127005,SCUOLA PRIMARIA,2,49,49,0,0,0
202223,FIPL085005,SCUOLA SECONDARIA II GRADO,3,7,7,0,0,0
202223,RMPLO35009,SCUOLA SECONDARIA II GRADO,5,27,24,3,0,3
202223,CN1M001008,SCUOLA SECONDARIA I GRADO,1,53,50,3,0,3
202223,NOPS03500C,SCUOLA SECONDARIA II GRADO,1,59,58,1,0,1
202223,VAPSVA500Z,SCUOLA SECONDARIA II GRADO,4,17,17,0,0,0
202223,SAPM53500M,SCUOLA SECONDARIA II GRADO,2,5,5,0,0,0
202223,BA1E01600N,SCUOLA PRIMARIA,3,8,7,1,0,1
202223,MI1E070002,SCUOLA PRIMARIA,4,12,10,2,0,2
202223,NO1E00300Q,SCUOLA PRIMARIA,5,48,48,0,0,0
202223,LI1M00600A,SCUOLA SECONDARIA I GRADO,2,16,15,1,0,1
202223,TR1M00100X,SCUOLA SECONDARIA I GRADO,3,14,12,2,1,1
202223,RM1E02600C,SCUOLA PRIMARIA,4,67,66,1,0,1
202223,TO1E05100L,SCUOLA PRIMARIA,3,18,18,0,0,0
202223,FI1E02300T,SCUOLA PRIMARIA,4,27,23,4,0,4
202223,MB1E09100X,SCUOLA PRIMARIA,1,35,35,0,0,0
202223,PSTF005006,SCUOLA SECONDARIA II GRADO,3,25,23,2,0,2
202223,MITD13500L,SCUOLA SECONDARIA II GRADO,5,13,11,2,0,2
202223,NA1E015003,SCUOLA PRIMARIA,5,21,14,7,0,7
202223,BSPC01500D,SCUOLA SECONDARIA II GRADO,5,13,13,0,0,0
202223,VAPLVL5003,SCUOLA SECONDARIA II GRADO,2,14,14,0,0,0
202223,RM1E142007,SCUOLA PRIMARIA,5,46,46,0,0,0
202223,AVTF6H500N,SCUOLA SECONDARIA II GRADO,3,4,3,1,0,1
202223,MI1MV25008,SCUOLA SECONDARIA I GRADO,3,34,30,4,1,3
202223,NA1E242005,SCUOLA PRIMARIA,3,10,9,1,0,1
202223,CT1E02300A,SCUOLA PRIMARIA,3,17,17,0,0,0
202223,GO1E00100A,SCUOLA PRIMARIA,5,48,48,0,0,0
202223,GO1MGQ500P,SCUOLA SECONDARIA I GRADO,1,13,13,0,0,0
202223,NAPSF2500E,SCUOLA SECONDARIA II GRADO,1,18,18,0,0,0
202223,RMPS03500C,SCUOLA SECONDARIA II GRADO,5,33,33,0,0,0
202223,UD1E001008,SCUOLA PRIMARIA,4,16,16,0,0,0
202223,RMPS305007,SCUOLA SECONDARIA II GRADO,2,4,4,0,0,0
202223,APPS9N5001,SCUOLA SECONDARIA II GRADO,3,4,4,0,0,0
202223,RMTNIF500Z,SCUOLA SECONDARIA II GRADO,5,46,39,7,4,3
202223,SAPSNV500C,SCUOLA SECONDARIA II GRADO,1,4,4,0,0,0
202223,RM1E01100P,SCUOLA PRIMARIA,3,19,19,0,0,0
202223,CETF4P500Q,SCUOLA SECONDARIA II GRADO,5,131,129,2,1,1
202223,RMPC355005,SCUOLA SECONDARIA II GRADO,3,17,17,0,0,0
202223,NATF6F5005,SCUOLA SECONDARIA II GRADO,4,7,6,1,0,1
202223,CE1E01800L,SCUOLA PRIMARIA,3,12,11,1,0,1
202223,NA1E14400X,SCUOLA PRIMARIA,4,21,20,1,1,0
202223,AL1E005002,SCUOLA PRIMARIA,2,36,36,0,0,0
202223,VA1E01500B,SCUOLA PRIMARIA,5,44,43,1,0,1
202223,VT1M00400V,SCUOLA SECONDARIA I GRADO,1,33,32,1,0,1
202223,VE1E01200A,SCUOLA PRIMARIA,1,17,17,0,0,0
202223,LU1E002008,SCUOLA PRIMARIA,2,25,24,1,1,0
202223,BSPS01500L,SCUOLA SECONDARIA II GRADO,4,13,12,1,0,1
202223,TO1M026005,SCUOLA SECONDARIA I GRADO,2,36,33,3,1,2
202223,BGPMVO500T,SCUOLA SECONDARIA II GRADO,5,35,35,0,0,0
202223,CO1E01000E,SCUOLA PRIMARIA,1,36,36,0,0,0
202223,CO1M00200R,SCUOLA SECONDARIA I GRADO,1,70,69,1,0,1
202223,CO1M022002,SCUOLA SECONDARIA I GRADO,3,20,20,0,0,0
202223,RMPL355003,SCUOLA SECONDARIA II GRADO,5,12,12,0,0,0
202223,NATDB75009,SCUOLA SECONDARIA II GRADO,2,6,6,0,0,0
202223,RCTD5M5009,SCUOLA SECONDARIA II GRADO,2,2,2,0,0,0
202223,MBPC215006,SCUOLA SECONDARIA II GRADO,1,19,19,0,0,0
202223,RMPSHQ500O,SCUOLA SECONDARIA II GRADO,4,13,12,1,1,0
202223,RMPS355008,SCUOLA SECONDARIA II GRADO,3,39,37,2,0,2
202223,SP1E002008,SCUOLA PRIMARIA,3,26,26,0,0,0
202223,MIPM1C500T,SCUOLA SECONDARIA II GRADO,4,29,27,2,1,1
202223,TO1E032007,SCUOLA PRIMARIA,3,16,16,0,0,0
202223,RM1E078005,SCUOLA PRIMARIA,4,24,23,1,0,1
202223,PV1E00600C,SCUOLA PRIMARIA,3,12,10,2,0,2
202223,CERI59500T,SCUOLA SECONDARIA II GRADO,2,10,10,0,0,0
202223,MI1E076001,SCUOLA PRIMARIA,4,22,20,2,0,2
202223,NA1E03200R,SCUOLA PRIMARIA,4,13,13,0,0,0
202223,SATLO6500Z,SCUOLA SECONDARIA II GRADO,2,1,1,0,0,0
202223,CAPS8T5007,SCUOLA SECONDARIA II GRADO,3,6,6,0,0,0
202223,MIPLRL500B,SCUOLA SECONDARIA II GRADO,3,17,17,0,0,0
202223,VATB01500D,SCUOLA SECONDARIA II GRADO,1,27,21,6,1,5
202223,PD1E01000L,SCUOLA PRIMARIA,1,44,41,3,0,3
202223,RC1M00500D,SCUOLA SECONDARIA I GRADO,3,3,2,1,0,1
202223,NA1E10200T,SCUOLA PRIMARIA,5,18,17,1,0,1
202223,RM1M11800G,SCUOLA SECONDARIA I GRADO,2,76,76,0,0,0
202223,MO1E2A5008,SCUOLA PRIMARIA,2,23,22,1,1,0
202223,BG1E006004,SCUOLA PRIMARIA,3,44,44,0,0,0
202223,NA1E178003,SCUOLA PRIMARIA,1,33,32,1,0,1
202223,NAPSP85001,SCUOLA SECONDARIA II GRADO,3,9,9,0,0,0
202223,TO1E02900B,SCUOLA PRIMARIA,1,10,10,0,0,0
202223,BO1M00900P,SCUOLA SECONDARIA I GRADO,3,71,69,2,0,2
202223,NA1E198008,SCUOLA PRIMARIA,2,13,13,0,0,0
202223,BGSLQP500D,SCUOLA SECONDARIA II GRADO,2,12,12,0,0,0
202223,ISPL5F5001,SCUOLA SECONDARIA II GRADO,4,1,1,0,0,0
202223,MIPC15500V,SCUOLA SECONDARIA II GRADO,5,26,26,0,0,0
202223,RM1E10900G,SCUOLA PRIMARIA,2,24,24,0,0,0
202223,MIPS535008,SCUOLA SECONDARIA II GRADO,5,13,13,0,0,0
202223,RMPMT1500R,SCUOLA SECONDARIA II GRADO,2,10,10,0,0,0
202223,MN1E001004,SCUOLA PRIMARIA,3,11,8,3,0,3
202223,MBPS23500E,SCUOLA SECONDARIA II GRADO,3,6,6,0,0,0
202223,NATD455002,SCUOLA SECONDARIA II GRADO,1,3,3,0,0,0
202223,VR1E011006,SCUOLA PRIMARIA,5,21,20,1,1,0
202223,VIPM01500B,SCUOLA SECONDARIA II GRADO,4,27,26,1,0,1
202223,PASD01500G,SCUOLA SECONDARIA II GRADO,3,34,33,1,0,1
202223,FO1E001006,SCUOLA PRIMARIA,5,24,23,1,0,1
202223,FI1E01100G,SCUOLA PRIMARIA,1,22,15,7,2,5
202223,GE1M007002,SCUOLA SECONDARIA I GRADO,3,17,17,0,0,0
202223,NATFD05003,SCUOLA SECONDARIA II GRADO,4,2,2,0,0,0
202223,NA1E13700R,SCUOLA PRIMARIA,2,11,11,0,0,0
202223,BNTLN2500A,SCUOLA SECONDARIA II GRADO,1,8,8,0,0,0
202223,VT1E00500D,SCUOLA PRIMARIA,2,19,18,1,0,1
202223,CSTF6C500B,SCUOLA SECONDARIA II GRADO,2,2,0,2,0,2
202223,ATPL01500N,SCUOLA SECONDARIA II GRADO,3,20,19,1,0,1
202223,BG1E028001,SCUOLA PRIMARIA,1,26,25,1,1,0
202223,MIPS445002,SCUOLA SECONDARIA II GRADO,2,23,22,1,0,1
202223,BS1E003005,SCUOLA PRIMARIA,1,35,34,1,0,1
202223,RM1E19000L,SCUOLA PRIMARIA,4,25,25,0,0,0
202223,VEPL04500N,SCUOLA SECONDARIA II GRADO,3,13,13,0,0,0
202223,RMPS36500V,SCUOLA SECONDARIA II GRADO,5,14,13,1,1,0
202223,NA1E05900R,SCUOLA PRIMARIA,1,22,21,1,0,1
202223,RE1E002002,SCUOLA PRIMARIA,4,70,64,6,1,5
202223,RMPL0L500V,SCUOLA SECONDARIA II GRADO,5,13,13,0,0,0
202223,RGPL025009,SCUOLA SECONDARIA II GRADO,4,8,6,2,0,2
202223,NAPL885005,SCUOLA SECONDARIA II GRADO,3,4,4,0,0,0
202223,GE1E01500Q,SCUOLA PRIMARIA,3,4,4,0,0,0
202223,GE1E02500A,SCUOLA PRIMARIA,3,22,22,0,0,0
202223,RGPM0A500T,SCUOLA SECONDARIA II GRADO,4,11,10,1,0,1
202223,SATFIP5005,SCUOLA SECONDARIA II GRADO,4,8,8,0,0,0
202223,COPL01500N,SCUOLA SECONDARIA II GRADO,3,9,9,0,0,0
202223,UD1M00700C,SCUOLA SECONDARIA I GRADO,3,41,40,1,0,1
202223,VRTN025003,SCUOLA SECONDARIA II GRADO,2,29,29,0,0,0
202223,NOSL015004,SCUOLA SECONDARIA II GRADO,4,3,3,0,0,0
202223,RMTD70500E,SCUOLA SECONDARIA II GRADO,3,31,25,6,4,2
202223,MB1M01500G,SCUOLA SECONDARIA I GRADO,1,51,51,0,0,0
202223,RM1E022005,SCUOLA PRIMARIA,1,14,11,3,0,3
202223,CAPQ00500E,SCUOLA SECONDARIA II GRADO,3,15,15,0,0,0
202223,VEPMLV5000,SCUOLA SECONDARIA II GRADO,4,15,15,0,0,0
202223,MI1E018001,SCUOLA PRIMARIA,2,19,19,0,0,0
202223,VI1E008002,SCUOLA PRIMARIA,4,8,8,0,0,0
202223,VA1E011004,SCUOLA PRIMARIA,5,24,24,0,0,0
202223,NARFRT500R,SCUOLA SECONDARIA II GRADO,4,5,5,0,0,0
202223,NARH3Z5008,SCUOLA SECONDARIA II GRADO,3,3,3,0,0,0
202223,CT1M02400B,SCUOLA SECONDARIA I GRADO,2,48,47,1,0,1
202223,AVTDAS5006,SCUOLA SECONDARIA II GRADO,3,9,9,0,0,0
202223,RMPSMF500G,SCUOLA SECONDARIA II GRADO,4,11,10,1,1,0
202223,NA1E12000B,SCUOLA PRIMARIA,5,10,7,3,0,3
202223,MBSL05500V,SCUOLA SECONDARIA II GRADO,5,70,68,2,0,2
202223,CE1E06800N,SCUOLA PRIMARIA,5,11,11,0,0,0
202223,NA1E086005,SCUOLA PRIMARIA,3,38,38,0,0,0
202223,RM1MST500V,SCUOLA SECONDARIA I GRADO,3,10,9,1,0,1
202223,RM1M106009,SCUOLA SECONDARIA I GRADO,3,14,9,5,1,4
202223,MS1E00400V,SCUOLA PRIMARIA,1,12,10,2,0,2
202223,NO1E006007,SCUOLA PRIMARIA,3,37,30,7,0,7
202223,VI1E00500E,SCUOLA PRIMARIA,4,29,28,1,0,1
202223,RMTD7E500U,SCUOLA SECONDARIA II GRADO,5,51,42,9,4,5
202223,LETD075009,SCUOLA SECONDARIA II GRADO,3,8,7,1,1,0
202223,AGTF825005,SCUOLA SECONDARIA II GRADO,4,3,3,0,0,0
202223,CE1E052004,SCUOLA PRIMARIA,3,15,15,0,0,0
202223,NAPM455007,SCUOLA SECONDARIA II GRADO,5,91,86,5,0,5
202223,SATD295005,SCUOLA SECONDARIA II GRADO,5,69,61,8,2,6
202223,RC1E00800Q,SCUOLA PRIMARIA,5,24,22,2,0,2
202223,CZ1EQB500O,SCUOLA PRIMARIA,3,16,16,0,0,0
202223,FE1E8D500F,SCUOLA PRIMARIA,2,25,25,0,0,0
202223,BN1ES9500O,SCUOLA PRIMARIA,3,14,13,1,0,1
202223,NAPS92500P,SCUOLA SECONDARIA II GRADO,4,26,22,4,0,4
202223,BSTD355007,SCUOLA SECONDARIA II GRADO,2,5,3,2,0,2
202223,NA1E17900V,SCUOLA PRIMARIA,3,10,10,0,0,0
202223,NA1E19000N,SCUOLA PRIMARIA,5,10,10,0,0,0
202223,RN1E001002,SCUOLA PRIMARIA,5,36,35,1,0,1
202223,LCTDVP5000,SCUOLA SECONDARIA II GRADO,1,23,23,0,0,0
202223,VR1E00700E,SCUOLA PRIMARIA,5,45,45,0,0,0
202223,CE1E05900V,SCUOLA PRIMARIA,2,27,27,0,0,0
202223,VIPLVN5005,SCUOLA SECONDARIA II GRADO,4,7,7,0,0,0
202223,CTTD37500P,SCUOLA SECONDARIA II GRADO,3,1,1,0,0,0
202223,MIRF6M5002,SCUOLA SECONDARIA II GRADO,1,19,10,9,0,9
202223,PS1E00100G,SCUOLA PRIMARIA,1,19,18,1,0,1
202223,RM1E12400N,SCUOLA PRIMARIA,1,28,28,0,0,0
202223,VRPS025009,SCUOLA SECONDARIA II GRADO,3,82,80,2,1,1
202223,RM1M07200B,SCUOLA SECONDARIA I GRADO,1,13,10,3,0,3
202223,NA1E21700C,SCUOLA PRIMARIA,1,16,15,1,0,1
202223,TO1E01400N,SCUOLA PRIMARIA,4,25,23,2,1,1
202223,CH1E005007,SCUOLA PRIMARIA,1,14,13,1,0,1
202223,MI1M05700R,SCUOLA SECONDARIA I GRADO,3,171,164,7,0,7
202223,PNPS03500L,SCUOLA SECONDARIA II GRADO,1,17,17,0,0,0
202223,NA1MTL500Q,SCUOLA SECONDARIA I GRADO,1,4,4,0,0,0
202223,NAPC00500E,SCUOLA SECONDARIA II GRADO,3,15,15,0,0,0
202223,PDTD01500R,SCUOLA SECONDARIA II GRADO,3,11,11,0,0,0
202223,FR1E001009,SCUOLA PRIMARIA,5,24,23,1,1,0
202223,RNTL025002,SCUOLA SECONDARIA II GRADO,5,6,6,0,0,0
202223,PO1E005008,SCUOLA PRIMARIA,1,23,19,4,0,4
202223,VE1E00900E,SCUOLA PRIMARIA,3,23,20,3,1,2
202223,SATL09500T,SCUOLA SECONDARIA II GRADO,5,70,70,0,0,0
202223,GE1ELE500C,SCUOLA PRIMARIA,1,12,11,1,0,1
202223,UDTBCH500I,SCUOLA SECONDARIA II GRADO,3,19,16,3,1,2
202223,AQ1E00600N,SCUOLA PRIMARIA,3,5,5,0,0,0
202223,MIPS735002,SCUOLA SECONDARIA II GRADO,2,20,20,0,0,0
202223,NA1E21700C,SCUOLA PRIMARIA,5,22,21,1,0,1
202223,BS1E00700C,SCUOLA PRIMARIA,2,26,26,0,0,0
202223,LO1M010007,SCUOLA SECONDARIA I GRADO,3,37,36,1,1,0
202223,RM1E04200A,SCUOLA PRIMARIA,2,16,14,2,0,2
202223,RMPS41500P,SCUOLA SECONDARIA II GRADO,5,15,14,1,0,1
202223,TO1E03400V,SCUOLA PRIMARIA,5,51,51,0,0,0
202223,SRPL005001,SCUOLA SECONDARIA II GRADO,4,14,14,0,0,0
202223,RM1E08400C,SCUOLA PRIMARIA,1,47,47,0,0,0
202223,PV1E00400R,SCUOLA PRIMARIA,1,15,15,0,0,0
202223,RM1EM25008,SCUOLA PRIMARIA,1,25,17,8,0,8
202223,VE1E013006,SCUOLA PRIMARIA,2,16,13,3,0,3
202223,TV1M01200G,SCUOLA SECONDARIA I GRADO,1,50,50,0,0,0
202223,COSLZE5008,SCUOLA SECONDARIA II GRADO,1,13,10,3,0,3
202223,GE1E03700L,SCUOLA PRIMARIA,5,30,29,1,0,1
202223,RMPM3Q500P,SCUOLA SECONDARIA II GRADO,5,53,50,3,1,2
202223,MIPM01500Q,SCUOLA SECONDARIA II GRADO,5,23,22,1,0,1
202223,MI1E04200T,SCUOLA PRIMARIA,1,42,40,2,1,1
202223,CERH4F500L,SCUOLA SECONDARIA II GRADO,5,37,36,1,0,1
202223,NATL145007,SCUOLA SECONDARIA II GRADO,4,3,3,0,0,0
202223,APPCV8500G,SCUOLA SECONDARIA II GRADO,1,2,2,0,0,0
202223,RM1E03400B,SCUOLA PRIMARIA,5,11,11,0,0,0
202223,FI1E03100R,SCUOLA PRIMARIA,2,17,16,1,0,1
202223,CORC43500S,SCUOLA SECONDARIA II GRADO,5,19,19,0,0,0
202223,RM1E13300C,SCUOLA PRIMARIA,2,16,14,2,0,2
202223,NA1E25100X,SCUOLA PRIMARIA,4,10,10,0,0,0
202223,NATF15500N,SCUOLA SECONDARIA II GRADO,4,25,24,1,0,1
202223,BGTF015006,SCUOLA SECONDARIA II GRADO,4,12,12,0,0,0
202223,NA1E27800X,SCUOLA PRIMARIA,2,43,43,0,0,0
202223,BLPL49500T,SCUOLA SECONDARIA II GRADO,1,5,5,0,0,0
202223,MT1E00100E,SCUOLA PRIMARIA,4,15,14,1,0,1
202223,APPMOI500F,SCUOLA SECONDARIA II GRADO,2,2,2,0,0,0
202223,TATDI4500D,SCUOLA SECONDARIA II GRADO,4,3,3,0,0,0
202223,MB1E05500R,SCUOLA PRIMARIA,3,57,53,4,0,4
202223,RG1E00300C,SCUOLA PRIMARIA,4,21,21,0,0,0
202223,FRTF2T500E,SCUOLA SECONDARIA II GRADO,4,2,2,0,0,0
202223,VA1M013001,SCUOLA SECONDARIA I GRADO,3,49,47,2,1,1
202223,NA1M059002,SCUOLA SECONDARIA I GRADO,1,8,8,0,0,0
202223,NA1E235002,SCUOLA PRIMARIA,4,23,22,1,0,1
202223,SATF795007,SCUOLA SECONDARIA II GRADO,5,69,65,4,0,4
202223,RM1E14500P,SCUOLA PRIMARIA,1,10,8,2,1,1
202223,PD1E012008,SCUOLA PRIMARIA,1,24,24,0,0,0
202223,GEPL01500Q,SCUOLA SECONDARIA II GRADO,1,140,131,9,2,7
202223,GEPSC85001,SCUOLA SECONDARIA II GRADO,4,21,20,1,0,1
202223,RMTB00500D,SCUOLA SECONDARIA II GRADO,4,16,15,1,1,0
202223,APPC0Q500G,SCUOLA SECONDARIA II GRADO,2,3,3,0,0,0
202223,SARF6Q5004,SCUOLA SECONDARIA II GRADO,2,7,7,0,0,0
202223,VA1E009004,SCUOLA PRIMARIA,5,74,74,0,0,0
202223,TO1E018001,SCUOLA PRIMARIA,3,55,54,1,1,0
202223,RM1E06300B,SCUOLA PRIMARIA,4,22,22,0,0,0
202223,PAPSIU5009,SCUOLA SECONDARIA II GRADO,4,5,5,0,0,0
202223,VE1E005007,SCUOLA PRIMARIA,3,26,25,1,0,1
202223,NA1M03400N,SCUOLA SECONDARIA I GRADO,1,21,19,2,0,2
202223,BG1M02100B,SCUOLA SECONDARIA I GRADO,1,31,30,1,0,1
202223,CTPS10500V,SCUOLA SECONDARIA II GRADO,4,3,3,0,0,0
202223,VC1E00200E,SCUOLA PRIMARIA,5,23,23,0,0,0
202223,SATFH5500B,SCUOLA SECONDARIA II GRADO,3,5,5,0,0,0
202223,COPLNP500T,SCUOLA SECONDARIA II GRADO,2,13,12,1,0,1
202223,CN1E00300P,SCUOLA PRIMARIA,4,19,18,1,0,1
202223,MI1E07900C,SCUOLA PRIMARIA,2,19,15,4,1,3
202223,BA1E01600N,SCUOLA PRIMARIA,4,10,10,0,0,0
202223,BATD665005,SCUOLA SECONDARIA II GRADO,3,4,4,0,0,0
202223,LT1E00300L,SCUOLA PRIMARIA,1,21,20,1,0,1
202223,RMPS575007,SCUOLA SECONDARIA II GRADO,4,8,8,0,0,0
202223,TO1E05100L,SCUOLA PRIMARIA,2,17,17,0,0,0
202223,RM1E099006,SCUOLA PRIMARIA,2,9,9,0,0,0
202223,RE1E565000,SCUOLA PRIMARIA,2,23,22,1,0,1
202223,MIPMRI500E,SCUOLA SECONDARIA II GRADO,2,68,65,3,0,3
202223,TO1E02200L,SCUOLA PRIMARIA,2,24,22,2,0,2
202223,IM1E00600C,SCUOLA PRIMARIA,2,17,14,3,1,2
202223,PA1EDC5004,SCUOLA PRIMARIA,3,13,13,0,0,0
202223,NATDZR500T,SCUOLA SECONDARIA II GRADO,1,9,9,0,0,0
202223,CATF955004,SCUOLA SECONDARIA II GRADO,5,16,16,0,0,0
202223,TOPC11500C,SCUOLA SECONDARIA II GRADO,5,2,2,0,0,0
202223,FIPL8A500L,SCUOLA SECONDARIA II GRADO,3,6,5,1,0,1
202223,RMPSPG500N,SCUOLA SECONDARIA II GRADO,5,6,6,0,0,0
202223,NATDAR5000,SCUOLA SECONDARIA II GRADO,1,5,5,0,0,0
202223,MITN03500N,SCUOLA SECONDARIA II GRADO,2,12,12,0,0,0
202223,MI1E06300V,SCUOLA PRIMARIA,4,22,14,8,0,8
202223,SAPM3S500H,SCUOLA SECONDARIA II GRADO,2,5,5,0,0,0
202223,BOPM8F500M,SCUOLA SECONDARIA II GRADO,2,27,25,2,0,2
202223,BS1M00300A,SCUOLA SECONDARIA I GRADO,3,55,54,1,1,0
202223,PA1E034009,SCUOLA PRIMARIA,1,27,25,2,1,1
202223,MI1MVA500E,SCUOLA SECONDARIA I GRADO,1,67,66,1,0,1
202223,COTD105001,SCUOLA SECONDARIA II GRADO,5,19,19,0,0,0
202223,RMPMTS5005,SCUOLA SECONDARIA II GRADO,5,7,7,0,0,0
202223,PVPS775003,SCUOLA SECONDARIA II GRADO,5,8,8,0,0,0
202223,RM1E17300V,SCUOLA PRIMARIA,5,14,14,0,0,0
202223,MI1EBF500V,SCUOLA PRIMARIA,5,25,25,0,0,0
202223,RGTDCA500P,SCUOLA SECONDARIA II GRADO,4,4,4,0,0,0
202223,ME1M010008,SCUOLA SECONDARIA I GRADO,1,19,19,0,0,0
202223,TO1M026005,SCUOLA SECONDARIA I GRADO,1,24,24,0,0,0
202223,BS1EUE5000,SCUOLA PRIMARIA,3,10,10,0,0,0
202223,RM1E15800R,SCUOLA PRIMARIA,4,15,5,10,0,10
202223,VRPS09500G,SCUOLA SECONDARIA II GRADO,5,24,23,1,1,0
202223,RMRHRE5002,SCUOLA SECONDARIA II GRADO,1,13,11,2,0,2
202223,BG1E014003,SCUOLA PRIMARIA,1,20,20,0,0,0
202223,PATFCO500Z,SCUOLA SECONDARIA II GRADO,4,2,2,0,0,0
202223,PCTD015006,SCUOLA SECONDARIA II GRADO,2,11,9,2,0,2
202223,NATA0L500I,SCUOLA SECONDARIA II GRADO,5,70,67,3,0,3
202223,NATD2T5008,SCUOLA SECONDARIA II GRADO,4,2,2,0,0,0
202223,PVSLMT5003,SCUOLA SECONDARIA II GRADO,2,11,10,1,0,1
202223,VETF015005,SCUOLA SECONDARIA II GRADO,1,30,29,1,1,0
202223,BGPS02500P,SCUOLA SECONDARIA II GRADO,5,16,16,0,0,0
202223,MI1M00100R,SCUOLA SECONDARIA I GRADO,2,108,108,0,0,0
202223,SARHRM500C,SCUOLA SECONDARIA II GRADO,3,5,5,0,0,0
202223,NA1E078006,SCUOLA PRIMARIA,5,23,21,2,0,2
202223,RM1E08300L,SCUOLA PRIMARIA,1,38,38,0,0,0
202223,TV1E01000P,SCUOLA PRIMARIA,5,45,45,0,0,0
202223,TO1M048002,SCUOLA SECONDARIA I GRADO,1,46,42,4,2,2
202223,LTTD01500X,SCUOLA SECONDARIA II GRADO,3,6,5,1,0,1
202223,CERVEN500Q,SCUOLA SECONDARIA II GRADO,3,8,8,0,0,0
202223,NA1E6E500B,SCUOLA PRIMARIA,4,34,33,1,0,1
202223,CETF36500S,SCUOLA SECONDARIA II GRADO,1,8,8,0,0,0
202223,BGPMC0500F,SCUOLA SECONDARIA II GRADO,3,13,13,0,0,0
202223,RMPLB3500E,SCUOLA SECONDARIA II GRADO,1,6,5,1,0,1
202223,APTD5L500H,SCUOLA SECONDARIA II GRADO,4,2,2,0,0,0
202223,RCPC02500G,SCUOLA SECONDARIA II GRADO,5,8,8,0,0,0
202223,NA1E10400D,SCUOLA PRIMARIA,1,18,18,0,0,0
202223,RM1E19700B,SCUOLA PRIMARIA,3,77,77,0,0,0
202223,LC1M020004,SCUOLA SECONDARIA I GRADO,1,23,22,1,0,1
202223,SP1E002008,SCUOLA PRIMARIA,2,27,27,0,0,0
202223,GE1E013004,SCUOLA PRIMARIA,2,18,16,2,0,2
202223,PTPS3N5004,SCUOLA SECONDARIA II GRADO,3,27,26,1,0,1
202223,SA1E01900R,SCUOLA PRIMARIA,5,9,9,0,0,0
202223,CERHFI5007,SCUOLA SECONDARIA II GRADO,1,6,6,0,0,0
202223,RN1E01000R,SCUOLA PRIMARIA,3,23,23,0,0,0
202223,PS1E00500V,SCUOLA PRIMARIA,5,15,15,0,0,0
202223,NARHM0500C,SCUOLA SECONDARIA II GRADO,3,13,13,0,0,0
202223,AG1EVA500E,SCUOLA PRIMARIA,2,11,11,0,0,0
202223,PD1M001003,SCUOLA SECONDARIA I GRADO,2,27,26,1,0,1
202223,PAPM4U500C,SCUOLA SECONDARIA II GRADO,5,3,3,0,0,0
202223,FG1E016002,SCUOLA PRIMARIA,1,13,3,10,9,1
202223,MCPM00500L,SCUOLA SECONDARIA II GRADO,2,8,8,0,0,0
202223,NA1E094004,SCUOLA PRIMARIA,4,10,10,0,0,0
202223,CR1E00200P,SCUOLA PRIMARIA,4,32,29,3,2,1
202223,CR1M00300Q,SCUOLA SECONDARIA I GRADO,1,47,43,4,1,3
202223,MO1E00900B,SCUOLA PRIMARIA,5,21,21,0,0,0
202223,CA1M013008,SCUOLA SECONDARIA I GRADO,2,16,16,0,0,0
202223,VETFO1500N,SCUOLA SECONDARIA II GRADO,4,10,10,0,0,0
202223,TOTA015004,SCUOLA SECONDARIA II GRADO,2,16,16,0,0,0
202223,MB1E06800V,SCUOLA PRIMARIA,1,9,9,0,0,0
202223,PERFNA5005,SCUOLA SECONDARIA II GRADO,3,2,2,0,0,0
202223,SVPS015002,SCUOLA SECONDARIA II GRADO,3,18,18,0,0,0
202223,SV1E00200P,SCUOLA PRIMARIA,2,16,15,1,0,1
202223,BSPLPI500F,SCUOLA SECONDARIA II GRADO,4,13,13,0,0,0
202223,TOPL11500A,SCUOLA SECONDARIA II GRADO,3,14,13,1,1,0
202223,RM1E106004,SCUOLA PRIMARIA,5,35,31,4,0,4
202223,MIPC075007,SCUOLA SECONDARIA II GRADO,4,43,42,1,1,0
202223,BNTLN2500A,SCUOLA SECONDARIA II GRADO,2,2,2,0,0,0
202223,FIPMT8500I,SCUOLA SECONDARIA II GRADO,1,16,15,1,0,1
202223,RM1E11100G,SCUOLA PRIMARIA,2,6,6,0,0,0
202223,RM1M04900A,SCUOLA SECONDARIA I GRADO,3,42,42,0,0,0
202223,MI1E038006,SCUOLA PRIMARIA,4,20,20,0,0,0
202223,RM1M114008,SCUOLA SECONDARIA I GRADO,2,41,34,7,3,4
202223,MB1E05000N,SCUOLA PRIMARIA,2,77,75,2,2,0
202223,NAPL885005,SCUOLA SECONDARIA II GRADO,5,16,16,0,0,0
202223,NAPM5I5007,SCUOLA SECONDARIA II GRADO,5,68,68,0,0,0
202223,CTTF04500E,SCUOLA SECONDARIA II GRADO,1,3,3,0,0,0
202223,SV1M00400G,SCUOLA SECONDARIA I GRADO,3,40,40,0,0,0
202223,MITD11500B,SCUOLA SECONDARIA II GRADO,3,3,2,1,0,1
202223,NA1E13300D,SCUOLA PRIMARIA,3,13,13,0,0,0
202223,BNTDHO5008,SCUOLA SECONDARIA II GRADO,5,67,63,4,1,3
202223,UD1M00100D,SCUOLA SECONDARIA I GRADO,1,16,16,0,0,0
202223,BO1E00100V,SCUOLA PRIMARIA,1,24,21,3,0,3
202223,VRPLHM500A,SCUOLA SECONDARIA II GRADO,5,16,16,0,0,0
202223,BG1E030001,SCUOLA PRIMARIA,2,49,49,0,0,0
202223,MIPS535008,SCUOLA SECONDARIA II GRADO,2,10,10,0,0,0
202223,BS1E003005,SCUOLA PRIMARIA,2,40,37,3,0,3
202223,MBPL73500N,SCUOLA SECONDARIA II GRADO,3,10,10,0,0,0
202223,RMSL015004,SCUOLA SECONDARIA II GRADO,5,14,12,2,1,1
202223,TO1E00600P,SCUOLA PRIMARIA,4,16,15,1,0,1
202223,LI1E00200T,SCUOLA PRIMARIA,2,28,28,0,0,0
202223,CS1E008005,SCUOLA PRIMARIA,3,13,12,1,0,1
202223,LCRFHO5008,SCUOLA SECONDARIA II GRADO,5,10,8,2,0,2
202223,RMPL085008,SCUOLA SECONDARIA II GRADO,2,14,12,2,1,1
202223,AN1E002005,SCUOLA PRIMARIA,1,20,20,0,0,0
202223,CTTD195006,SCUOLA SECONDARIA II GRADO,1,11,11,0,0,0
202223,MIPSZS500P,SCUOLA SECONDARIA II GRADO,5,26,25,1,0,1
202223,RNPC015002,SCUOLA SECONDARIA II GRADO,1,17,16,1,0,1
202223,TO1ED5500F,SCUOLA PRIMARIA,4,13,13,0,0,0
202223,PRPS4I500E,SCUOLA SECONDARIA II GRADO,1,24,23,1,0,1
202223,NA1E051006,SCUOLA PRIMARIA,2,32,31,1,0,1
202223,RMPME45007,SCUOLA SECONDARIA II GRADO,2,5,5,0,0,0
202223,COPL08500X,SCUOLA SECONDARIA II GRADO,1,26,25,1,1,0
202223,RMPM08500E,SCUOLA SECONDARIA II GRADO,2,20,19,1,1,0
202223,FIPS065005,SCUOLA SECONDARIA II GRADO,1,3,1,2,0,2
202223,MI1E082008,SCUOLA PRIMARIA,1,27,27,0,0,0
202223,PA1E00900L,SCUOLA PRIMARIA,1,26,22,4,0,4
202223,RMTD49500B,SCUOLA SECONDARIA II GRADO,2,6,6,0,0,0
202223,MB1M017007,SCUOLA SECONDARIA I GRADO,3,41,40,1,0,1
202223,NA1E226007,SCUOLA PRIMARIA,1,15,13,2,0,2
202223,MI1M063004,SCUOLA SECONDARIA I GRADO,3,116,114,2,1,1
202223,PN1E002004,SCUOLA PRIMARIA,1,34,32,2,1,1
202223,CS1E00500N,SCUOLA PRIMARIA,1,15,13,2,2,0
202223,SI1E003001,SCUOLA PRIMARIA,2,16,16,0,0,0
202223,VA1E02200E,SCUOLA PRIMARIA,4,32,31,1,0,1
202223,BR1E001002,SCUOLA PRIMARIA,2,17,16,1,0,1
202223,VA1E00700C,SCUOLA PRIMARIA,3,39,38,1,0,1
202223,NARH96500S,SCUOLA SECONDARIA II GRADO,1,22,22,0,0,0
202223,BG1M002002,SCUOLA SECONDARIA I GRADO,3,26,26,0,0,0
202223,NA1E023002,SCUOLA PRIMARIA,2,7,7,0,0,0
202223,TVPL75500A,SCUOLA SECONDARIA II GRADO,5,19,18,1,1,0
202223,NA1E25700V,SCUOLA PRIMARIA,4,13,13,0,0,0
202223,CE1E00300V,SCUOLA PRIMARIA,3,18,18,0,0,0
202223,MC1M8S500G,SCUOLA SECONDARIA I GRADO,2,24,24,0,0,0
202223,CE1MOT500D,SCUOLA SECONDARIA I GRADO,3,1,0,1,0,1
202223,MN1E00300Q,SCUOLA PRIMARIA,3,29,28,1,0,1
202223,NATLGU500N,SCUOLA SECONDARIA II GRADO,1,9,9,0,0,0
202223,LO1E00400P,SCUOLA PRIMARIA,2,48,46,2,0,2
202223,APPSNE500L,SCUOLA SECONDARIA II GRADO,3,17,15,2,0,2
202223,CAPS02500E,SCUOLA SECONDARIA II GRADO,1,5,5,0,0,0
202223,AGTD2M5007,SCUOLA SECONDARIA II GRADO,4,5,5,0,0,0
202223,PE1E00400X,SCUOLA PRIMARIA,2,28,28,0,0,0
202223,PG1E00500A,SCUOLA PRIMARIA,1,8,7,1,0,1
202223,RM1M01200Q,SCUOLA SECONDARIA I GRADO,1,72,72,0,0,0
202223,SATD27500X,SCUOLA SECONDARIA II GRADO,2,8,6,2,0,2
202223,SSPL015003,SCUOLA SECONDARIA II GRADO,5,5,5,0,0,0
202223,VR1M00100R,SCUOLA SECONDARIA I GRADO,3,43,39,4,0,4
202223,CO1E00700P,SCUOLA PRIMARIA,4,26,24,2,1,1
202223,RC1E00200R,SCUOLA PRIMARIA,4,16,15,1,0,1
202223,MIPLMC5009,SCUOLA SECONDARIA II GRADO,1,7,7,0,0,0
202223,NA1E11600Q,SCUOLA PRIMARIA,2,16,16,0,0,0
202223,SATF6H500T,SCUOLA SECONDARIA II GRADO,4,2,2,0,0,0
202223,MS1E002007,SCUOLA PRIMARIA,3,15,15,0,0,0
202223,MIPSRS500B,SCUOLA SECONDARIA II GRADO,3,18,14,4,1,3
202223,BSTF01500P,SCUOLA SECONDARIA II GRADO,2,27,27,0,0,0
202223,NA1E185006,SCUOLA PRIMARIA,5,21,21,0,0,0
202223,PDTD01500R,SCUOLA SECONDARIA II GRADO,4,14,14,0,0,0
202223,VITD02500R,SCUOLA SECONDARIA II GRADO,4,12,12,0,0,0
202223,TS1E00500D,SCUOLA PRIMARIA,4,17,16,1,0,1
202223,VTPLR35005,SCUOLA SECONDARIA II GRADO,5,18,17,1,1,0
202223,VAPS06500N,SCUOLA SECONDARIA II GRADO,3,26,25,1,0,1
202223,VA1EZH500L,SCUOLA PRIMARIA,2,18,18,0,0,0
202223,SS1E01100Q,SCUOLA PRIMARIA,3,15,14,1,0,1
202223,NA1M007009,SCUOLA SECONDARIA I GRADO,3,19,19,0,0,0
202223,BSPS88500T,SCUOLA SECONDARIA II GRADO,4,14,14,0,0,0
202223,BS1M00600T,SCUOLA SECONDARIA I GRADO,3,73,71,2,0,2
202223,RM1E155009,SCUOLA PRIMARIA,4,36,36,0,0,0
202223,VRPSI5500C,SCUOLA SECONDARIA II GRADO,4,27,26,1,0,1
202223,CSTDIB500Z,SCUOLA SECONDARIA II GRADO,3,6,5,1,1,0
202223,MIPS375001,SCUOLA SECONDARIA II GRADO,2,56,56,0,0,0
202223,CT1E033001,SCUOLA PRIMARIA,3,27,27,0,0,0
202223,GR1E74500I,SCUOLA PRIMARIA,1,14,12,2,1,1
202223,MOTD01500Q,SCUOLA SECONDARIA II GRADO,4,9,7,2,0,2
202223,NATFU9500E,SCUOLA SECONDARIA II GRADO,3,11,11,0,0,0
202223,AP1E00200Q,SCUOLA PRIMARIA,3,12,10,2,0,2
202223,RE1M8H500D,SCUOLA SECONDARIA I GRADO,2,29,26,3,1,2
202223,FR1EZQ500N,SCUOLA PRIMARIA,2,7,7,0,0,0
202223,MCPMOP500O,SCUOLA SECONDARIA II GRADO,5,50,40,10,4,6
202223,BGPS0D500U,SCUOLA SECONDARIA II GRADO,3,29,26,3,1,2
202223,RM1E00800V,SCUOLA PRIMARIA,4,17,17,0,0,0
202223,VA1M012005,SCUOLA SECONDARIA I GRADO,1,83,78,5,0,5
202223,NA1M023007,SCUOLA SECONDARIA I GRADO,2,27,25,2,0,2
202223,VE1E014002,SCUOLA PRIMARIA,4,18,18,0,0,0
202223,FI1E00400C,SCUOLA PRIMARIA,4,27,27,0,0,0
202223,SATFTL5007,SCUOLA SECONDARIA II GRADO,3,7,6,1,0,1
202223,GE1E03800C,SCUOLA PRIMARIA,1,10,8,2,0,2
202223,APTFOR5004,SCUOLA SECONDARIA II GRADO,5,21,19,2,0,2
202223,UD1E010003,SCUOLA PRIMARIA,3,16,16,0,0,0
202223,MIPS175007,SCUOLA SECONDARIA II GRADO,1,45,42,3,0,3
202223,PA1E01700G,SCUOLA PRIMARIA,3,32,32,0,0,0
202223,NA1E219004,SCUOLA PRIMARIA,3,13,12,1,0,1
202223,BS1E008008,SCUOLA PRIMARIA,5,44,43,1,1,0
202223,RMTB04500X,SCUOLA SECONDARIA II GRADO,5,24,24,0,0,0
202223,BG1E00800Q,SCUOLA PRIMARIA,3,54,54,0,0,0
202223,MI1E003007,SCUOLA PRIMARIA,4,50,49,1,0,1
202223,VA1E02100P,SCUOLA PRIMARIA,4,93,91,2,0,2
202223,NA1M003002,SCUOLA SECONDARIA I GRADO,1,68,67,1,0,1
202223,LC1E00100D,SCUOLA PRIMARIA,2,18,18,0,0,0
202223,LC1E010008,SCUOLA PRIMARIA,1,26,26,0,0,0
202223,FGTDO25007,SCUOLA SECONDARIA II GRADO,5,30,29,1,0,1
202223,RM1E057004,SCUOLA PRIMARIA,2,27,27,0,0,0
202223,CORC61500H,SCUOLA SECONDARIA II GRADO,1,14,14,0,0,0
202223,GE1E03000T,SCUOLA PRIMARIA,3,21,19,2,1,1
202223,NATDLM500R,SCUOLA SECONDARIA II GRADO,1,5,4,1,1,0
202223,SATFU9500P,SCUOLA SECONDARIA II GRADO,4,3,3,0,0,0
202223,MIPLAM5002,SCUOLA SECONDARIA II GRADO,1,8,8,0,0,0
202223,TO1MB25008,SCUOLA SECONDARIA I GRADO,2,34,30,4,1,3
202223,FIPMT8500I,SCUOLA SECONDARIA II GRADO,3,11,11,0,0,0
202223,RE1E001006,SCUOLA PRIMARIA,1,25,23,2,1,1
202223,MI1E07300D,SCUOLA PRIMARIA,4,25,24,1,0,1
202223,RMPSBI5001,SCUOLA SECONDARIA II GRADO,5,23,22,1,0,1
202223,RMPS555002,SCUOLA SECONDARIA II GRADO,2,26,25,1,0,1
202223,BO1M00300Q,SCUOLA SECONDARIA I GRADO,3,23,22,1,0,1
202223,ME1E001008,SCUOLA PRIMARIA,5,27,27,0,0,0
202223,BS1E02600T,SCUOLA PRIMARIA,3,13,13,0,0,0
202223,RM1E7V500S,SCUOLA PRIMARIA,2,13,11,2,0,2
202223,PA1E043004,SCUOLA PRIMARIA,5,21,14,7,0,7
202223,AVPM10500T,SCUOLA SECONDARIA II GRADO,5,70,63,7,2,5
202223,TVPC48500H,SCUOLA SECONDARIA II GRADO,5,22,22,0,0,0
202223,NATDFO5000,SCUOLA SECONDARIA II GRADO,2,14,14,0,0,0
202223,NATDR0500L,SCUOLA SECONDARIA II GRADO,3,3,3,0,0,0
202223,TOPC10500T,SCUOLA SECONDARIA II GRADO,5,13,13,0,0,0
202223,FE1E004005,SCUOLA PRIMARIA,3,23,23,0,0,0
202223,RMPSQP500D,SCUOLA SECONDARIA II GRADO,1,21,21,0,0,0
202223,RM1M04200G,SCUOLA SECONDARIA I GRADO,1,70,64,6,0,6
202223,BA1E00200Q,SCUOLA PRIMARIA,5,23,23,0,0,0
202223,TO1E004003,SCUOLA PRIMARIA,1,17,11,6,3,3
202223,CHRI00500N,SCUOLA SECONDARIA II GRADO,3,2,2,0,0,0
202223,NA1E164005,SCUOLA PRIMARIA,2,14,14,0,0,0
202223,CN1E001003,SCUOLA PRIMARIA,3,15,14,1,1,0
202223,PVTD065009,SCUOLA SECONDARIA II GRADO,1,3,2,1,0,1
202223,RMPSHR5005,SCUOLA SECONDARIA II GRADO,2,5,4,1,0,1
202223,NA1E073003,SCUOLA PRIMARIA,5,25,25,0,0,0
202223,TV1E01500T,SCUOLA PRIMARIA,5,51,51,0,0,0
202223,NA1E00900Q,SCUOLA PRIMARIA,2,11,11,0,0,0
202223,FRRFL1500I,SCUOLA SECONDARIA II GRADO,4,3,3,0,0,0
202223,CTTN01500A,SCUOLA SECONDARIA II GRADO,3,7,7,0,0,0
202223,FO1M00100B,SCUOLA SECONDARIA I GRADO,2,41,41,0,0,0
202223,AVTD045005,SCUOLA SECONDARIA II GRADO,4,9,9,0,0,0
202223,MI1MN45001,SCUOLA SECONDARIA I GRADO,3,58,56,2,0,2
202223,TOPM085002,SCUOLA SECONDARIA II GRADO,5,7,7,0,0,0
202223,PATD87500G,SCUOLA SECONDARIA II GRADO,2,7,7,0,0,0
202223,RMPSVA5006,SCUOLA SECONDARIA II GRADO,5,24,21,3,0,3
202223,SATFET500V,SCUOLA SECONDARIA II GRADO,3,7,7,0,0,0
202223,PVPS01500C,SCUOLA SECONDARIA II GRADO,2,22,22,0,0,0
202223,PVPS345009,SCUOLA SECONDARIA II GRADO,2,11,8,3,1,2
202223,NATD46500L,SCUOLA SECONDARIA II GRADO,4,8,8,0,0,0
202223,NA1E06800G,SCUOLA PRIMARIA,4,19,14,5,0,5
202223,SARH13500E,SCUOLA SECONDARIA II GRADO,3,4,4,0,0,0
202223,TV1E01200A,SCUOLA PRIMARIA,4,20,19,1,0,1
202223,CE1E049008,SCUOLA PRIMARIA,1,13,13,0,0,0
202223,PAPS02500Q,SCUOLA SECONDARIA II GRADO,3,50,50,0,0,0
202223,FRPM9G500T,SCUOLA SECONDARIA II GRADO,3,4,3,1,0,1
202223,VA1M4Z500Q,SCUOLA SECONDARIA I GRADO,3,39,39,0,0,0
202223,LU1E003004,SCUOLA PRIMARIA,2,13,11,2,0,2
202223,CTPC08500Q,SCUOLA SECONDARIA II GRADO,2,16,16,0,0,0
202223,VBSLCH500S,SCUOLA SECONDARIA II GRADO,2,10,9,1,0,1
202223,FI1E00900G,SCUOLA PRIMARIA,1,17,12,5,0,5
202223,NA1E05400N,SCUOLA PRIMARIA,5,55,54,1,0,1
202223,NA1E14400X,SCUOLA PRIMARIA,1,14,14,0,0,0
202223,AQ1E00500T,SCUOLA PRIMARIA,4,20,18,2,2,0
202223,AT1ENP5001,SCUOLA PRIMARIA,1,18,16,2,0,2
202223,NA1E20800N,SCUOLA PRIMARIA,4,11,11,0,0,0
202223,RM1E18900C,SCUOLA PRIMARIA,4,14,14,0,0,0
202223,VI1E001007,SCUOLA PRIMARIA,5,43,36,7,0,7
202223,CS1ENE5005,SCUOLA PRIMARIA,2,21,21,0,0,0
202223,RE1E565000,SCUOLA PRIMARIA,3,17,13,4,1,3
202223,TV1E01700D,SCUOLA PRIMARIA,3,45,44,1,1,0
202223,MIPM2A500Z,SCUOLA SECONDARIA II GRADO,2,29,24,5,0,5
202223,LTRFGQ5000,SCUOLA SECONDARIA II GRADO,2,3,3,0,0,0
202223,SATD9H500H,SCUOLA SECONDARIA II GRADO,2,8,7,1,0,1
202223,TO1M04600A,SCUOLA SECONDARIA I GRADO,1,54,53,1,0,1
202223,SI1E001009,SCUOLA PRIMARIA,3,22,22,0,0,0
202223,FIPLV0500F,SCUOLA SECONDARIA II GRADO,5,6,6,0,0,0
202223,FIPMP9500U,SCUOLA SECONDARIA II GRADO,5,27,26,1,0,1
202223,RMPLI6500I,SCUOLA SECONDARIA II GRADO,5,7,7,0,0,0
202223,MI1E05700G,SCUOLA PRIMARIA,3,33,32,1,1,0
202223,BA1MD7500G,SCUOLA SECONDARIA I GRADO,1,14,13,1,1,0
202223,TOPS955001,SCUOLA SECONDARIA II GRADO,5,19,18,1,1,0
202223,RM1E049005,SCUOLA PRIMARIA,1,21,20,1,1,0
202223,FI1E022002,SCUOLA PRIMARIA,5,22,21,1,0,1
202223,RM1E10200R,SCUOLA PRIMARIA,3,28,28,0,0,0
202223,MB1E128009,SCUOLA PRIMARIA,1,38,38,0,0,0
202223,CE1E058003,SCUOLA PRIMARIA,1,9,8,1,1,0
202223,BO1M2F5007,SCUOLA SECONDARIA I GRADO,1,16,16,0,0,0
202223,FI1MIM500Z,SCUOLA SECONDARIA I GRADO,1,52,43,9,0,9
202223,SATDG0500E,SCUOLA SECONDARIA II GRADO,1,7,6,1,0,1
202223,BG1M015004,SCUOLA SECONDARIA I GRADO,3,95,93,2,1,1
202223,RM1E143003,SCUOLA PRIMARIA,1,21,21,0,0,0
202223,PAPC1H500H,SCUOLA SECONDARIA II GRADO,4,11,11,0,0,0
202223,AVTF005001,SCUOLA SECONDARIA II GRADO,4,4,4,0,0,0
202223,NA1E24400R,SCUOLA PRIMARIA,2,23,23,0,0,0
202223,TOPS09500G,SCUOLA SECONDARIA II GRADO,5,55,54,1,0,1
202223,RM1E113007,SCUOLA PRIMARIA,1,11,10,1,1,0
202223,NA1E149003,SCUOLA PRIMARIA,1,3,3,0,0,0
202223,VRPS005004,SCUOLA SECONDARIA II GRADO,2,24,23,1,0,1
202223,CT1E03900X,SCUOLA PRIMARIA,3,21,21,0,0,0
202223,RM1M15000B,SCUOLA SECONDARIA I GRADO,3,23,23,0,0,0
202223,RM1M031005,SCUOLA SECONDARIA I GRADO,2,22,19,3,0,3
202223,TVTD02500D,SCUOLA SECONDARIA II GRADO,5,25,25,0,0,0
202223,MI1E445002,SCUOLA PRIMARIA,1,55,51,4,2,2
202223,MB1E03500G,SCUOLA PRIMARIA,1,61,55,6,0,6
202223,SAPS8F500U,SCUOLA SECONDARIA II GRADO,2,5,5,0,0,0
202223,PEPMDE500O,SCUOLA SECONDARIA II GRADO,1,23,23,0,0,0
202223,ME1E00500G,SCUOLA PRIMARIA,4,17,17,0,0,0
202223,TO1M00600X,SCUOLA SECONDARIA I GRADO,3,14,14,0,0,0
202223,RMPC455002,SCUOLA SECONDARIA II GRADO,3,9,9,0,0,0
202223,PR1M00900X,SCUOLA SECONDARIA I GRADO,3,56,56,0,0,0
202223,MI1E11900N,SCUOLA PRIMARIA,2,20,20,0,0,0
202223,CT1E02300A,SCUOLA PRIMARIA,1,17,17,0,0,0
202223,NAPS265003,SCUOLA SECONDARIA II GRADO,4,16,15,1,0,1
202223,RM1M058005,SCUOLA SECONDARIA I GRADO,3,17,13,4,0,4
202223,UD1E001008,SCUOLA PRIMARIA,5,19,19,0,0,0
202223,SASLFZ5001,SCUOLA SECONDARIA II GRADO,1,9,7,2,0,2
202223,MB1E037007,SCUOLA PRIMARIA,2,40,33,7,0,7
202223,FIPL005008,SCUOLA SECONDARIA II GRADO,3,17,17,0,0,0
202223,CETF4P500Q,SCUOLA SECONDARIA II GRADO,4,13,11,2,0,2
202223,VAPLDB5003,SCUOLA SECONDARIA II GRADO,5,23,19,4,1,3
202223,NA1E03700X,SCUOLA PRIMARIA,4,48,48,0,0,0
202223,BGPL04500P,SCUOLA SECONDARIA II GRADO,1,38,36,2,0,2
202223,GE1M030003,SCUOLA SECONDARIA I GRADO,1,9,8,1,0,1
202223,SAPC005001,SCUOLA SECONDARIA II GRADO,3,7,6,1,0,1
202223,TO1E00800A,SCUOLA PRIMARIA,5,16,16,0,0,0
202223,RM1E19700B,SCUOLA PRIMARIA,2,65,64,1,1,0
202223,LEPS02500C,SCUOLA SECONDARIA II GRADO,1,9,9,0,0,0
202223,MI1M068007,SCUOLA SECONDARIA I GRADO,1,28,27,1,0,1
202223,SP1E00400X,SCUOLA PRIMARIA,2,23,22,1,0,1
202223,RNPM015006,SCUOLA SECONDARIA II GRADO,5,37,24,13,0,13
202223,VR1M00900B,SCUOLA SECONDARIA I GRADO,3,19,18,1,0,1
202223,TVPC01500X,SCUOLA SECONDARIA II GRADO,5,15,15,0,0,0
202223,NA1E03200R,SCUOLA PRIMARIA,3,13,12,1,0,1
202223,PD1M015007,SCUOLA SECONDARIA I GRADO,3,22,5,17,0,17
202223,NA1E272001,SCUOLA PRIMARIA,5,11,9,2,0,2
202223,BL1M00100R,SCUOLA SECONDARIA I GRADO,1,31,31,0,0,0
202223,FG1E022009,SCUOLA PRIMARIA,4,46,46,0,0,0
202223,CERH015004,SCUOLA SECONDARIA II GRADO,2,12,12,0,0,0
202223,CR1E005006,SCUOLA PRIMARIA,2,19,19,0,0,0
202223,SAPMSZ500D,SCUOLA SECONDARIA II GRADO,2,10,10,0,0,0
202223,TOTF055007,SCUOLA SECONDARIA II GRADO,3,3,3,0,0,0
202223,BO1E014001,SCUOLA PRIMARIA,4,42,41,1,0,1
202223,TO1E04900L,SCUOLA PRIMARIA,5,25,24,1,0,1
202223,TO1E032007,SCUOLA PRIMARIA,4,17,17,0,0,0
202223,FI1M001006,SCUOLA SECONDARIA I GRADO,3,20,18,2,0,2
202223,VI1E00900T,SCUOLA PRIMARIA,1,25,25,0,0,0
202223,BORC10500R,SCUOLA SECONDARIA II GRADO,3,27,25,2,0,2
202223,SV1M00400G,SCUOLA SECONDARIA I GRADO,2,39,39,0,0,0
202223,SSPQC7500O,SCUOLA SECONDARIA II GRADO,4,2,2,0,0,0
202223,RM1E2U500H,SCUOLA PRIMARIA,1,50,50,0,0,0
202223,RMPC24500N,SCUOLA SECONDARIA II GRADO,4,19,19,0,0,0
202223,COPS055009,SCUOLA SECONDARIA II GRADO,4,25,24,1,1,0
202223,MIPLRL500B,SCUOLA SECONDARIA II GRADO,1,22,20,2,0,2
202223,PC1E00300V,SCUOLA PRIMARIA,3,16,15,1,0,1
202223,MBRH02500X,SCUOLA SECONDARIA II GRADO,4,23,23,0,0,0
202223,PD1E00900C,SCUOLA PRIMARIA,5,19,19,0,0,0
202223,RMPMR25005,SCUOLA SECONDARIA II GRADO,2,11,10,1,1,0
202223,BA1E02500C,SCUOLA PRIMARIA,4,11,11,0,0,0
202223,NATL27500X,SCUOLA SECONDARIA II GRADO,1,8,8,0,0,0
202223,CA1E00600X,SCUOLA PRIMARIA,1,19,15,4,1,3
202223,MI1M03700G,SCUOLA SECONDARIA I GRADO,3,19,18,1,0,1
202223,RMTF285009,SCUOLA SECONDARIA II GRADO,3,8,7,1,1,0
202223,NAPMRP500S,SCUOLA SECONDARIA II GRADO,2,3,3,0,0,0
202223,BGPS1G5008,SCUOLA SECONDARIA II GRADO,3,17,16,1,1,0
202223,PG1EPF500P,SCUOLA PRIMARIA,4,20,19,1,0,1
202223,FO1E00300T,SCUOLA PRIMARIA,4,21,20,1,0,1
202223,MERHOV500E,SCUOLA SECONDARIA II GRADO,1,2,2,0,0,0
202223,VATFME500R,SCUOLA SECONDARIA II GRADO,5,9,7,2,0,2
202223,NATFIQ500E,SCUOLA SECONDARIA II GRADO,1,8,5,3,1,2
202223,BNTFOA500V,SCUOLA SECONDARIA II GRADO,2,2,2,0,0,0
202223,PATD7N500Z,SCUOLA SECONDARIA II GRADO,3,2,2,0,0,0
202223,ENRH5C5006,SCUOLA SECONDARIA II GRADO,1,2,2,0,0,0
202223,CSTD71500B,SCUOLA SECONDARIA II GRADO,3,8,8,0,0,0
202223,MIPS535008,SCUOLA SECONDARIA II GRADO,3,13,13,0,0,0
202223,RMSL5N500U,SCUOLA SECONDARIA II GRADO,5,4,4,0,0,0
202223,MBPS1Q500V,SCUOLA SECONDARIA II GRADO,5,31,30,1,1,0
202223,PIPS02500D,SCUOLA SECONDARIA II GRADO,4,26,25,1,0,1
202223,MI1E00700E,SCUOLA PRIMARIA,3,49,47,2,0,2
202223,LCPS025007,SCUOLA SECONDARIA II GRADO,4,20,20,0,0,0
202223,REPS00500P,SCUOLA SECONDARIA II GRADO,5,9,8,1,0,1
202223,VR1E01000A,SCUOLA PRIMARIA,4,23,23,0,0,0
202223,VR1E00200B,SCUOLA PRIMARIA,5,16,13,3,0,3
202223,MIRF105007,SCUOLA SECONDARIA II GRADO,3,19,15,4,0,4
202223,CERIH2500T,SCUOLA SECONDARIA II GRADO,3,35,35,0,0,0
202223,CETFOD5002,SCUOLA SECONDARIA II GRADO,4,8,0,8,0,8
202223,TO1M01000G,SCUOLA SECONDARIA I GRADO,2,39,37,2,1,1
202223,NATFD05003,SCUOLA SECONDARIA II GRADO,3,2,2,0,0,0
202223,UD1MD8500H,SCUOLA SECONDARIA I GRADO,1,15,12,3,1,2
202223,RMPS265002,SCUOLA SECONDARIA II GRADO,1,28,25,3,2,1
202223,VEPL04500N,SCUOLA SECONDARIA II GRADO,5,17,17,0,0,0
202223,MI1E011006,SCUOLA PRIMARIA,2,21,20,1,0,1
202223,BOPSVN5005,SCUOLA SECONDARIA II GRADO,1,17,17,0,0,0
202223,VA1E01200X,SCUOLA PRIMARIA,1,30,29,1,0,1
202223,RGTD105002,SCUOLA SECONDARIA II GRADO,2,3,2,1,0,1
202223,SA1E00600P,SCUOLA PRIMARIA,3,14,14,0,0,0
202223,PD1E018007,SCUOLA PRIMARIA,1,45,41,4,0,4
202223,CTPMOQ500A,SCUOLA SECONDARIA II GRADO,3,2,2,0,0,0
202223,COPL01500N,SCUOLA SECONDARIA II GRADO,2,9,6,3,1,2
202223,BNPS3O5006,SCUOLA SECONDARIA II GRADO,2,3,3,0,0,0
202223,RM1M09800G,SCUOLA SECONDARIA I GRADO,2,14,13,1,0,1
202223,BA1E01000P,SCUOLA PRIMARIA,5,24,24,0,0,0
202223,CS1E00600D,SCUOLA PRIMARIA,1,20,20,0,0,0
202223,NA1E186002,SCUOLA PRIMARIA,1,11,10,1,0,1
202223,AGRHUP500I,SCUOLA SECONDARIA II GRADO,5,52,52,0,0,0
202223,NAPMGN5002,SCUOLA SECONDARIA II GRADO,5,44,43,1,1,0
202223,LT1E00900G,SCUOLA PRIMARIA,3,42,42,0,0,0
202223,NARF5C500N,SCUOLA SECONDARIA II GRADO,5,61,61,0,0,0
202223,SATD25500P,SCUOLA SECONDARIA II GRADO,5,70,69,1,0,1
202223,ISTDGG500C,SCUOLA SECONDARIA II GRADO,4,3,3,0,0,0
202223,RC1E005008,SCUOLA PRIMARIA,2,13,12,1,0,1
202223,RM1E11500V,SCUOLA PRIMARIA,3,78,77,1,0,1
202223,NATD53500N,SCUOLA SECONDARIA II GRADO,4,11,11,0,0,0
202223,RMPSIZ500B,SCUOLA SECONDARIA II GRADO,5,8,8,0,0,0
202223,PD1E01400X,SCUOLA PRIMARIA,5,25,24,1,1,0
202223,MI1E024008,SCUOLA PRIMARIA,1,23,23,0,0,0
202223,BSTF4M5001,SCUOLA SECONDARIA II GRADO,5,12,12,0,0,0
202223,MI1E067006,SCUOLA PRIMARIA,3,16,15,1,0,1
202223,NA1E19600L,SCUOLA PRIMARIA,3,11,11,0,0,0
202223,TV1E00800P,SCUOLA PRIMARIA,5,20,20,0,0,0
202223,TV1E00100X,SCUOLA PRIMARIA,1,24,24,0,0,0
202223,LETD075009,SCUOLA SECONDARIA II GRADO,2,1,1,0,0,0
202223,RM1E00800V,SCUOLA PRIMARIA,5,25,25,0,0,0
202223,CE1E065006,SCUOLA PRIMARIA,2,38,38,0,0,0
202223,CTTDHQ5002,SCUOLA SECONDARIA II GRADO,1,1,1,0,0,0
202223,GE1E006001,SCUOLA PRIMARIA,2,93,84,9,1,8
202223,CE1E03200V,SCUOLA PRIMARIA,1,17,14,3,0,3
202223,CETDHL500C,SCUOLA SECONDARIA II GRADO,3,10,8,2,1,1
202223,NA1M023007,SCUOLA SECONDARIA I GRADO,3,28,27,1,0,1
202223,BS1E02000V,SCUOLA PRIMARIA,4,48,47,1,0,1
202223,PR1M00400R,SCUOLA SECONDARIA I GRADO,3,29,26,3,0,3
202223,FI1E00400C,SCUOLA PRIMARIA,5,39,38,1,0,1
202223,VRTF265002,SCUOLA SECONDARIA II GRADO,2,27,27,0,0,0
202223,BG1E01600P,SCUOLA PRIMARIA,4,54,52,2,0,2
202223,RMTD325008,SCUOLA SECONDARIA II GRADO,3,13,13,0,0,0
202223,BS1E009004,SCUOLA PRIMARIA,1,25,24,1,1,0
202223,CETL04500C,SCUOLA SECONDARIA II GRADO,4,3,3,0,0,0
202223,MBPS365007,SCUOLA SECONDARIA II GRADO,2,13,13,0,0,0
202223,RM1E180002,SCUOLA PRIMARIA,4,31,27,4,0,4
202223,NAPC135007,SCUOLA SECONDARIA II GRADO,2,5,5,0,0,0
202223,LE1E009009,SCUOLA PRIMARIA,5,11,10,1,0,1
202223,FR1E00400R,SCUOLA PRIMARIA,4,12,11,1,0,1
202223,NARH96500S,SCUOLA SECONDARIA II GRADO,3,20,20,0,0,0
202223,NATF30500A,SCUOLA SECONDARIA II GRADO,3,11,11,0,0,0
202223,GE1M015001,SCUOLA SECONDARIA I GRADO,2,26,26,0,0,0
202223,APPSZ65005,SCUOLA SECONDARIA II GRADO,3,9,8,1,0,1
202223,AV1E007009,SCUOLA PRIMARIA,3,18,16,2,0,2
202223,NA1E21600L,SCUOLA PRIMARIA,4,16,15,1,0,1
202223,BS1E004001,SCUOLA PRIMARIA,4,43,40,3,0,3
202223,BS1E009004,SCUOLA PRIMARIA,5,25,22,3,1,2
202223,NARI01500D,SCUOLA SECONDARIA II GRADO,3,7,7,0,0,0
202223,PI1E00200G,SCUOLA PRIMARIA,4,14,14,0,0,0
202223,MI1M076006,SCUOLA SECONDARIA I GRADO,3,36,33,3,1,2
202223,TV1M00400L,SCUOLA SECONDARIA I GRADO,3,102,100,2,0,2
202223,AL1E00100P,SCUOLA PRIMARIA,3,53,49,4,3,1
202223,BO1M00400G,SCUOLA SECONDARIA I GRADO,2,11,11,0,0,0
202223,RM1E07500N,SCUOLA PRIMARIA,2,76,74,2,1,1
202223,FI1M028006,SCUOLA SECONDARIA I GRADO,1,19,19,0,0,0
202223,PV1E00900X,SCUOLA PRIMARIA,1,21,21,0,0,0
202223,LT1E00800Q,SCUOLA PRIMARIA,1,9,9,0,0,0
202223,LTTFOH5004,SCUOLA SECONDARIA II GRADO,4,5,5,0,0,0
202223,FI1E00300L,SCUOLA PRIMARIA,2,23,22,1,1,0
202223,NA1E04000Q,SCUOLA PRIMARIA,1,13,13,0,0,0
202223,VR1M01500P,SCUOLA SECONDARIA I GRADO,2,47,42,5,1,4
202223,SATL16500Q,SCUOLA SECONDARIA II GRADO,1,18,16,2,0,2
202223,CO1M021006,SCUOLA SECONDARIA I GRADO,3,16,15,1,1,0
202223,NA1E28100Q,SCUOLA PRIMARIA,2,44,43,1,0,1
202223,RMPL43500P,SCUOLA SECONDARIA II GRADO,4,14,14,0,0,0
202223,RM1M130006,SCUOLA SECONDARIA I GRADO,1,46,46,0,0,0
202223,RCRI015009,SCUOLA SECONDARIA II GRADO,3,4,4,0,0,0
202223,MI1E046005,SCUOLA PRIMARIA,2,76,74,2,2,0
202223,RMPSHR5005,SCUOLA SECONDARIA II GRADO,1,14,13,1,0,1
202223,RM1E02500L,SCUOLA PRIMARIA,5,26,26,0,0,0
202223,RMPS655007,SCUOLA SECONDARIA II GRADO,4,6,6,0,0,0
202223,RM1E04100E,SCUOLA PRIMARIA,5,15,14,1,0,1
202223,RMTL08500Q,SCUOLA SECONDARIA II GRADO,1,2,2,0,0,0
202223,GE1E00700R,SCUOLA PRIMARIA,4,9,8,1,0,1
202223,AL1E00600T,SCUOLA PRIMARIA,3,42,35,7,2,5
202223,BO1EL9500N,SCUOLA PRIMARIA,4,20,18,2,1,1
202223,PE1M5C500R,SCUOLA SECONDARIA I GRADO,2,24,22,2,1,1
202223,MIPMEO500H,SCUOLA SECONDARIA II GRADO,4,32,32,0,0,0
202223,PV1E00500L,SCUOLA PRIMARIA,2,49,48,1,0,1
202223,PA1E04500Q,SCUOLA PRIMARIA,5,26,25,1,1,0
202223,TV1M01200G,SCUOLA SECONDARIA I GRADO,2,71,70,1,1,0
202223,NATDU1500D,SCUOLA SECONDARIA II GRADO,3,5,5,0,0,0
202223,BGTF9O500Q,SCUOLA SECONDARIA II GRADO,4,13,13,0,0,0
202223,VATB01500D,SCUOLA SECONDARIA II GRADO,4,25,22,3,1,2
202223,VAPSVA500Z,SCUOLA SECONDARIA II GRADO,5,28,28,0,0,0
202223,MI1E054004,SCUOLA PRIMARIA,1,11,10,1,1,0
202223,MSPC01500B,SCUOLA SECONDARIA II GRADO,5,7,7,0,0,0
202223,NO1E00300Q,SCUOLA PRIMARIA,4,46,44,2,0,2
202223,CL1E00500Q,SCUOLA PRIMARIA,3,12,12,0,0,0
202223,MB1E07200E,SCUOLA PRIMARIA,5,28,28,0,0,0
202223,RMPCAM500U,SCUOLA SECONDARIA II GRADO,4,9,9,0,0,0
202223,BGSLN6500G,SCUOLA SECONDARIA II GRADO,1,29,28,1,1,0
202223,SATDR35003,SCUOLA SECONDARIA II GRADO,3,14,14,0,0,0
202223,POPS9T5004,SCUOLA SECONDARIA II GRADO,2,11,8,3,0,3
202223,BSPSS1500O,SCUOLA SECONDARIA II GRADO,3,51,51,0,0,0
202223,RM1E10400C,SCUOLA PRIMARIA,3,23,22,1,1,0
202223,AVPM03500Q,SCUOLA SECONDARIA II GRADO,3,4,4,0,0,0
202223,PS1E00200B,SCUOLA PRIMARIA,4,20,20,0,0,0
202223,AVTF1Q5009,SCUOLA SECONDARIA II GRADO,5,70,70,0,0,0
202223,MI1MV25008,SCUOLA SECONDARIA I GRADO,2,44,43,1,0,1
202223,RM1E11700E,SCUOLA PRIMARIA,1,9,9,0,0,0
202223,RM1M04000X,SCUOLA SECONDARIA I GRADO,1,77,76,1,1,0
202223,GO1EUT5002,SCUOLA PRIMARIA,5,2,2,0,0,0
202223,MI1E03000G,SCUOLA PRIMARIA,5,25,25,0,0,0
202223,NAPSNL500R,SCUOLA SECONDARIA II GRADO,3,27,27,0,0,0
202223,NARHZ8500V,SCUOLA SECONDARIA II GRADO,5,70,69,1,1,0
202223,AP1E00100X,SCUOLA PRIMARIA,4,16,16,0,0,0
202223,MI1E125001,SCUOLA PRIMARIA,4,55,55,0,0,0
202223,NA1E073003,SCUOLA PRIMARIA,2,34,32,2,0,2
202223,SAPSNV500C,SCUOLA SECONDARIA II GRADO,2,10,10,0,0,0
202223,CE1E03300P,SCUOLA PRIMARIA,5,17,16,1,0,1
202223,VA1M01900X,SCUOLA SECONDARIA I GRADO,1,19,17,2,0,2
202223,RM1E007003,SCUOLA PRIMARIA,5,20,18,2,0,2
202223,NA1M015008,SCUOLA SECONDARIA I GRADO,1,30,28,2,0,2
202223,VE1E00300G,SCUOLA PRIMARIA,3,20,20,0,0,0
202223,VR1E01300T,SCUOLA PRIMARIA,2,30,28,2,0,2
202223,CE1E01800L,SCUOLA PRIMARIA,2,11,11,0,0,0
202223,UDPC00500N,SCUOLA SECONDARIA II GRADO,3,11,11,0,0,0
202223,AR1E00400L,SCUOLA PRIMARIA,5,36,33,3,0,3
202223,RMPS505001,SCUOLA SECONDARIA II GRADO,1,17,17,0,0,0
202223,BOPSOI5007,SCUOLA SECONDARIA II GRADO,4,23,23,0,0,0
202223,RM1E127005,SCUOLA PRIMARIA,3,59,56,3,1,2
202223,GE1M013009,SCUOLA SECONDARIA I GRADO,3,32,30,2,0,2
202223,RMPM00500N,SCUOLA SECONDARIA II GRADO,5,7,7,0,0,0
202223,RMPLOA500A,SCUOLA SECONDARIA II GRADO,3,4,3,1,0,1
202223,CN1EN55004,SCUOLA PRIMARIA,5,16,16,0,0,0
202223,NATDB75009,SCUOLA SECONDARIA II GRADO,1,8,8,0,0,0
202223,PA1E005009,SCUOLA PRIMARIA,5,17,17,0,0,0
202223,BA1E01600N,SCUOLA PRIMARIA,2,9,9,0,0,0
202223,SAPM53500M,SCUOLA SECONDARIA II GRADO,3,2,2,0,0,0
202223,LI1M00600A,SCUOLA SECONDARIA I GRADO,1,24,24,0,0,0
202223,RMPS56500L,SCUOLA SECONDARIA II GRADO,2,1,0,1,1,0
202223,TO1E05100L,SCUOLA PRIMARIA,4,23,21,2,1,1
202223,RMPS355008,SCUOLA SECONDARIA II GRADO,4,31,29,2,0,2
202223,FI1M02000G,SCUOLA SECONDARIA I GRADO,2,24,23,1,1,0
202223,PV1E00600C,SCUOLA PRIMARIA,2,11,10,1,0,1
202223,TVPMRQ500V,SCUOLA SECONDARIA II GRADO,4,16,16,0,0,0
202223,NA1E015003,SCUOLA PRIMARIA,4,12,8,4,0,4
202223,BSPC01500D,SCUOLA SECONDARIA II GRADO,4,19,19,0,0,0
202223,SRTD06500N,SCUOLA SECONDARIA II GRADO,5,51,51,0,0,0
202223,COTB01500Q,SCUOLA SECONDARIA II GRADO,3,18,15,3,0,3
202223,TOPS005004,SCUOLA SECONDARIA II GRADO,3,26,25,1,0,1
202223,NA1E242005,SCUOLA PRIMARIA,2,10,7,3,0,3
202223,RM1E13200L,SCUOLA PRIMARIA,2,21,20,1,0,1
202223,CT1E02300A,SCUOLA PRIMARIA,2,22,22,0,0,0
202223,GO1E00100A,SCUOLA PRIMARIA,4,35,35,0,0,0
202223,MIPSQV500F,SCUOLA SECONDARIA II GRADO,5,22,22,0,0,0
202223,RMPS08500D,SCUOLA SECONDARIA II GRADO,1,35,34,1,0,1
202223,MNPL2H500Q,SCUOLA SECONDARIA II GRADO,4,7,7,0,0,0
202223,LIPL035005,SCUOLA SECONDARIA II GRADO,4,8,8,0,0,0
202223,PVSL015009,SCUOLA SECONDARIA II GRADO,3,2,2,0,0,0
202223,RMPSII500C,SCUOLA SECONDARIA II GRADO,1,7,7,0,0,0
202223,APPS9N5001,SCUOLA SECONDARIA II GRADO,2,2,2,0,0,0
202223,MB1E037007,SCUOLA PRIMARIA,3,28,26,2,1,1
202223,BS1M00300A,SCUOLA SECONDARIA I GRADO,1,50,48,2,0,2
202223,METDP0500I,SCUOLA SECONDARIA II GRADO,3,6,6,0,0,0
202223,PA1E02900T,SCUOLA PRIMARIA,3,15,15,0,0,0
202223,RMPC355005,SCUOLA SECONDARIA II GRADO,4,12,12,0,0,0
202223,RM1E13800G,SCUOLA PRIMARIA,1,75,74,1,0,1
202223,MIPL265008,SCUOLA SECONDARIA II GRADO,4,10,10,0,0,0
202223,BG1E019006,SCUOLA PRIMARIA,3,17,16,1,0,1
202223,SATF09500P,SCUOLA SECONDARIA II GRADO,4,8,8,0,0,0
202223,RMPMT1500R,SCUOLA SECONDARIA II GRADO,3,7,7,0,0,0
202223,TO1E012002,SCUOLA PRIMARIA,2,22,22,0,0,0
202223,NATD3V500N,SCUOLA SECONDARIA II GRADO,5,109,97,12,4,8
202223,RM1E17400P,SCUOLA PRIMARIA,1,14,11,3,1,2
202223,VIPM01500B,SCUOLA SECONDARIA II GRADO,5,35,35,0,0,0
202223,PASD01500G,SCUOLA SECONDARIA II GRADO,2,30,30,0,0,0
202223,CETB015007,SCUOLA SECONDARIA II GRADO,4,9,9,0,0,0
202223,VE1E01200A,SCUOLA PRIMARIA,2,13,12,1,0,1
202223,BSPS01500L,SCUOLA SECONDARIA II GRADO,3,13,11,2,1,1
202223,TO1M026005,SCUOLA SECONDARIA I GRADO,3,41,36,5,1,4
202223,VAPMCL500Q,SCUOLA SECONDARIA II GRADO,1,23,21,2,1,1
202223,CTTD01500C,SCUOLA SECONDARIA II GRADO,2,3,3,0,0,0
202223,GE1M007002,SCUOLA SECONDARIA I GRADO,2,17,17,0,0,0
202223,VT1E00500D,SCUOLA PRIMARIA,3,22,22,0,0,0
202223,BG1E02300T,SCUOLA PRIMARIA,2,41,40,1,1,0
202223,MIPS445002,SCUOLA SECONDARIA II GRADO,1,35,34,1,0,1
202223,RMPS135009,SCUOLA SECONDARIA II GRADO,1,11,11,0,0,0
202223,MB1MC5500R,SCUOLA SECONDARIA I GRADO,1,12,12,0,0,0
202223,MBPQ035002,SCUOLA SECONDARIA II GRADO,4,35,35,0,0,0
202223,TO1E016009,SCUOLA PRIMARIA,1,24,24,0,0,0
202223,SP1E002008,SCUOLA PRIMARIA,4,25,25,0,0,0
202223,NA1E058001,SCUOLA PRIMARIA,5,19,19,0,0,0
202223,RM1E08800Q,SCUOLA PRIMARIA,2,14,11,3,1,2
202223,REPM7R500G,SCUOLA SECONDARIA II GRADO,3,11,11,0,0,0
202223,REPM01500A,SCUOLA SECONDARIA II GRADO,1,16,14,2,0,2
202223,GE1E01500Q,SCUOLA PRIMARIA,2,13,13,0,0,0
202223,MIPM1C500T,SCUOLA SECONDARIA II GRADO,3,25,25,0,0,0
202223,FR1E007008,SCUOLA PRIMARIA,1,12,12,0,0,0
202223,VA1E00600L,SCUOLA PRIMARIA,1,7,5,2,0,2
202223,RO1E00300A,SCUOLA PRIMARIA,1,14,14,0,0,0
202223,CT1M00100P,SCUOLA SECONDARIA I GRADO,3,5,5,0,0,0
202223,PD1EZU500F,SCUOLA PRIMARIA,2,21,19,2,0,2
202223,CTRHMM500U,SCUOLA SECONDARIA II GRADO,2,9,9,0,0,0
202223,PAPMB55005,SCUOLA SECONDARIA II GRADO,1,5,5,0,0,0
202223,MIPLRL500B,SCUOLA SECONDARIA II GRADO,2,11,10,1,0,1
202223,VATB01500D,SCUOLA SECONDARIA II GRADO,2,22,21,1,0,1
202223,CEPC015007,SCUOLA SECONDARIA II GRADO,5,13,12,1,0,1
202223,NA1E10200T,SCUOLA PRIMARIA,4,25,25,0,0,0
202223,RM1M11800G,SCUOLA SECONDARIA I GRADO,3,104,102,2,0,2
202223,NA1E22500B,SCUOLA PRIMARIA,3,13,13,0,0,0
202223,RM1E19700B,SCUOLA PRIMARIA,5,59,57,2,1,1
202223,MO1E2A5008,SCUOLA PRIMARIA,1,25,23,2,2,0
202223,BG1E006004,SCUOLA PRIMARIA,2,42,42,0,0,0
202223,TR1E00100P,SCUOLA PRIMARIA,3,14,12,2,0,2
202223,CAPQ00500E,SCUOLA SECONDARIA II GRADO,2,15,15,0,0,0
202223,TORI46500C,SCUOLA SECONDARIA II GRADO,2,8,8,0,0,0
202223,NAPSP85001,SCUOLA SECONDARIA II GRADO,2,3,3,0,0,0
